id_cliente_enc,total_productos,productos_distintos,dias_activos,compras_por_semana,compras_entre_semana,compras_fin_de_semana,grupo_preferido,Cluster
10f52d0f4815c761fed4605708bc6791,20,20,1,140,20,0,09090,1
a9fec2648af04bf065372199d25ca9d5,76,58,2,266,76,0,05040,2
a8bda299cfeb70fb6abfb742b8554685,121,41,2,423.5,25,96,05040,3
d4f56ae0a81b32a066310d4514351073,40,34,2,140,40,0,01027,1
0fb70db6c64ea008d16dde193b8c0361,7,7,1,49,7,0,05030,1
dd13f137551262ec8846044515874482,31,31,1,217,0,31,04020,1
372a1f466fe5f9c73372b931b5ab0d03,83,69,3,193.66666666666669,38,45,01013,3
b1b654b5143a5eab3ff9b1560d020ce4,515,193,4,901.25,311,204,01085,4
51127d2c736c14f667fde78e72a61e04,50,41,2,175,50,0,01027,1
56d12f4c0e03d8e4f76055e49342e4f0,113,76,3,263.6666666666667,113,0,11080,3
99bcb28ffa93f433250628d712367beb,13,13,1,91,0,13,01028,1
89321556761d6c789207c62febd56ffc,56,56,1,392,56,0,01026,2
344e324cc31cd295027b0a25e44b15b6,240,97,4,420,194,46,05040,4
ad62e5de8ba98133daad0f39168af1f4,23,23,1,161,23,0,01026,1
a483af3694f2d6f3bb39c277640b31dc,101,67,3,235.66666666666669,101,0,05040,3
2dbb6735c81537950641052c2fab01bb,94,83,1,658,94,0,12501,3
4d7ad9ae3d87035f99c3ef8ebaf08a36,37,37,1,259,37,0,11100,1
8b1a5a9592f53a45fa7a12e4a20e2ad3,75,49,3,175,58,17,03050,2
235f2284689ed84a02a25055ea166a1e,256,106,2,896,26,230,02690,4
6651104a689a3e230a4415121e39f8ae,60,60,1,420,0,60,01012,2
a6d838834b99d186e2598d8c479ea8fe,217,141,3,506.33333333333337,140,77,01013,4
a38e931efe51034835e37cac4fddf499,374,122,2,1309,286,88,05040,4
e9ddb3023ca20a1ec61485a115c2da17,57,45,2,199.5,57,0,01026,1
0044a91daa38ca4f9677179baf1e6324,12,12,1,84,0,12,10200,1
52690c461b0a83a61f9bf1358780a294,3,3,1,21,0,3,11040,1
e3ba1701bb3749601f22249184a3f6c6,72,59,2,252,72,0,02620,2
29b79442ba991f38aeb3927a9ee23a27,172,50,4,301,159,13,06100,3
f8432bdc797798bbc8069bd456fd8215,299,87,2,1046.5,299,0,03070,4
a1c1585d405760d9d9a1e416c26b6bea,74,49,3,172.66666666666669,57,17,10153,2
41845e76ac91d9a8eaf70e77df68b89f,7,7,1,49,7,0,05030,1
f2c59a96b37dc4320c54f6e1e1fcfc8e,287,156,2,1004.5,165,122,01027,4
f41f6c57f02bc3187b2a4d97aef9c9ab,9,9,1,63,9,0,03050,1
464b63ef01f26f4b125abfb76071b9b2,39,14,4,68.25,39,0,05030,1
22ddbf30d8c33b09369108d072b79e2d,44,44,1,308,44,0,05041,1
bdff39e6eba8407f2694628fddc72d8b,34,34,1,238,34,0,13877,1
7c29055dd158f0e2e9977dd300be88e8,74,59,2,259,45,29,05040,2
e262addfeb178204424fe076f08ff849,106,74,2,371,106,0,01012,3
37286ef2e678e4cf45c6af54a948c14b,51,40,4,89.25,51,0,10110,2
7051a19bb2323b7915d46c68416d01f5,38,31,1,266,38,0,04201,1
358f75097de4cb982adace3e0865ad29,48,39,2,168,48,0,13621,1
9603e89343999c0862d6c5862890e206,80,71,2,280,46,34,05030,3
776aa9be3ef69b7aec009136955da904,59,50,2,206.5,59,0,01026,1
52573a847c630b2765d5f5475acd0290,33,33,1,231,33,0,05040,1
21f833690ab6a3dd91bf19c91eaf732c,32,26,3,74.66666666666667,32,0,11140,1
f5522e6039cd7274d947cc22d387caf8,22,22,1,154,22,0,05100,1
a36f5e92140f51a9e93cd9ad57097a2a,30,26,2,105,30,0,05040,1
97d80c888fa9e01e55a4cf8b548584ac,79,55,3,184.33333333333334,52,27,05040,2
44ec79f3a2e6861e1ce4501c4b6d92cf,51,41,2,178.5,24,27,01026,1
56a42ed058fd9fd8d58342c72618959a,19,13,3,44.333333333333336,19,0,11040,1
1c5d0e3cdb633827511d37d3c47e0d7c,489,148,5,684.6,441,48,01085,4
b8ae6375bfc5b435cf3db045f8c90053,200,125,3,466.6666666666667,133,67,02750,4
5c5f862df6d7881012702244414e629f,7,7,1,49,7,0,05030,1
90e7ffe6c3b495f15d9c1aeabe3959e7,54,41,1,378,54,0,11080,1
513d089510e6713d07e9ef012f6220a8,44,14,3,102.66666666666667,44,0,08314,1
51af1f22345a50cf1db557dd6e7c44dd,25,25,1,175,25,0,05030,1
83ef109584d02ccd134f3cd742f836b8,131,83,3,305.6666666666667,131,0,09030,3
8b30c6295a90793bd9e19ebefc22a6bf,31,29,2,108.5,31,0,12500,1
c6d53c1c0b5f26f0d8484dea615cbb8f,96,77,3,224,96,0,04032,3
52d7108427275832a6935f064a4de1f5,58,43,2,203,58,0,01085,1
63507f0671658d9e5ee42c137397c536,57,36,4,99.75,57,0,05030,2
44eb396f0afae02353d865c3af9ef889,72,57,2,252,42,30,05030,2
e59a545dbbeeda3310de14f94d88a55e,12,12,1,84,12,0,10200,1
c55b680eced2caab82b73f329a8f4f05,21,21,1,147,21,0,07131,1
d86bd4473932268f8c5346a64cb39a05,20,17,2,70,20,0,05030,1
74a28152c7db2e3b9072466ccdbd9626,128,87,3,298.6666666666667,128,0,05040,3
631e997ebb23ca4e1a370866d1c0bc4f,264,99,6,308,229,35,11140,4
b2fbec5c403d1bd7eeb67635b68152de,129,84,6,150.5,110,19,07141,3
d1facc81aafe14cd63f420a23b39fe21,170,85,4,297.5,133,37,01012,3
7807ebce6161ead182b22402324cf796,119,69,3,277.6666666666667,88,31,10240,3
e63dff3daa14c125dd00174139bf3082,58,58,1,406,0,58,05040,2
ad9448a3c85162626729287fcbcfe174,32,32,1,224,32,0,01014,1
f510748014d647ff010f8f3f0c93ea2c,38,38,1,266,0,38,05030,1
d50cdf2dfa1ff9eeee4d6eeb9c164e93,10,10,1,70,10,0,08032,1
bf657cc7bda43b00744a9cdb86054379,31,31,1,217,31,0,01026,1
6b64ed4cae7dd90736d90a8872dcf520,160,105,3,373.33333333333337,108,52,10200,3
4084c4e9df94d23f8942a0f64cf14a48,103,82,3,240.33333333333334,60,43,10261,3
5ed2b52a681fd8d0770c95b5ab633069,301,139,3,702.3333333333334,102,199,03050,4
fa7e5e66b22dd9591923c79e6bdbdc60,63,63,1,441,63,0,01026,2
979d244cabeca9a7311405b76f82f515,293,128,4,512.75,293,0,01012,4
fefc23ecb68ccb447e922e2a15bba812,43,39,2,150.5,20,23,01026,1
92b5d70ef2a45a17889a0625a3999892,33,33,1,231,33,0,08010,1
d078a9c8e5469aedd9fa03a04331a467,11,11,1,77,0,11,01012,1
9f4d9032237c2770569b26aa017bcfde,40,40,1,280,40,0,10200,1
15dd4972e4cb0f1454198bff134b573d,43,30,2,150.5,21,22,01012,1
935ba4d882a87e258c05d67fcc4073d4,119,76,4,208.25,75,44,05041,3
f638e5065ad0b85cfbc15b001f0c86bf,109,81,2,381.5,109,0,10200,3
eb56a4ed45e1c7183a6a5cff2cae249b,32,32,1,224,0,32,01012,1
530db3e7107892b92b19a568ae5456ea,44,44,1,308,44,0,05100,1
63f4c3ddd31bdad6e296ef9dd44d742a,32,32,1,224,32,0,08052,1
95fe8a8ab2e518cd36d948e7ffb07422,34,34,1,238,34,0,05041,1
d669d9becb99d7b3f97ab43c47dce4e0,105,65,2,367.5,105,0,06100,3
819eb3ea52f6d078be7060edce469fa7,2,1,2,7,2,0,11040,1
bad15461c0a146c31bf6aee44095eb7e,38,37,2,133,38,0,01013,1
02315c579e26e580df04f785b76a0fc6,20,20,1,140,20,0,11100,1
3db180623d82768ba6a13ec91a981954,154,127,3,359.33333333333337,154,0,01027,3
ad8ee145c2ae0bbb5b6f917f97f2b7e7,30,22,3,70,24,6,11140,1
f14309a5a486d1fb7daad91489fc9dfe,45,42,1,315,45,0,13690,1
33a6a5b2ac1c560efd9b8c77660e2211,247,90,4,432.25,247,0,01012,4
546b7fc68c1b4045e96ab4195cb6f427,180,102,2,630,180,0,05040,3
92f40c9476778d52cfb089a2abb57560,17,17,1,119,17,0,07133,1
54c0ac31da6f0995bf2855f1a5ff9ea0,86,44,2,301,30,56,05030,2
f8f45a18b4324c8fafa121379984290a,124,102,2,434,124,0,01026,3
25f99c417d2c2abfefa8a6ccc35d3f96,63,53,2,220.5,63,0,09010,2
2701c33bb969ddc70860de22477ab41a,57,46,2,199.5,57,0,05040,1
0376cd67caf908f1578245b6a549ff68,106,82,3,247.33333333333334,78,28,01013,3
b2e6bbc7543902abfc6a13b33aa795f5,142,87,3,331.33333333333337,106,36,05040,3
02e9d47b471b0ba97dba362f5cde3095,151,87,4,264.25,100,51,01027,3
b6e9d3b86d5b7e828de8f84eb5715868,33,33,1,231,33,0,10240,1
ace2a0e85c4710c66485aa2f7821d032,40,40,1,280,40,0,01013,1
14828351d412ce9cc1df8a1568d3ea2b,20,20,1,140,20,0,05040,1
59350bdb56599e558748602d1841b911,20,20,1,140,20,0,11100,1
6e5844a8b4051615dedf0233c41fb7a3,101,64,2,353.5,101,0,01026,3
0c926782d86a4e4335a78ff75c3e15aa,56,46,2,196,56,0,11100,1
0d205cccb830678e8f21558c3c330db5,177,110,3,413,177,0,02650,3
6aae42a92c0cdd9f511d132b353fce1a,32,32,1,224,32,0,03050,1
b7172f5ea27c7bbe406a8843e9cea6ed,291,157,3,679,198,93,05040,4
ee68f4fa8d581b11ba207a9f083fba8e,142,101,2,497,142,0,04020,3
2cddd7aeb12ad9a3b3102435b925fbd7,99,68,3,231,72,27,08052,3
547a19c294588985a3e670e94f9c1f71,18,18,1,126,18,0,03030,1
89a5046cc1cb741e04bf1a92b968553f,140,89,3,326.6666666666667,140,0,10200,3
904c358ab85ffb4a1cf7c028aa803f3a,11,11,1,77,11,0,09010,1
e776e150d656f12586779c90678ecb6c,242,111,2,847,242,0,05040,4
3d4e58d8e4e9fc950dc19ef86e1c2160,10,10,1,70,10,0,05030,1
9b767d3205e31d3a0ddaeaf888e66785,40,29,2,140,40,0,10153,1
4887a3948370ee3505a42f4e66b8a87d,26,26,1,182,26,0,03050,1
72f5ad29bc9b89db95f85da618f1c7fd,222,133,2,777,222,0,11040,4
06a0db990d326c4af6a29c5382433cc5,199,108,4,348.25,165,34,01026,4
b39a0f8454b01ab55dc0f199e467c368,128,98,3,298.6666666666667,128,0,05030,3
7fd3977ad48542cad97f24d0a134bdd3,36,36,1,252,36,0,05040,1
a9737b69b38ab586ea6ea6d7020940f1,10,10,1,70,0,10,11080,1
4e52f87060410c7ba322ba1e69a392eb,80,70,2,280,37,43,01013,3
6934466080fe195eb1ef5a98ab450dcc,17,11,2,59.5,17,0,10080,1
4f00997c3ae9bedf52e9ef1fee282a11,48,39,1,336,48,0,01012,1
6e853d6d717538dbe654bcba1becc561,181,66,3,422.33333333333337,181,0,08090,3
59eb73d57a483040f1812fdceefbecdb,45,41,1,315,45,0,04080,1
261b7ab8189b6d492faeff743b4d7013,55,47,2,192.5,55,0,05041,1
339f60858b616e858260b901097983bd,33,33,1,231,33,0,11100,1
d650d6326eb509604a72a4380c55ab35,14,14,1,98,14,0,01026,1
a765a8396ae163d800fddb02d5868376,55,45,2,192.5,55,0,01201,1
1e920afbe363e63a970ede60a6d8c4e8,66,50,2,231,66,0,04060,2
fd198399ebd1cb601fa09587394e60cd,27,23,2,94.5,27,0,05040,1
b8cdaa1cefb3c69093295e22bef6928e,83,70,2,290.5,83,0,04060,2
4831b4e1841be6f0cacc4b49ed2c8717,1,1,1,7,0,1,11040,1
7821e7647cdd938289910f06aa0f37fd,150,105,3,350,101,49,04032,3
0a71231be3e6794a1da3201fdf2119d4,47,47,1,329,47,0,05100,1
ef8c8f7281ac9be453b3f8e2f0bb80f4,10,10,1,70,10,0,01026,1
78331764c4939755f52a1dc9ab43501f,17,17,1,119,17,0,01012,1
e8c63089ebef388dccf640a43cc412ea,254,127,3,592.6666666666667,162,92,05040,4
903e224ac4484a3f36adb8890abc16d8,309,170,4,540.75,222,87,05040,4
d1aa7f54c6f51cd753d6ca076f936b94,79,51,3,184.33333333333334,48,31,05040,2
e3b3548e054531ece5f4a859647fd77f,841,254,3,1962.3333333333335,841,0,05040,4
b507b7ac7877c8bdf03e5d3af69b721f,1,1,1,7,1,0,11100,1
3c9339dddd46b77f9bab8104c588edb6,245,134,3,571.6666666666667,195,50,08010,4
d931548e8b63ec7d14ac06db5f5150f3,29,29,1,203,29,0,01026,1
3e29208b4f3f26be1b159a8025aa7641,5,5,1,35,5,0,05030,1
ffd49b7e6148f2a95f8f0111ff85a966,66,53,1,462,66,0,03070,2
fa25ffab4c12a3d3de437827d6c27e78,88,70,4,154,88,0,05030,3
8281ae3eb9a35d9283880b32aca0069d,67,58,3,156.33333333333334,42,25,01012,2
15bf8a5377dbcccf2bc187559c4cadd1,106,72,2,371,106,0,05040,3
2f08df1c383a56546410d1efd2e6cf36,55,52,2,192.5,55,0,05040,1
a23a93a1791efcd3b52c207885daeebd,20,20,1,140,0,20,12570,1
3e1b38e50e7f236fd271ffc432ae3585,52,44,2,182,52,0,01012,1
65147291c5acc58e38cf26333047fc53,29,29,1,203,29,0,05100,1
a560ff23e300ec8d372f61ae83819f0a,25,25,1,175,25,0,05040,1
00341ca1bf2dd3066c42f50685697f31,119,81,2,416.5,73,46,04020,3
2b88e91011de91e0a8e768434d4c6e64,99,83,2,346.5,99,0,02620,3
fc11ff703bfd7b32acdf237d6e3b6c09,112,85,2,392,112,0,01026,3
19ea733dbe8c760efec0fd3332ad6c0c,4,4,1,28,0,4,10152,1
1276e58ae96158798877f98b4c152cf0,115,64,3,268.33333333333337,115,0,10200,3
886280b28d74f4c1d150912c6dd7919d,28,28,1,196,0,28,01027,1
1da5d7df697137204a7b0345bf088b83,245,117,3,571.6666666666667,245,0,01026,4
42b0205f64b21f1923b6073a0deb6742,105,61,2,367.5,48,57,01027,3
bb3d8c27c1294a0f088d1aba29b1be6a,282,79,2,987,282,0,10200,4
7f47723dbda8c9bd64820bc1157a2dc0,7,7,1,49,7,0,10200,1
1e92ad2b024f259e40a4119f7327bd24,21,21,1,147,21,0,03050,1
92def3fe84f244f6a8d54c7bf6a3b486,37,37,1,259,37,0,10200,1
405e304d1baa4ff7a7196660e144f196,35,26,1,245,35,0,13720,1
87cfe270fb32ba10a2de20465c0886b7,545,168,2,1907.5,66,479,01027,4
0e049dc11b80379193e9f5a496db0879,201,101,3,469,201,0,01026,4
fc56ea4f96ff097d3c9404bfd431a818,115,66,3,268.33333333333337,83,32,06100,3
099114118ab84751dce9e099b35f0a8c,394,131,5,551.6,203,191,05040,4
70e4fa639548da5598011a3de0ae0c06,43,15,4,75.25,43,0,05030,1
66650d06f053979d3d787d01e930de38,29,29,1,203,29,0,08230,1
222d695df71453709e77591d093e81d2,9,9,1,63,9,0,02751,1
6743cc40cf7bbfa6b0a34352e26ded05,82,82,1,574,82,0,13877,3
8f299806c68199f54cead4ac8b51f529,158,114,2,553,158,0,01026,3
4cdeae45b3fbd22c6bf07034e0b84133,97,56,3,226.33333333333334,97,0,11080,3
da5e60e14c713270025492ad483f5f8d,271,75,3,632.3333333333334,271,0,01027,4
c55da780a1209fb2d2fa95bc1418aa42,150,106,2,525,150,0,05040,3
0610a634e5515882ae2000f37b985025,82,67,2,287,82,0,05040,2
4b9d85bd48f236189f201990740dc20c,36,34,2,126,36,0,01013,1
f300f05555dbc2e7d8a050629d5b0535,21,18,2,73.5,21,0,01026,1
9d64c48379d5828558e095765f8bac6f,125,87,3,291.6666666666667,125,0,11080,3
06dd1c1cf10fade22ccabe204faf4ce0,115,69,3,268.33333333333337,91,24,10200,3
b6231475375ab8d39f3be7d33dc4b6c5,127,80,2,444.5,69,58,05040,3
88dae00e98921334cb32b70d567437d7,185,99,4,323.75,154,31,01026,4
38dfac0be14b42dc166b82f96e8d1eb6,55,49,2,192.5,55,0,10200,1
f7dbdbfbbadc99e18486e42d1cb82877,11,11,1,77,11,0,05030,1
d8caf6471da61c57f1f894df4fc7b47b,107,76,1,749,0,107,05041,3
16910cd9a4517018434844240f86e4b6,82,42,2,287,82,0,09090,2
2d226291e3ea5b585bf2f5d20182acc6,44,42,2,154,44,0,04032,1
7deb6444e71bea5805c77fb8593111c7,76,52,1,532,76,0,05041,2
0bfe87f5754a69745dbbc577f293eeaf,113,56,3,263.6666666666667,113,0,10240,3
76e23da9f4dda67008d7bae1e08ce6ec,15,15,1,105,15,0,10200,1
8b0d34db944166d112b502e09ccbdf32,82,55,2,287,82,0,09150,2
24400a95bf15c4be17cb7a22abf51e73,53,47,2,185.5,22,31,05040,1
107d829b016a940b3580f9b10aa14fb2,16,16,1,112,16,0,08452,1
8c1c61ae4f64d04c75b8467e6f11653c,31,31,1,217,31,0,05040,1
87bd3cda6c8b247baefadc62e26bdc14,88,37,3,205.33333333333334,53,35,01012,2
718b8b570d75a03bb0630d594b01b0fa,63,39,1,441,63,0,04020,1
5262de0fd5cd6b889186b6fc5189516c,23,23,1,161,23,0,08100,1
9af9392a560e40b821800460ea93b62a,41,25,3,95.66666666666667,41,0,12410,1
8f2ad4e32809774b7528653d6dded47d,3,3,1,21,3,0,10240,1
e8908eca6905096eef6e96051bad0b94,10,10,1,70,10,0,01012,1
1fc687ac8935e5a93e56f1e90be79003,41,31,1,287,41,0,08452,1
e450e3a0dbacb6f202b4512ff294a089,43,43,1,301,43,0,01026,1
d2ee91f6b2f2a0c8d05f6cbc608ce6ad,68,60,2,238,68,0,05040,2
14febd14ff3e2c368da0f84fcfea618e,102,80,3,238,102,0,02691,3
82bacc489ac09ff1ac4f7f292adc6010,15,15,1,105,15,0,08230,1
1b924e4629ba269c28d96f6b972bc495,65,58,2,227.5,65,0,05100,2
3b2530dd22a174f310178576e102a430,50,47,1,350,50,0,05040,1
41022282a43c4d6abdd21cbf1955c703,45,39,4,78.75,41,4,04060,2
c1d22b98e8c8e41f4d7940b6d6658877,66,60,3,154,35,31,10040,2
69771a39b2c5139576b00e58ea47d5b3,90,77,1,630,90,0,09010,3
da7fe7c643033d77ccea0930430edf9f,334,73,3,779.3333333333334,309,25,10140,4
4bf12b5d5d6a67dbe2275aba6f10a32c,789,149,6,920.5,683,106,01012,4
a6b2086e82f5965bafe28ada8b2e791b,11,11,1,77,11,0,13930,1
cd058c3ba61007941414819b4d9008d2,31,31,1,217,31,0,04060,1
3ffc9ca6d5726eea6901c905d2b156a9,414,141,5,579.6,414,0,05040,4
5f2fbb267af848065f43f9794567298f,153,114,2,535.5,41,112,05100,3
ebf393306204bb590b4062c67e8f4f67,33,33,1,231,33,0,10200,1
34cf7d35b077ccdf99a1bdec7c8643af,60,60,1,420,60,0,06100,2
d8ddfaa4b63c319d19c530f8b0957ae3,278,97,3,648.6666666666667,206,72,11040,4
241280b7d9062f98106df7acec16b5d6,58,42,3,135.33333333333334,58,0,01085,2
849ca44633c1a27c73d67a5666c5f9d8,194,95,2,679,48,146,05040,4
6146c9e3b83477330ad869d5c82987bf,51,47,2,178.5,51,0,10040,1
ead4a9115ffe8e978805b1f4c68edd22,261,128,3,609,261,0,05040,4
8bf9f3d4510ce056cd0c7e670621e1e6,15,15,1,105,15,0,05040,1
9f7c8ee5acc321cbf372abeca9d74ada,51,46,1,357,51,0,01013,1
c19e29a95f613de598225f01af737019,23,23,1,161,23,0,05040,1
8eeb1a6fd24a9f147d0cdcd56149699d,21,21,1,147,21,0,08390,1
015be0cae058e56a1873b8cd19ce6173,39,39,1,273,39,0,01027,1
28a407093053e0aee710fcedda559f69,60,48,2,210,29,31,01026,2
e3bb4a9ecc7fc936b1958dfedaf28116,32,32,1,224,32,0,09130,1
0890d9acff256c47f7fa107239cb0068,50,50,1,350,50,0,13820,1
75e6b649a3652c285ecd6a7c84cbe7fa,205,116,3,478.33333333333337,205,0,08010,4
00723ea93efad2f4c7b36491a50662b4,22,22,1,154,0,22,04032,1
37ba31e15ddc3f3edce5b783507a11e0,142,77,3,331.33333333333337,142,0,01026,3
de33534dbf5dd05a76bd51b03f07dca2,363,183,4,635.25,198,165,13955,4
c4673b9e64442627f259d75df574d1a3,15,15,1,105,15,0,09010,1
1969eacf26fe2bba310338c5da9a827f,439,236,6,512.1666666666667,385,54,05040,4
5d68c1b9f59e62e9f3bf337e7fb6ff74,368,221,4,644,368,0,01027,4
1a5b9cfad84c37e8e1794f726df86833,142,76,3,331.33333333333337,57,85,04200,3
b60a92f1eaec4bf95f76efcfa6427381,80,50,3,186.66666666666669,53,27,05030,2
4c764d2542a936a0b9e5f2e454cf6f9e,117,117,1,819,117,0,09351,3
589975738080a26ca9d19f141ff61774,96,71,2,336,29,67,05040,3
b34836164e53be5ca03096a83bda27f6,40,38,2,140,15,25,01026,1
36377a992186a06848c4e78424d9c4ee,119,78,3,277.6666666666667,119,0,01012,3
98f55875b6e7e9fdd95a4212a2a05f75,102,40,3,238,68,34,08231,3
f2e49a85ba463632686e5638f53dae6e,17,17,1,119,17,0,03070,1
5de9754ae03718eb0e7681f86aaba69a,64,44,2,224,39,25,09130,2
9704cdce454a65675a998cd366975911,110,65,4,192.5,86,24,01012,3
f33f8e713c4e612d0b78e1ac7b79d502,469,227,2,1641.5,363,106,01026,4
abb23f86f4877d70b2567e99ff8b658f,95,62,3,221.66666666666669,95,0,01012,3
0704cf4e641470d925212d3e6b8a3e69,110,82,3,256.6666666666667,110,0,09030,3
ca3399a0a710bdcf430dcac04247ced5,79,60,3,184.33333333333334,37,42,05040,3
b5df8b4cb0b837470a97cbbb0c34e180,63,63,1,441,63,0,03070,2
972ba6023d91df395cae6efd16811996,90,69,3,210,90,0,05040,3
6893d57835a26343a38afc12f46195d0,45,45,1,315,45,0,01012,1
61038666dc20383fc3bb116606dc111a,9,9,1,63,9,0,02620,1
883fb445a2bc1ad3d2d75f9989294354,40,34,2,140,40,0,11100,1
118e70cc06e647336a4e39ea02f8a1aa,35,32,2,122.5,35,0,03070,1
b1baca61116a61211b2cdf88aac8b03d,584,151,3,1362.6666666666667,409,175,01085,4
f823b141737d69bb354243b457de2c41,153,94,4,267.75,109,44,01012,3
346f21a217ec749b96bd74c5e9fe1f1c,25,25,1,175,25,0,03033,1
2f836ee9b6bc534fb29b5f72470204dd,8,8,1,56,8,0,14301,1
d0f2a4fb1fb1c665ab3ed94cf539e660,55,43,3,128.33333333333334,55,0,05030,2
7439535c1f2152881711848b797c8ab1,554,148,1,3878,0,554,01013,4
1bef1b784525fc3271214c91de953062,21,21,1,147,21,0,05040,1
13d75a1537fcc18fbfee38bfa0802e99,30,30,1,210,30,0,01085,1
d4be3754a989c620f7cb28395e2341c5,143,97,2,500.5,39,104,05030,3
f44cdf94beb5834dc815b0f61b3c0257,34,34,1,238,34,0,02690,1
2486582b8cd16510b7b288891176f435,187,93,3,436.33333333333337,187,0,05040,3
2d06760c7957c3b816f15598ffcd9cfb,658,174,3,1535.3333333333335,496,162,01013,4
625f3d804d9e7bd3550a135b08f0f3ba,382,146,3,891.3333333333334,382,0,01085,4
0355bc96dd36f6827912c12a85effb4f,19,19,1,133,19,0,01026,1
30ed581de0f4f6b6c309c12d009a35af,42,42,1,294,42,0,08314,1
a22d46e730ebea6446a6d13fdc987669,35,35,1,245,0,35,08231,1
2d1a43b67b802b982a51baf5f9d27dd4,50,35,1,350,50,0,01027,1
0fd909116da619b115473374bfcb3938,287,137,5,401.8,222,65,04080,4
ae4615806748f79bad31e80191776653,52,25,3,121.33333333333334,43,9,02651,1
65184f8eb431aa8882ad6897cc91252f,84,66,2,294,84,0,10028,2
2af9012b5dceda1b96501d42b945a40b,26,26,1,182,26,0,01012,1
cc205a9e9e20334c73dd46c3a38028ed,617,126,2,2159.5,566,51,05040,4
3fa7487c9343d7750c2f2c4c213b74ea,13,13,1,91,13,0,03050,1
c43d40ec64259ec36de6f3a4478b7cba,46,37,1,322,0,46,05030,1
fa349ecbbaaeb8f2db9d02e525dfee32,33,33,1,231,0,33,05040,1
eadaeccb65fe888d8394443f4e1c5900,6,6,1,42,6,0,11040,1
37d71a27b94adb8c46e6d38af2ecd549,26,23,2,91,16,10,01013,1
6f039b45a61df20aea2c5aa206ada24f,160,80,5,224,92,68,11040,3
53844068acc6285f711b92c8f07e6863,38,30,2,133,19,19,03050,1
cba644784372c065b54a0534b0d894d0,157,85,3,366.33333333333337,82,75,05030,3
8d979d890b829092f1ea430d27cc06b5,37,37,1,259,37,0,10200,1
ca390fd9c730d0f921d80d4e3e9a78c4,17,17,1,119,17,0,05040,1
d91405de80c29ba3148be16860392b1b,23,23,1,161,23,0,01026,1
bdf239d8c7d5d14e71454ec8c87ca866,203,119,3,473.6666666666667,86,117,05040,4
1a4732c429ccd37bf1f528ac471040bc,238,83,5,333.2,238,0,10240,4
1363ac9bda925ef75b3425ae9d5223cf,40,40,1,280,40,0,09090,1
d64af59f1053993fb2f467a76b524352,289,123,3,674.3333333333334,168,121,01027,4
c5f53d9e8cd09daa23105e28308c12f7,6,3,2,21,3,3,05030,1
774fa4f99b8ea241594cacfeaca812ba,21,21,1,147,21,0,08452,1
0faa76ecccebaa3f282f35a2b169eda2,58,39,3,135.33333333333334,58,0,10028,2
fe60145bcba9b1fbdd403259e8d49a33,22,22,1,154,22,0,08313,1
ce6104e96fa19e5d304ac022acf32c18,37,37,1,259,37,0,10028,1
4c92f5ece7e1545bb4b3d6805dd8c8b0,117,59,1,819,117,0,04060,3
ddd4c2351558f13acc6c83091cbbcb58,77,55,2,269.5,77,0,01085,2
3baff05087109cc6f4cd5ebdb58b5683,71,55,2,248.5,71,0,05040,2
08d7327ca0bc44a285d50020d179330e,49,49,1,343,0,49,01013,1
b630d98dd876053d42b77da1b670b7ad,226,116,2,791,196,30,05040,4
9add3117ce6220834e6d36d6823bca04,124,82,2,434,37,87,01026,3
3cc5e55e42bf03c2bb84bc91d10f9af3,107,66,3,249.66666666666669,68,39,05041,3
7f7ff9afa77b2cff788f61585aa5cb4b,25,25,1,175,25,0,01026,1
715fd3f533e1e564e203dea1d5da8fcd,95,68,3,221.66666666666669,95,0,01013,3
3aab1f55d12258419d0459dddef0c4ce,95,83,2,332.5,95,0,01026,3
106c6d0c17f46d71ebd5f705d81c32a3,3,3,1,21,3,0,05030,1
16bcb8ff5aeb85a406711dc2b2589ae3,93,51,3,217,28,65,05041,3
9e4df4076cbcf2f6319822513bd634fd,49,35,2,171.5,49,0,09090,1
a7485d70e807fa0a9a813cd1a12525ef,44,36,2,154,44,0,08230,1
34bd837a8ac17b56405edc020053e012,526,154,3,1227.3333333333335,484,42,05100,4
d3d6a5e76ef008eccb834e20b29c2c91,94,80,2,329,94,0,04020,3
2bdd383278b55f40b744b757becca404,103,76,4,180.25,103,0,01012,3
b1f42704d9ceab36bde72034547effa6,43,43,1,301,43,0,05040,1
1122b0a9e55c919c10ff5adb9b981677,108,63,3,252,108,0,03050,3
64a50af6f4a8a4dc2c9c8f08125db10e,124,83,3,289.33333333333337,124,0,11040,3
ef23cb77c518c3fcbef0106f47c7535a,25,22,2,87.5,25,0,01012,1
02659f7ccd064d31df08243e2b49dfb7,292,157,2,1022,192,100,05040,4
9b89522dfb2e771643017620fff6e07a,71,44,3,165.66666666666669,43,28,03050,2
e91a4150487e9813afb8655678f17ff8,27,27,1,189,27,0,01013,1
39a7295230b527dd6849faf3c9638b92,28,24,2,98,28,0,05030,1
a11ff6f237fbfca787dd1f3d03b18b4d,70,46,1,490,70,0,05030,2
53eb1b3ae6964f20bd27666db1447560,108,79,2,378,108,0,05040,3
9464ddffe9af79152f7783d995c6cfeb,298,82,3,695.3333333333334,223,75,07143,4
916153d047a8e4b1debbe101496856dd,168,114,3,392,168,0,03070,3
28faef534854f5d8c1867918aa6cca0a,16,16,1,112,16,0,01201,1
dcf67ca00d064e8659d8345d0a6e63a4,222,148,3,518,177,45,01085,4
b1bf930fb4eaf89a3439376006bee8cd,28,28,2,98,28,0,05040,1
6e2f677f4bcbb61d83336493b8312199,111,96,2,388.5,111,0,05100,3
a3e8f5bd52505144269699b427ba800e,335,101,5,469,335,0,01027,4
7f259589acaf932b780c3f690f7f9e57,41,41,1,287,0,41,04060,1
bc5df5dd43d7d2cee3911065e76db278,62,43,5,86.8,55,7,05030,3
ff4c49497ac0b96f4851a95040dd5ac0,125,70,2,437.5,12,113,04201,3
68161a65c3a3f96b6487fb6243464637,114,71,4,199.5,89,25,12500,3
9281f15d8f37d081b97601419b409d6b,36,36,1,252,0,36,05030,1
76e90bc07aac484d45f2c98182a130c7,46,43,1,322,46,0,01027,1
a992e34648ad4970af21678c30746970,101,74,1,707,101,0,01012,3
ce8ebdfbe24f7dba8df737b508db423f,313,158,3,730.3333333333334,313,0,05040,4
ca6aba72efaf56c8da5adebacc5284c4,41,25,3,95.66666666666667,41,0,05030,1
310c0b68081d274519de12cc5de72c27,33,33,1,231,33,0,01026,1
cc1f16c28bc8455624033a4f3a8b22f7,108,81,1,756,108,0,01026,3
d03199c36cc3cd7ebde5911d90ed80dd,35,35,1,245,35,0,01012,1
a6915c911597abbaa90a62bed3ad5d5f,98,52,1,686,98,0,01027,3
c1ce088c83a24e2a51b6ecee87ef4c58,53,53,1,371,53,0,05100,1
fe870324b68027e966d3473409e4f260,71,47,3,165.66666666666669,71,0,10200,2
050253dc6b01c79ee01169184db54572,237,121,4,414.75,194,43,01012,4
c9103f78332fd5e45b683e7aa0ecea9e,35,29,2,122.5,35,0,03050,1
67183cfefaaaac30b971f87dd16f3159,54,44,1,378,54,0,05040,1
5b469680c65216d5d71dd33328e61ccb,97,76,3,226.33333333333334,97,0,01027,3
40de30d8c29e1293bfebe07561af6439,1,1,1,7,0,1,11040,1
898e573ca772267ce89ab244edd9b280,50,42,2,175,20,30,04201,1
333481031ae22da09271e5d62c155406,38,38,1,266,38,0,01026,1
d10868e1d2322bb8c18d44231f67cfde,58,46,3,135.33333333333334,58,0,09130,2
e9c4eeeb1efb198594a72b125c1bab24,57,52,2,199.5,57,0,08170,1
0b367cb72fdec48cdd1a9b098d88216d,128,128,1,896,128,0,10200,3
8483ffec9e67d716a137d6a0ffdb7024,13,13,1,91,13,0,09010,1
406c8bd73bbed6fe318891f49fa11718,182,88,3,424.6666666666667,134,48,04020,3
9964d83803eda37d65505393a0dc003f,86,64,2,301,86,0,01026,2
6570bd78d41c12ac34f0beff8c3a95e1,21,16,1,147,21,0,11040,1
0af9fb33a3217fcd0dfdb5fd7b124b9d,109,58,4,190.75,109,0,05041,3
b290d7a5e0ccbe2e8df1ec40fbe7a38b,24,24,1,168,24,0,08051,1
1d49479352139341555944d2b12fad57,46,43,2,161,46,0,05040,1
30bfb30478fdc2c0a472ea26967b12d5,2,2,1,14,2,0,04301,1
e803a1a81760c425d4c57e8245348b3c,81,60,2,283.5,81,0,04020,2
4b217513af7501a3b95c6704d0ce7bc0,28,28,1,196,28,0,05100,1
c527eb37f09b9c59a1b92b9b85e292c1,79,55,1,553,79,0,14301,2
f588ea285cf6b0e823dd3dbdd2398e84,35,30,2,122.5,35,0,05040,1
914844332665399d11a7138be370c656,162,129,2,567,54,108,01026,4
5b8f64535bd13022bf157aa3e515d31e,35,35,1,245,35,0,01026,1
d3827efbd27b683d7640f7f07b97d2db,39,39,1,273,0,39,01026,1
48851f4bd2a662d5da06e0b537e0d0fc,22,11,2,77,22,0,08100,1
751a97c9a62240af6550146b9e9c4571,2,2,1,14,2,0,12500,1
15b3ddefe83d3a5aac2bdc676d6f98ad,9,9,1,63,9,0,05030,1
d35a10db925124e54d86d380bebd6eb2,31,31,1,217,31,0,08312,1
d211d84d7539aac6eeeb776107cb66a8,132,107,2,462,132,0,01026,3
d32aa539511067a17c59094742d24327,242,125,4,423.5,212,30,11100,4
6b58259bf1191d732d1902ab5f334f94,193,141,4,337.75,101,92,09130,4
6128321227e56f4f94aa4afcb7a5bc05,20,20,1,140,20,0,08010,1
965e3903f705c704b9ae9e8d0482b76a,70,39,2,245,70,0,05030,2
9670858dc91691d5aa366079a7fb56eb,22,20,2,77,22,0,11040,1
e98d1beb62c542acdec2943d6d09cf48,25,25,1,175,25,0,09170,1
345179f28e0fae08cad536c2be37bad8,109,81,2,381.5,109,0,05040,3
dee6b0a6c2f07729eb2950bf502e40ab,12,12,1,84,12,0,13720,1
8a498c5bd9dfd9f29b41cfe1f075bfad,75,61,1,525,75,0,05040,2
4ec69f7a94b414aa28e0eca5871f2833,3,3,1,21,3,0,04300,1
4dc776a396311fe65990fc693a760774,26,26,1,182,26,0,11040,1
5a85a29a0b1df68edf4f951bd4cb3bd8,84,71,3,196,84,0,03070,3
1aae270eddd7d1ef418875b70e6d47c2,92,77,1,644,92,0,01026,3
6aed1d32630c52cc200b3bb4a2d5d721,143,95,3,333.6666666666667,100,43,05040,3
951b2862b48ee6f911f306d07c4f5fe2,98,79,1,686,98,0,02751,3
fe21b09f55e84b25d4dca80a49633c5e,49,49,1,343,49,0,02650,1
9368fd43232acc58a54ff8b6476001f9,39,34,2,136.5,39,0,11100,1
ebfebf5c132b3c3f924b135c712ff171,32,32,1,224,32,0,01201,1
4f0653ecc12d95d586dd5e54ef67aad7,191,83,6,222.83333333333334,158,33,10040,4
32ded70853a0f62740488397ab6600d0,38,38,1,266,38,0,01027,1
dd1ed0837b6c6fd6e840696c17059975,173,86,6,201.83333333333334,160,13,05040,4
ce81ca62b59560e69a407254a6c0713d,12,12,1,84,12,0,01013,1
495dee3e70e9e1bcef1eaab5d290315a,47,47,1,329,47,0,01016,1
293f4266fb8f713c0458e9b36bfa22ab,43,38,2,150.5,21,22,11040,1
8f2b4a70b3191ad72f5c2c1d5d120c06,39,39,1,273,39,0,05100,1
3b4de2f6709970d11e09b34752c488d1,21,21,1,147,21,0,01012,1
ca1b89e2917b3faee82c884d84266801,402,140,3,938,402,0,01085,4
bcb3fa723c4ebf5feb49cbe6823ed73f,115,73,5,161,108,7,05040,3
c226ab77a9bfdb4e02019ae6e9d049f2,93,74,4,162.75,93,0,04020,3
0f1d95528ac180e4afcecb7bf7c0a03d,50,50,1,350,50,0,09130,1
54c8614927cbf74ca5ecd0cb0d7c8678,36,32,2,126,36,0,10200,1
c5be6fccec5734e399da0257c7e5da64,54,48,2,189,54,0,09130,1
678b58bb899a9728aac721ec583232e3,19,19,1,133,19,0,01012,1
daf4eeb3e135048aab39e67e9334470f,59,46,2,206.5,59,0,08312,1
102259209973d3e46ebe68de15726d02,75,54,2,262.5,75,0,09130,2
742ff7191e14b761a8e0a641c27b9b8a,27,27,1,189,27,0,12570,1
78221ccfa94bf93c678a158f425c271b,23,23,1,161,23,0,05040,1
a3c1de8d0c7ddb476c5902d8ec252762,178,74,4,311.5,178,0,11040,3
681870af9f36127fd96fe0551d34923f,25,19,2,87.5,25,0,05030,1
0fbdbcd34879e672ac05fa6dd38dcb08,213,121,2,745.5,213,0,05041,4
bdb552cf6facf9ba9bd778ba77610601,56,51,2,196,56,0,05040,1
006e1d7694bc4d644adb57585679058f,22,22,1,154,0,22,05030,1
5bad6cd52c3b08b75698c900cf2b4601,133,81,2,465.5,3,130,07144,3
d6c38f10e9511b8f000aa160d92f755d,93,60,4,162.75,93,0,11100,3
e4730ae0d90ffff22eecc6f6ef70eaba,84,69,3,196,31,53,08031,3
36f0f0a7ced6501af70579f35ff9f788,68,53,4,119,50,18,05030,2
184936e18e0bee7288b8b191582bade9,149,109,5,208.6,149,0,04060,3
d29cd40d7f1fcf044735208e770d4fae,41,34,4,71.75,41,0,05041,1
ce5db5371dc5c5b9be74e44d1857ca1a,214,117,5,299.59999999999997,156,58,01026,4
e76e0c007ea40fd75c18d67ad3cc6b27,73,41,4,127.75,54,19,05030,2
919d4ea5833bd0a23d8112c888707acf,50,39,2,175,50,0,09010,1
66e1b49c1ecdf2c18d62af23f30b55d0,26,26,1,182,0,26,08100,1
cc938135868624a29debfc8f7634e6c9,42,42,1,294,42,0,01013,1
bf622be7858a535a17b17cb309af73f0,20,19,2,70,20,0,13930,1
c3de9e08f1f30ddd04b0df5c5af241db,81,63,2,283.5,81,0,10040,2
710d782d494476c629a610fcb536a8cc,58,43,2,203,58,0,05030,1
d3aaf7edcbe1a77b5990c5c6c11cffb6,218,51,5,305.2,119,99,01012,4
b4bcb799f5b6e48c6b0f17ef903cad5e,25,25,1,175,25,0,10153,1
ce848dd32e2dd1b468bccb41417569e4,105,91,1,735,0,105,08052,3
33702390c873516d04572e2bce7a072d,36,28,4,63,23,13,11100,1
2583b73e29554295b16ec5770c75543b,20,20,1,140,20,0,01027,1
8849e9b79131cc7f44272931b55a5e99,17,17,1,119,17,0,05030,1
58cb7be9d36f09c3292ab2588f76acc0,49,42,2,171.5,19,30,05030,1
288e6c37a48c15b1974ad167a8e581ce,93,79,2,325.5,93,0,01026,3
5fb5169fc1481a2c6e0fd3bec76d4267,78,61,3,182,55,23,09150,2
0cb2e841256ff615cc9976449a227b6e,499,172,3,1164.3333333333335,499,0,05040,4
7e0c3eea3b2f3efc611602f8c91b69d7,407,177,3,949.6666666666667,368,39,01026,4
8522d1cf202a689ad200217408fedb95,55,44,2,192.5,28,27,08010,1
8ee69d89e9e85a752049409ac182cb36,33,33,1,231,33,0,01026,1
b65c09d55fb0424d9b4da73effb76bf9,27,27,1,189,27,0,08391,1
ee6b6cb26e89021e45ef01c851b8adff,214,119,3,499.33333333333337,115,99,01026,4
7798e44ab4ace48eb3a349bd8a856629,35,32,1,245,0,35,10153,1
e55d7f08765289b1f382d4f70eee640d,274,91,1,1918,274,0,05160,4
3fd8913a13e36f4ba4ac4217c7b273aa,9,9,1,63,0,9,02620,1
c7374a0135e57bd385c8c42cc14d8cab,83,65,3,193.66666666666669,38,45,09030,3
a9f6603568078727cd8c2bda675b702d,45,38,3,105,45,0,01085,1
5d4b5649cfed13ad5e9c88e1626299ee,73,52,4,127.75,47,26,04020,3
f1c7af4f9e44bede294d6d6ffdba0d33,115,88,2,402.5,44,71,01013,3
de3b0f3622d734d9e336fb2235a92a75,203,95,5,284.2,184,19,01027,4
01b9cd10336b29c0695a959606e7ed3a,124,90,2,434,85,39,05030,3
09527098e600eda1c87af7840fa7f2bc,32,32,1,224,32,0,05040,1
b0eed593616d4f555c784f06b9a66437,20,20,1,140,0,20,11080,1
b5971d9a27f3aeb64fb6111080c243a9,219,106,4,383.25,185,34,01026,4
3bb076412be7eb7fbb4f191dec46715e,26,26,1,182,26,0,11100,1
a257cffe2f5571132353a1b6077ab263,17,10,1,119,17,0,10260,1
6f755496f2476217ce32e08c1f397a18,50,50,1,350,0,50,10080,1
d9d64e7362797b90c8012f93e7730ce4,20,20,1,140,20,0,05030,1
430e5b37eeda56639ad1c087ee21fcb6,98,84,2,343,1,97,05040,3
44f3e75bf260b3e14237e3752fd37cda,182,111,3,424.6666666666667,182,0,05040,3
e403229bbe6566d490fbd76177a57560,149,81,2,521.5,34,115,05041,3
e393125413638ac30ffca92e98ffa2f1,149,121,3,347.6666666666667,109,40,01026,3
844e0fb91baed3eb994d510b8ceeedaa,46,46,1,322,0,46,05030,1
1be32bfbc91371a80dd8295de3606f20,22,22,1,154,22,0,08100,1
468283b3b277127cc3bf67ccce4e1161,15,14,1,105,15,0,10240,1
580523dba8d4054bd4d4cb47ed5de99a,235,136,3,548.3333333333334,235,0,05040,4
fc1179b9de7d8e6cdd0d28c647c6e488,28,28,2,98,20,8,08231,1
8c43940554564eb56ee09aaebcbef31f,152,89,2,532,51,101,08230,3
ad669cf1d384600fb528c9ae44ddccfa,76,57,4,133,58,18,11080,3
58e9d58a1779241060e55acad4c89a1c,88,51,2,308,88,0,05100,2
566bdc295d2973ec6530763f085c7abb,47,47,1,329,47,0,01012,1
b88d97720375b8bbac2c104db159d652,111,70,3,259,111,0,05041,3
3c714519ef5ccf624f8dde737f718bdc,60,46,2,210,32,28,01026,1
74a44e56db6b4c7dbbd0e95480b5a468,176,83,5,246.4,176,0,01012,3
7d84030ad976776df610248e1e7a037a,15,15,1,105,15,0,09130,1
d7f5252dd74e49449aabec1b5e607a5b,103,81,2,360.5,41,62,05040,3
256558dbff0ca67d4f5aa019ff7fa6c6,45,38,2,157.5,45,0,01026,1
a1fc2ed9c624f8a5a4471ff2603d1f9a,62,54,2,217,62,0,05040,2
7000571fc84b6fdd857050194548fb49,274,159,5,383.59999999999997,184,90,05100,4
8dea80c48b39ff81776990a05cba3ebc,17,17,1,119,17,0,05040,1
bfee76f35b23c4d090d314b8f775eed1,52,52,1,364,52,0,01027,1
ffe0098165dbbe445032991836b24217,169,107,2,591.5,169,0,05040,3
b8f6bf63c4a11058c982d69fa7d5d423,143,128,4,250.25,124,19,01026,3
a49cf670878ec67c654b5c5c5867e895,2,2,1,14,2,0,11040,1
64ece39cb015b6118d657c38e0033ddd,348,179,4,609,348,0,01085,4
2bc1bf256dd65ee5c169681a926f05f0,69,58,2,241.5,36,33,03050,2
2c9e7417124113dd3a9f3c03eb19c4cb,167,98,4,292.25,167,0,01026,3
47344194f27f237bd4db748f020551a5,57,57,1,399,57,0,05040,2
33d74546d3dfdefc79e42777a22b02b8,16,16,1,112,16,0,05030,1
ac5579b21c3c0b50c7f8e77b882f6cfb,1,1,1,7,1,0,11040,1
184b32eadbef6935280303e6f1252754,53,53,1,371,53,0,01013,1
92f52e9375a4799c661c8516525e9297,54,47,2,189,54,0,04060,1
2a19a9d54ce5f2fcbfc9d5bccf46efd9,221,87,3,515.6666666666667,221,0,05030,4
120d80b0e3abdb73a00361ede4359ae0,18,18,1,126,0,18,01026,1
9ba4b5bf758692a0b75865aa02b71087,30,30,1,210,0,30,10200,1
04574ab3f67142b9e7107b40af4d3251,72,50,2,252,72,0,10200,2
4b773b7698be29026cfe152c1d3498ab,10,10,1,70,10,0,04200,1
a2af4d15dea6801ffb5c8067d388af4f,28,28,1,196,28,0,02751,1
56657b1e323596c2afa91760feee06a9,82,50,3,191.33333333333334,67,15,02620,2
cf1e824389a7e8ae3f520e596374803a,165,103,2,577.5,57,108,10200,3
a14442474e66edc9b29e3234686d76f2,49,41,2,171.5,49,0,05100,1
de0229707128a61adfc4158bde7ae1cc,81,61,3,189,81,0,05030,3
5379e709f14a2f4688ea3a8641e6e392,99,63,3,231,64,35,03090,3
9bf493012579119303a512676ad954c1,33,33,1,231,33,0,01026,1
8d728e43e10d56da8a46a7fdd396f7ae,80,53,4,140,57,23,05030,3
47fb2209a8250b0105b0d994b4f363ab,140,91,4,245,115,25,01026,3
05332f4008693731387255aead8ed207,422,151,2,1477,390,32,05041,4
a0f72f4aad50e34753e7192625438e0d,107,62,3,249.66666666666669,107,0,05030,3
0550e135787e7d2b6374ed9127942059,246,127,3,574,232,14,10200,4
9b42f2aba9ae6e7bd46e1793fd990dde,430,180,5,602,387,43,05040,4
525a0e6d15521228ec427102f86a3060,33,24,2,115.5,33,0,11040,1
999fdf6944c09d711cefdd52c41687ed,123,87,3,287,123,0,11100,3
5dad5fcbdedb4bdfd516890475bc9829,178,80,5,249.2,146,32,11080,3
56e588d51d189b4eee8f05737f737802,282,145,2,987,282,0,05040,4
b13f482ac73d75ad5cd5ee417f2845c6,24,23,2,84,24,0,08231,1
cdc57fa79dbb5341b3717c384470b4a9,21,21,1,147,21,0,03030,1
67777d257963fc7c8cdd8d5f86dcc5d8,21,15,2,73.5,21,0,05030,1
9e3f024b70d92aa73f0c0c0ea60b8278,37,34,2,129.5,37,0,05040,1
20feeaf6c0a7be1f0944f00ac702fbeb,8,8,1,56,8,0,02750,1
92e0f018f623f7ce21549cc998bb7fdf,20,20,1,140,20,0,01026,1
76e2a675cbabeb7407c6ae4ce85bbc96,58,53,2,203,58,0,09130,1
6a13485c5f4ebffdb1c3f54198211666,32,30,2,112,32,0,01012,1
749d92b8bdd7097b087543bca7fd6a29,136,85,2,476,136,0,09110,3
52c5be0fb92b585b43eda5d0da5282b1,39,38,2,136.5,39,0,04020,1
3eaacbbb367cdc10c6bca2ca3ccf87b9,38,22,3,88.66666666666667,26,12,05040,1
0a36ecf702717e38b52982160c42e166,33,33,2,115.5,4,29,01026,1
85a708a93c3bc7342df7a8b97ad8ee7f,25,25,1,175,0,25,10040,1
a15b052c254e6442c8acecab9e82cb7f,28,28,1,196,28,0,11080,1
b8d4caa751ed3e5b84e3df189c9051e3,81,54,3,189,36,45,11040,2
1f17df711beff859251c1a87a9c3d591,59,49,2,206.5,26,33,05040,2
2757559c8a9d80fdd67378b038b36ba3,82,63,2,287,82,0,01012,2
e93f0a9daf3bee4189428af6458427cf,134,90,3,312.6666666666667,134,0,01026,3
912bd7f8292095f531990227a5739c58,221,128,4,386.75,149,72,05100,4
8208afae1610cdf7abe459a769696dce,29,29,1,203,29,0,01027,1
dc98fe0140ea353873a63c8aa2bb6bc3,208,111,3,485.33333333333337,154,54,01013,4
1bdb3af4cfa35c172c3a94469db28028,182,106,3,424.6666666666667,182,0,03050,3
42d02cfa07341ce82d0e96007e265177,273,137,3,637,273,0,05030,4
6d9902ac7f3a08fe642d9768aec706eb,367,146,5,513.8,332,35,05100,4
2f0b30d2dba78ed26c03823b7890bddf,49,33,2,171.5,32,17,01201,1
110d1123091f7847369ee38644aa9900,116,57,4,203,116,0,05040,3
302c05a3030f75a1f7cf5f2bc77f83f5,10,10,1,70,10,0,05040,1
aea5cc259e5e91fb2ae8bb8a0508a2e5,16,16,1,112,16,0,09030,1
920baf1905a80f11c9a7ef35be5bb4ce,241,101,4,421.75,241,0,05040,4
80dc5e426c1116702ad9049ec8ce2d26,207,59,3,483,175,32,05040,3
55d3c272ed4d930ff9f89878af933967,210,134,3,490,150,60,05040,4
08e65b1582184487bf605c15e9351663,196,88,3,457.33333333333337,196,0,01027,3
4602f71eaa275a2842fb97f4ce1b774d,58,30,1,406,0,58,03033,1
bb4e82425ef48f17f452d3e12f45e416,74,74,1,518,74,0,09091,3
f33f024b4e1c4872f82bc971cf8122e3,61,43,2,213.5,61,0,01013,1
6077dcb712d205e5b1bf2481842f4b57,13,6,3,30.333333333333336,13,0,10080,1
25922936c2754a1ced1ada62b1dbe0b3,38,30,2,133,23,15,05041,1
8e4b6947ce0cccd466c58adc0fa3d3f9,134,102,4,234.5,134,0,05030,3
c1e2fa93cbbce40a51ef7b8e7b146cb0,189,128,4,330.75,154,35,04032,4
0df8d16b2c8174ac4a89c21c68784bc1,193,105,3,450.33333333333337,73,120,05041,4
eea869708765f0f4c6d2c14966fb0895,119,50,3,277.6666666666667,119,0,05040,3
945cfc698d932aa4d777ef0262445c94,25,25,1,175,25,0,05100,1
91128985d2052b2a2f10878d3eda5f45,28,28,1,196,28,0,08052,1
6aba73ae466f83ad36a685299df65942,156,106,3,364,130,26,02691,3
cfeee912c7c47d32fb690775606387f3,151,88,3,352.33333333333337,151,0,01012,3
f401582da142f12c61ab80d39fdc6d15,31,31,1,217,31,0,01012,1
eb7820ba3737089bac8334dd21d44214,63,63,1,441,63,0,10153,2
6a2536e81cb4f67ae64a202d58362daa,83,72,2,290.5,42,41,05040,3
c8e4bf8cbce01990ff0925b616376899,153,95,1,1071,153,0,05040,3
7ab39030e0108845f0132efa5e517c3a,76,64,1,532,76,0,10200,2
0d47deea819a12ccec77c8e0fcb42ed7,20,20,1,140,20,0,05040,1
ddf92431296e882105870c5d457028b4,9,9,1,63,9,0,07121,1
1ee17fe601f2b41b2cf99cde2a93b1b9,260,105,4,455,260,0,10200,4
f29d14b0ebfa7d5bb719379f8c987eb0,17,17,1,119,17,0,09010,1
46527de36ff6c255667163cb6e928576,32,27,2,112,32,0,11100,1
1fa9c154a58ba7eab3faf8ffd5d06a0a,37,37,1,259,37,0,01013,1
dd4efb8d08e400cab46ec8f6a9278ab0,45,44,1,315,45,0,10240,1
e49827d6d01db1225e98ba53dd76992e,22,22,1,154,22,0,05041,1
17995f2d09e6e7ce9b67f53067368f83,54,45,2,189,54,0,02620,1
be60249730d5cc546237fa5819a17d24,56,49,3,130.66666666666669,56,0,01026,2
fdd84a81c571dc7bd3869136eb83fe60,82,67,3,191.33333333333334,82,0,01026,3
8c4582fd066c2ad6b6eaedc8c9827151,205,140,3,478.33333333333337,135,70,03090,4
7538ee9c6d9d561f28543f4370e02440,84,71,2,294,84,0,10200,3
f3b3513350a1cc236734f98ab8b400ea,40,29,2,140,40,0,11100,1
4a2519d369abac5fe3bc90581a612130,131,88,2,458.5,16,115,05040,3
a62f12653ce397cdf1f8a89ae5ac8e0c,37,37,1,259,37,0,01016,1
dfa8808209227c796747b7f0a3c74b1f,175,103,3,408.33333333333337,175,0,01012,3
01dff2de0f1bda0d6a4d7d9c324c1452,44,26,1,308,44,0,11100,1
021130f2cb0b48a1ec4dc31fd95e528d,12,12,1,84,12,0,01012,1
8924078c00a08f594d377adf80e4ed53,28,17,2,98,28,0,11040,1
e754b23b2765464cff145b53f66c7e12,43,42,2,150.5,22,21,03090,1
b9a256c4d84306899f9157d05f93bcb3,50,27,3,116.66666666666667,50,0,09110,1
94d31dfd36b258b8402200fc040d4284,36,36,1,252,36,0,09130,1
06c9cd0099c4bedf44cd26a7048312d0,155,80,3,361.6666666666667,117,38,09030,3
b8254dc730e8278dec2a26ef7d7c4bfa,194,121,3,452.6666666666667,194,0,05100,4
80ef135f915cd71f6b2f581b3c388237,98,60,2,343,98,0,11080,3
ed81ca606d2b2d5753e80695ec2762f9,159,92,4,278.25,159,0,04060,3
df9f8373da4edc3b375b063ad5989a48,75,65,3,175,75,0,08230,2
aa77529d07ff9cf83ca663189f961c52,59,57,3,137.66666666666669,17,42,01026,2
5fa6a39d90a7a74fd811af97a1d9e729,51,39,2,178.5,17,34,05030,1
af9c225fb318fae582b836eddae76fd4,366,112,2,1281,366,0,01026,4
657efd0029d7f4b6f6e555fdb4842d59,82,72,2,287,40,42,01026,3
e3f0003c864e817e2051c5659c032f60,96,84,2,336,42,54,04020,3
19c4f0c3c02dfa4ecdf606ad964354b3,40,28,1,280,0,40,05040,1
88fd642a77e7903480fc55c92ff2c097,116,76,2,406,116,0,05040,3
0d3a682661ee60599ec44c8106a86777,209,123,2,731.5,209,0,05040,4
7bf23bf78037777f7e767dbefa99392e,114,82,1,798,114,0,05040,3
bd9156dc3956b3d14622ce0e6a0f40d4,117,97,3,273,117,0,01026,3
f8d9334328b13bf9e8c39d9e28489e54,345,154,2,1207.5,345,0,10200,4
12a405d0e35474cb12d2831ff45d0ac0,138,95,3,322,138,0,01027,3
d8b78ee7d34b665e4c5ae3a86e0b17d2,195,70,4,341.25,139,56,08100,3
c0c8c549d6492b9e95d9688801ce883a,102,85,3,238,102,0,08010,3
de35923a57fce240bb5e87f4efb8e761,117,86,2,409.5,117,0,05030,3
ad61765a3ae93a9cd29e27e18f990dbc,142,111,3,331.33333333333337,142,0,01013,3
a721bbdbddfd1afd954d9c36dca50614,86,56,3,200.66666666666669,61,25,03070,3
01a1c1079f5e7a9442cff9a5076cc29d,360,139,5,504,288,72,05040,4
96b0ddf71309a342ff510de75b1219df,34,34,1,238,34,0,08100,1
ba03d06e98c4224cfc4d1c205a386547,166,98,2,581,129,37,05100,3
4e08cdbdf31edbf66db260b78271a238,148,80,2,518,61,87,05040,3
75dfce4a7ddf5c6d6bfde4f151df8306,276,85,5,386.4,225,51,10200,4
757e57bf4bc82649a155e66ec5a1aaa4,608,166,5,851.1999999999999,608,0,10200,4
b3189dd7d406789eb76bc53ff8ecbe72,189,127,3,441,189,0,05100,4
05c084534f472ea57f764195abe5d96f,32,26,3,74.66666666666667,32,0,09190,1
57fb9cf964a88a89ffe33d4c13cb83df,4,4,1,28,4,0,13930,1
6e43c85eec9914316ba4c1320fe39c3d,17,17,1,119,17,0,05040,1
1a3f2e3d5e3072660277ff94bbe2e618,308,160,4,539,308,0,05040,4
d7a6a791dc64e35c382ded5bf0ad933c,246,134,2,861,246,0,05040,4
7d27277b65aaa9b9b4a8d948b3520235,113,90,1,791,113,0,04060,3
53a90a8dd194d7fcfc51e6ffab58fae6,27,23,1,189,0,27,12670,1
f9e1b7534779580c8a552ac41e25606f,86,63,2,301,86,0,02690,2
8977070868ddf0fc9045d9d9d65c3aa3,6,6,1,42,6,0,05030,1
33c091869fea107dcf01bd28e183d4b0,10,10,1,70,0,10,02755,1
81b27fbe74f28987c753b25339b63bf3,147,83,4,257.25,53,94,11100,3
35adfc819f43ab5969d86771e850fa23,374,133,2,1309,281,93,01027,4
5bff650fcc88b2e45e325c03e59b26a6,29,29,1,203,29,0,01026,1
917f4d6607c8aafc8afe224d1981526d,146,99,3,340.6666666666667,102,44,01026,3
dfebb61b0543ce76af1df164b94c4189,32,27,2,112,32,0,09010,1
cfa59d77f8c5209c22b7f07b283dadab,8,8,1,56,8,0,09010,1
c7b1aed8921fb92716911293e7f6afd7,87,78,3,203,59,28,10200,3
662b08ff7679f810924225222a1b6991,24,24,1,168,24,0,01026,1
cd0a7ba0c2b766cf952c8972a8b00c90,23,14,3,53.66666666666667,23,0,11100,1
e44b8dfa096fc9b8cbda73e14f352f51,337,128,6,393.1666666666667,271,66,05040,4
d23ce425d507ef6d2489feeaae0647d6,466,154,3,1087.3333333333335,426,40,01012,4
e99c8e5ab78168bf8c9c27ad1961ed5b,93,56,3,217,93,0,05040,3
1e834320a746215e149e7d7bb17dd2aa,65,43,3,151.66666666666669,65,0,08230,2
36c900b274a0706d18616e0ee19155a5,16,16,1,112,16,0,05041,1
b4ccdec88e77fa2ecde33b40506b9dc2,251,140,4,439.25,208,43,05120,4
b94869d94891311fdc4e159258ef0061,60,56,2,210,60,0,01026,2
8ca98e978bd29716a76501cd8acddf5c,34,34,1,238,34,0,01027,1
1b58e79376c777d2cce15ede990c09dd,52,52,1,364,52,0,01013,1
a28b998b100447c16eefe957ec5f25a0,46,31,2,161,46,0,01026,1
0e1dc6a718759b1241bf50e041fe67be,45,37,2,157.5,45,0,05100,1
3c6f5e6765ee79ab2b12c13a830854ca,42,42,1,294,42,0,05040,1
6bacb9fd542211208adbf69152429485,214,120,3,499.33333333333337,149,65,05100,4
f85876fd033dd09de61b93a4ea249ce9,22,21,2,77,22,0,08132,1
f3c95970cddee621a02655a7b4503283,105,73,2,367.5,105,0,05040,3
608401df395795f45d88e00ab59c7657,39,35,2,136.5,39,0,10200,1
640e20fcc7ddb1dc350cf3ee7019537d,2,2,1,14,2,0,05030,1
b05cbb127d7d5a3bbee32f5aaf96aead,52,43,2,182,52,0,01013,1
3a6b8af50c2501db8a8e25a406effc5c,78,60,2,273,39,39,04032,2
5ba62811d5a200da28e43cdf7c8cc9be,388,111,3,905.3333333333334,388,0,01026,4
4fb61b0fd6fb1e0d852e2574985bd847,142,76,4,248.5,109,33,04020,3
85ff2df06269d59fb3b51c05e692fc61,73,57,2,255.5,38,35,05040,2
109b16ce9b65707cbd9eacb4353851b9,189,82,3,441,189,0,05030,3
d38ddae8901afa04238904f3c2111372,146,101,3,340.6666666666667,146,0,08134,3
ca272d7c5760cd75fec636abaeb5e00e,93,72,4,162.75,93,0,01201,3
f0ed336aeea4dc011dc30c6502733ba3,101,70,3,235.66666666666669,101,0,03050,3
7813a39edcb07d97a2192e74128c5a49,199,57,4,348.25,199,0,01012,3
46823b22847d2215b6d346e8a7b93bce,2,2,1,14,2,0,09010,1
aaf6324ae7afe6d10133e4b2c399d272,63,54,2,220.5,63,0,10240,2
4cf57d9db365ea3785693d3f1cb52d1e,1,1,1,7,1,0,05030,1
33f6fdc576a57609fcc20ca1153874d2,32,32,1,224,32,0,09010,1
a7f625e029a46ded36274773d341a6dd,39,35,2,136.5,39,0,05030,1
5e1ba877bc48fed009ef7633cb62fc41,245,138,4,428.75,222,23,05040,4
3e27b44627a201f803bf9363e7a57c74,62,55,2,217,35,27,11040,2
3ae59f5495696e112d297a33e43cbba2,15,15,1,105,15,0,10200,1
a6dac9130d48af4e7962ae21eb6e5de0,222,101,5,310.8,172,50,05040,4
36548945bce223d04ba58a8360abbead,399,203,3,931,399,0,01026,4
bf3132ecad2f04a33ffcde737b540201,14,14,1,98,14,0,01012,1
e4f64b4f05944611dfdf24a76b9b1d75,240,98,5,336,193,47,05041,4
14a98e75663ebd2059ec90083c09d262,64,64,1,448,64,0,05040,2
530e6cacb32a5f136eb5d7559b832d86,34,34,1,238,34,0,12590,1
63e899f37bbb073a8b1fa22c1d0b016d,20,20,1,140,0,20,01012,1
e2511818ed58d6413698468a5c255c12,25,20,1,175,25,0,12501,1
47e2b3f9c59c680c90a1fc4352da8268,21,21,1,147,21,0,07143,1
5ae3fe82d15cd173b3e52539be1fcc76,83,60,2,290.5,36,47,08052,2
0148786245b4a5eb2e6312b63975a0fe,48,48,1,336,0,48,05040,1
a2de2916046fc89e3dfa7f3cd525219b,16,16,1,112,0,16,05041,1
49f32bec84fd7e50a53657e64a7390ee,22,22,1,154,22,0,05041,1
5de3f174b7b474662d360674699090c0,349,166,5,488.59999999999997,331,18,05040,4
d6a825984ca6e5206b19b10c3185b6e4,38,38,1,266,38,0,01085,1
d6c97dffc72c229d69fc2be89267053d,112,74,3,261.33333333333337,76,36,10240,3
53865632706a9a845fa70473ca72a5ee,187,72,4,327.25,187,0,01013,3
416c228f94f3dbac71cd93a698c65c6b,79,71,2,276.5,33,46,03050,3
4b1554eb1f6dad09afab644d045b3481,160,90,3,373.33333333333337,131,29,01026,3
b223d51898559c961ba1df3ab3b24318,2,1,1,14,2,0,11040,1
fee3553607cd9469ff462e8db93fada9,45,40,2,157.5,45,0,13550,1
3d2366f1b66ed5ad7105eae34d4c06a6,20,20,1,140,20,0,05040,1
30139fdaa2652cf103488261c5be5b56,87,52,2,304.5,42,45,08090,2
f9cf16ce4a42578ca34b49e2dd45da8f,43,25,3,100.33333333333334,15,28,11040,1
03e001a4e9862742302b2df3a465395b,116,80,2,406,61,55,11080,3
64bc01d7e88fbcb6b69a031575864767,100,72,1,700,100,0,05030,3
94755e085e911e79a483db7ae994f78e,13,13,1,91,13,0,09130,1
927371b6295c6cb941002782bbfa51ab,333,148,4,582.75,231,102,01026,4
124e2f1690aac301283afafdfbcd874b,41,38,1,287,41,0,02620,1
28d1b34a088369038453bb499054bf23,76,56,2,266,76,0,08230,2
eeab1b2a913daf1985033315675e60bf,274,145,2,959,86,188,10200,4
75b5aff479f126a94ef112674db6e5d7,26,26,1,182,26,0,01012,1
7052042047fabcc637ecfae25188e452,76,53,2,266,76,0,01027,2
0a1174b03e2bcee5d19f0194c700dcc0,21,20,1,147,21,0,01012,1
9a41d43b6ad5ad36fa6bf2efc95b89c3,124,81,3,289.33333333333337,124,0,12670,3
18d81219d59742248c7a09ec50ed931d,63,34,4,110.25,33,30,01026,2
83c184a6f8d1f6aedf04a1999aa97cd9,28,24,3,65.33333333333334,21,7,08100,1
4c6d991876b94df2a44d5e24e07a52de,118,81,3,275.33333333333337,118,0,08051,3
68c8129afaf85f5ef0b1c7f6502a8345,52,47,2,182,52,0,11080,1
b799bcee4fde4e7bfc8c212e93321052,147,82,4,257.25,147,0,10200,3
525ae6018a72503fc87fced6eacdff19,68,48,3,158.66666666666669,45,23,08314,2
09334732c81cccab3c5817a1ec086000,14,14,1,98,14,0,01201,1
f61b1e5c919fc34e77a0fbce1926e7d8,182,92,2,637,126,56,11100,3
51cc602efc3ae0677076b0c6c7bb7863,19,19,1,133,0,19,01027,1
0934f159f61937483d50ef356a8474a0,518,130,2,1813,393,125,05040,4
c2db280b276d7d0f94beb658f4cefd5f,1,1,1,7,1,0,13580,1
8cd865c17c83b92c022494ba254a7d93,74,59,1,518,74,0,03050,2
383fb41edf34514a6b2abefee306674b,36,36,1,252,36,0,10200,1
d115f6be6ec2841a438c21fb1d682e78,63,44,3,147,40,23,12500,2
bf8889c61cbd1aff81604a57e822ac07,147,108,1,1029,147,0,01026,3
43c243e45e40590f1942a77d183052bb,434,145,6,506.33333333333337,414,20,01012,4
1298610e7ab63e1fdcdeacd9cf02adf8,150,73,2,525,150,0,01026,3
255ecdb80b2f3c2bb5b0a14f868e15d4,105,89,2,367.5,48,57,10200,3
8fff5c38cea2c15d13403b8bb8f54865,155,95,2,542.5,2,153,05100,3
3c8c04d19a33f4040fd65a05990a0832,24,24,1,168,0,24,04060,1
70a98efa9ca6c6d14b0381a77efe67e1,116,87,3,270.6666666666667,116,0,10200,3
95557270ddcbe8eb017c0fd5db5bcef6,2,2,1,14,2,0,11040,1
2ed8f8b8c08433ea7ac5597c7ea8c851,195,81,4,341.25,163,32,01027,3
a2680fb442438a5cb8057a9a1b27c11a,85,75,1,595,85,0,05040,3
a6f04109b066c3975e9ee43a0d199660,112,81,3,261.33333333333337,112,0,05030,3
9e90e7d0314408a655746b856ca7c6fd,132,88,4,231,132,0,05040,3
12c9084a62e4eafa09b6d80c4e544af6,25,25,1,175,0,25,09030,1
f5a81e23a48a384fa6378ab9399c7084,117,87,3,273,44,73,05040,3
ad40991ba5efaa9a3105a53f9c3af705,102,79,2,357,102,0,05040,3
0a8e6e679aaac12b565cde3245918113,75,51,2,262.5,75,0,12570,2
407ed140b352393d43ad8f03737c1a1f,139,94,2,486.5,139,0,01026,3
dbf7731eadf172b56dea5bf2a92701e7,65,63,3,151.66666666666669,65,0,01026,2
304707173ccdc351ff97ac4d033d1e5a,79,45,3,184.33333333333334,79,0,01012,2
06d7e7a296225e66fff3016d7e07b3de,490,138,5,686,453,37,05040,4
dec355a66ca4b90978db5700db0d320d,369,90,2,1291.5,369,0,13930,4
696b5e57d59d3241f1c6822539f4720c,28,16,1,196,28,0,10080,1
f9e05362d993fbd93c614dd378d58482,88,74,3,205.33333333333334,88,0,05041,3
28dd86240ffaaec58d8b57967bd36cfe,149,97,2,521.5,84,65,10240,3
26e14a071a9c1c56f27950555874333a,14,14,1,98,14,0,10040,1
ede1331602c32d7ee8bbf80b66959d0b,120,68,2,420,23,97,01026,3
720d411b9740cf8759579b50e7387954,29,29,1,203,29,0,01012,1
eb1e0ca509eb6d15d0e0961e27b241e7,58,55,2,203,58,0,02691,2
131bb10d44019d77293efae86035c5b9,41,41,1,287,41,0,09130,1
0823172f979f01b350bca7c450c4f220,230,76,4,402.5,170,60,04060,4
7aa175edd6fa96cda67c59adef88062c,354,114,4,619.5,354,0,05030,4
4524f1deac9338e1e69abad55b7d5ca0,55,47,2,192.5,55,0,01026,1
f10b83b47b491b0059f7d2036bf3ce21,67,46,4,117.25,53,14,01026,2
ad74c3f9d319006fbe3cf3cdcb7607cb,113,66,2,395.5,113,0,05041,3
5bfe2d7baa41ed94aa811f65255ff07c,33,33,1,231,33,0,09130,1
f3175972956e9c5ffa85ca76a26cf94c,18,18,1,126,18,0,09130,1
6be5db2da58738c82b2697ab9b4eaf7d,149,95,4,260.75,131,18,06120,3
589295056b81cbd02069027551e6996d,192,84,5,268.8,169,23,01026,4
7efb5c1673ecca59d3ab59e4eac57211,4,4,3,9.333333333333334,4,0,08090,1
2f81861f9085c0e2f7a19d46efc3d09d,8,8,1,56,8,0,07143,1
0763a0af4800907db57982192c9f9fdf,47,38,2,164.5,47,0,05030,1
60d684106c36f7226b7e838e02279810,12,12,1,84,12,0,01012,1
746ac1990644cf430a17cefc960347a5,399,158,6,465.5,266,133,05040,4
0b8037c26c268c889aea6b6b76cfd1b9,67,48,2,234.5,34,33,01026,2
a8bd12d94251ad55fb19075a0678fccb,55,55,1,385,55,0,01012,1
12b102e90ed20bfe144cca4f32c2b7ac,63,56,3,147,29,34,09150,2
bafe5f1d0c63769e97fd582a768cb6c2,54,54,1,378,54,0,05040,1
3fccc924b215f5208960366b3ac03e64,78,62,3,182,59,19,01026,3
297f7fab355b03f6b98b8dc7616e6db4,358,168,6,417.6666666666667,324,34,01012,4
cb0e819cb18e2619290c0eeae00b31ae,33,33,1,231,33,0,01026,1
9caf8906a127568dbbb72b4adcc68fc8,66,47,2,231,66,0,05040,2
596e9bdddf12752976422b3f547224aa,164,98,5,229.6,120,44,11140,3
e69fa0d1e3b94a2c2f497c60ccb431e5,23,23,1,161,23,0,05100,1
4753c2c38875b7ee073c10e931b2175e,219,123,2,766.5,219,0,05040,4
f95b75cd94fb14b0e7404f4b3f111804,114,94,3,266,114,0,05040,3
798746b12ceff93d0455b3d0b3c7aa68,74,50,2,259,74,0,01012,2
01c90cb0a557f60d7f8d49dce936a1c4,488,149,6,569.3333333333334,470,18,05040,4
ece8c2cb274726189780cc73f0e6c81d,140,63,2,490,140,0,11100,3
f6a83d886a6f6da41c9058bc76dd72c9,446,198,5,624.4,396,50,10200,4
da529df348d96c5abf0cacf4436bd9fd,93,56,2,325.5,93,0,05030,2
c4ad3c6bb1a876925f5af8dd0b644ea2,83,60,1,581,83,0,09111,3
5679e55ca29257cab2f230dbbf7eb58a,69,69,1,483,69,0,01026,2
1d5f828302cb64cdbc341f7cdf26eab1,28,28,1,196,28,0,08010,1
ce2f136155070f79875731860612a95c,51,51,1,357,51,0,05040,1
4f2777709cf1e64ab45f5b7d7d6bcdee,52,43,2,182,52,0,05030,1
1aeedff5543fe07473403db01214dd8e,37,37,1,259,37,0,02751,1
3ad2b9eff8fb9503f9d3afb47a3be614,47,47,1,329,0,47,04130,1
1af94e2668701290947757bc4933e0e5,62,62,1,434,62,0,01026,2
881294fce79d104092db71fda1ab0a0e,29,28,1,203,0,29,05030,1
ace93589fdcf13ec56cc14c10af0e6e2,116,97,2,406,116,0,08010,3
187d9be54b81b1add5f774cb99f2fef0,13,13,1,91,13,0,04130,1
591ba1e79dbb7f550ab85b2f87fed3a2,47,47,1,329,47,0,08231,1
9ceba682bbbfd5cc12c9e4892c54b468,42,34,2,147,42,0,05030,1
6267159ca97c96df4ce969f8425cb0eb,67,38,4,117.25,41,26,05040,2
f6f68ec39e0b61d2cecc71ebc5549128,66,55,2,231,66,0,10200,2
d484705ff0c1a786c29a0c8039879a49,32,32,1,224,32,0,09170,1
97c3669bb37caac4e60877a958cae3e2,73,60,2,255.5,73,0,10200,2
af2ec9510a3cd12eea316281d5ac2ada,343,161,4,600.25,231,112,01026,4
5ccb16410f891bdb9549306811310f49,50,50,1,350,50,0,05100,1
ad7e058089c00f8d37115b14b1b8fb4c,62,38,2,217,62,0,03070,1
02d93e7e745edc8010ea92cb4eb873b2,57,37,3,133,50,7,05040,1
8c5f0e4f43d712f1da61336451365125,35,28,1,245,35,0,10261,1
3496ec23330e928089530c2d29ff1c1b,254,158,3,592.6666666666667,254,0,10240,4
03c650aaf639738ba04077aadc427d4e,29,29,1,203,29,0,11100,1
af3a1a695acabbd4b8610e3df52b0a1a,120,91,2,420,73,47,09130,3
cb2977aa0da2a5c2d4a1c29a95e5d05d,523,110,6,610.1666666666667,420,103,04060,4
e2b05a3d565180546ec91051c7291da2,171,136,4,299.25,142,29,04032,4
74a166f2c3b85a9fc3a8bc0ebe0bcd93,132,75,2,462,132,0,10200,3
f4785830477beeb26bdc5ec95efb219c,90,45,2,315,90,0,13830,2
ad022f39a7c5ef0060f50b33beffe245,15,15,1,105,15,0,01027,1
fabe91a465da1a33cd866640924c8c3c,39,37,1,273,39,0,01026,1
049503cfcc38fa9b154a30b4e6fabb5f,52,52,1,364,52,0,05040,1
ff66fd43cf192d82d3c33a5e820a17a8,203,92,4,355.25,203,0,05040,4
a19d9e0783c2fe411694479ab190da4e,103,63,2,360.5,103,0,05100,3
7e8d8f1793501ab3b4bd6a6c5b4912ed,110,69,2,385,24,86,08031,3
8e0fddaac56330a029d503761f415f6c,44,44,1,308,44,0,05100,1
b81925b8d27cfe8c172ed0ac22120209,25,25,1,175,25,0,10200,1
911e0587213f47db774177e54cfc3790,53,44,3,123.66666666666667,53,0,01012,2
c62ade3985a528e2d6ca04c300b60568,39,29,2,136.5,39,0,08231,1
fafcfe81e5b40c006f8700b0a52e00e2,194,90,2,679,194,0,01026,3
5b8d919e9110a20ecf534b0cf9824fc7,25,25,1,175,25,0,01026,1
15b293e7bee223fa035552a9e77a7cb1,35,30,3,81.66666666666667,35,0,10200,1
148e086e2f03afc866b80d8e1194779f,31,29,2,108.5,31,0,01013,1
d7db48409b9b4e10e1d191523f9cb845,24,20,2,84,24,0,05040,1
7eec107c2ea11271b73e6238e17ac4eb,31,31,1,217,31,0,08010,1
5f4192544862ac9cfec59c4f262c07f7,29,29,1,203,29,0,09130,1
a7b2911658d805c1c46ac5778eedce43,134,102,2,469,70,64,05100,3
e17730d16d9ab3b981da48286a0c28e9,111,79,2,388.5,111,0,01012,3
4adeed5eca8d8abff391f5bd602c6816,201,66,2,703.5,31,170,05040,3
7ea4715ce45df843854914f3daa13775,113,89,1,791,0,113,10240,3
2558f71123cf226e5186dc61460fe137,110,85,1,770,0,110,01026,3
11b166abedbf4c2dbc051d6cdd758f30,46,35,3,107.33333333333334,25,21,01013,1
fed2af2e79866a79f40eb19c632b39bd,18,18,1,126,18,0,08452,1
dadb83a1f591e40c75ba817d95cd118d,127,89,3,296.33333333333337,77,50,05040,3
b7c089dd137975e730e73b247b892466,4,2,2,14,2,2,09190,1
3f66e95610cb5883ee07c7aee1993acd,15,15,1,105,15,0,04201,1
7793a98def4bee631ed56d921409636a,15,15,1,105,15,0,01012,1
73c58fd05564b4b9836762cb0a053094,11,11,1,77,11,0,01012,1
5f76b1d58f3f699f37f126c053285269,59,50,1,413,59,0,08010,1
feaf8b5217696ef6b162d0f0b60e2d5f,15,14,2,52.5,15,0,11040,1
e8b002727a79055cd435a77d91a91282,35,34,1,245,35,0,01026,1
622c167a1b72e34c48309f39e6f8aa56,31,31,1,217,0,31,10200,1
6dd5d5d382e8a852d44b9f0bd831dcde,148,105,2,518,148,0,05040,3
35601eccce7aa5f5b2ac3d5a0e969384,86,70,3,200.66666666666669,55,31,11140,3
f7966a3ca759e72b46f853ddf72c729f,201,97,4,351.75,166,35,01026,4
75806fa4838c334d8e7d87a6f850f218,54,54,1,378,54,0,11140,1
acab9aa157e098aac7aa56c9f834ab70,126,113,2,441,126,0,01026,3
c44301b3fdb716089af32154de7e3feb,97,74,2,339.5,50,47,05040,3
64b6714a2c0fc6dc69ee1b60c356ec1f,11,10,2,38.5,11,0,12650,1
5919e15d5bf30a4cb4683231b853eb66,43,42,1,301,0,43,11100,1
e91a438aabfc1721e26083d149faa49a,132,87,2,462,132,0,05030,3
ebcb886ac6390e455d649a1e52d7a873,19,19,1,133,19,0,11140,1
7b200cc6a7d070f34cd81e9c9786af66,68,53,2,238,68,0,05040,2
ec038bbf51691a1cecb99b77a7451247,182,107,5,254.79999999999998,160,22,11040,4
42fda2b1fd27c621f22499cf15cd3487,1,1,1,7,1,0,05030,1
1cb1790097e9a3d81d514f9028b54634,342,127,3,798,342,0,05040,4
cc9c8b7ebb88bb56efb7962ba9080c23,22,22,1,154,22,0,05040,1
b9dffdf1b3553ac1726ba90e2d46f730,25,24,2,87.5,25,0,10080,1
22421a98ed3478bc06ee011615f64ab6,10,10,1,70,10,0,05030,1
39d7bd77fa063fcdfca14f1874939717,30,30,2,105,13,17,11100,1
49512f99cc021a5a81ca2d7cad898d38,868,293,3,2025.3333333333335,868,0,05040,4
3a7d433122c13bf3da71c6c719b8a084,235,106,4,411.25,235,0,05160,4
9927fb70073f456350396f61ead776da,113,71,4,197.75,88,25,05041,3
d179f934c74a64330bceb968e824410e,76,66,3,177.33333333333334,76,0,01012,2
4854c57bcbf41670610be405ff08e946,24,24,1,168,24,0,01026,1
57388ecbbb865d0dee9c33e6097953be,84,67,1,588,84,0,01026,3
a15e54c05690dc5a280db90b3cb347f9,4,4,1,28,4,0,08051,1
73680accf3359e012f980ce5f0c6b465,6,6,1,42,6,0,05030,1
c646d46f7cfb3d2bd210b4ad03f26553,30,30,1,210,30,0,11080,1
a92fe9ddd6733cb4f9913e3ad948eee8,19,19,1,133,19,0,01026,1
0bae981970b77c368e7c122dc178ed36,107,74,3,249.66666666666669,48,59,05040,3
1cb15ce8c518a308c55c251e2a509753,17,17,1,119,17,0,13490,1
24ab50c9c9e8ea4e74fffd2800ceda89,287,168,5,401.8,287,0,05040,4
35e42de6b65f4f69e9dc408d96d54f3e,52,47,2,182,52,0,05030,1
d21e9fdbef4efef3d71a26c4491690a5,50,49,2,175,50,0,08100,1
8eec6671b00231fec420d49bc879b340,9,9,1,63,0,9,05030,1
2729a018f1d6380eda126c2e301f3da9,342,97,3,798,342,0,05040,4
6eb1102b7c533efed4e951c47cf40d04,87,58,1,609,87,0,08230,3
e66265b9e000eb693b655e8f1e18a315,41,33,2,143.5,41,0,05030,1
3b6b4c104173522351d0e2ea13fb24b8,204,116,4,357,204,0,01026,4
45bffb85bef8af207447055db4e4f6e1,4,4,1,28,4,0,03033,1
be33f8e4617a822e461eb306e8ef7e30,209,121,3,487.6666666666667,101,108,06120,4
7d9a880959754a9efd98e97de3cf7462,29,29,1,203,29,0,04032,1
9554b45db3454e02701cf9bfbd6d5570,16,8,2,56,16,0,05030,1
da24e42ca2ae9a4331932b68035c2ca2,54,54,1,378,54,0,01026,1
397a32ad40baeab35ad78ec5e4bd6baa,53,45,1,371,53,0,05040,1
bd630f0e4a2d34ef7c062991b0280d77,29,29,1,203,29,0,01012,1
3e40d5ca1c6ddbace9d0e601da8857a6,110,67,2,385,41,69,05040,3
10c1b8611a28b089566b50ff51523175,272,122,5,380.8,246,26,05030,4
adb2bf4116ac022aaf42d775ccb93fe7,36,36,1,252,36,0,08010,1
24e6d5ef8a4c50b714075c819177c577,211,90,2,738.5,106,105,01026,4
e480fab39ee73c3eec39d8b8cc081be4,41,32,2,143.5,41,0,05030,1
ab991e298b808d8ab0d731247d31adea,20,20,1,140,20,0,09130,1
426e23e583edac761a3fe96ea3df89d3,139,92,4,243.25,107,32,01026,3
61887a5fe8e34d52fa0ddd33a0bdd819,27,27,1,189,27,0,09130,1
1a9c678ba68f897385b52db1efe9b027,19,19,1,133,19,0,01085,1
044a3ff2d01179573c657d04e8eacd81,9,9,1,63,9,0,05030,1
e1cf9a3db79979cc1c71fcbb396fcabe,102,48,3,238,102,0,09090,3
f446c50644ef2b7990632e439c768155,27,25,2,94.5,1,26,05040,1
65cae4a6ed8a294e8169e6c451e3cf8b,14,11,2,49,7,7,05030,1
42cbac7fd44b75ddbdb3404e7957eae2,308,134,5,431.2,308,0,03050,4
ca1ac91e883c0890c830da00026b5ed7,316,111,3,737.3333333333334,84,232,05030,4
2fdb047b908ab156b13344cdc5ea50a8,107,79,3,249.66666666666669,74,33,05040,3
3e2fd30d6d6523500c9678977f3110d4,8,8,1,56,8,0,05200,1
359d44793cce7d3b94651d8f72e33f25,147,74,3,343,147,0,03050,3
0aabf70c449fb8a8b3c4ea4a25be58ca,277,101,1,1939,277,0,05030,4
a55acf8a480d19749531708d26244580,43,36,3,100.33333333333334,24,19,05040,1
83367f101f51b54f681a8c75725d0ed8,257,121,1,1799,0,257,01012,4
76e5117f112c3647c1376ca92ea9cb1c,706,302,3,1647.3333333333335,191,515,05040,4
d95496e4aa2933f0d35f42406aea4e2d,166,114,1,1162,0,166,01026,4
ea3c5de842c54c7ea188cc457b435c32,100,89,3,233.33333333333334,100,0,05030,3
9aaa1e731df9cd16e01c4518f5f8b24c,39,34,2,136.5,39,0,02690,1
b9690dc77d7a7a8fbd4bdaed2f090da4,14,14,1,98,14,0,01085,1
80117a618766948fad3cf6f01fe2b875,136,101,4,238,136,0,01026,3
6efc79ce18ef85c84ceef1d89cd8f14f,64,46,2,224,31,33,05030,2
d2cf995d00f54d51ed56eb1b4a4d61c2,49,35,5,68.6,49,0,05100,2
2782e12f74ee266eab2d09367c2f3e7f,244,136,3,569.3333333333334,105,139,01013,4
3eb945df42a26563448a14ff6735f840,560,174,5,784,560,0,05040,4
2c652b1ae7f5a415b9e2a554ac7fcd97,29,29,1,203,29,0,04060,1
9e87ee933fec172378d844355d39e05e,19,19,1,133,19,0,05100,1
ae298bca9fe79b232c37647cbfcf55a4,49,42,3,114.33333333333334,49,0,05100,1
447e6ee2270a1711254458ac04b9dc59,80,77,2,280,80,0,01026,3
05986acb69b9c19442e65bda75a946eb,171,121,3,399,171,0,05040,3
2657ffcc0914c29dcc3229e4017dd13c,107,87,2,374.5,107,0,08134,3
c4d6706d4d9fb757af9b1e56ad5fa4b0,170,84,4,297.5,78,92,01026,3
2c5f1b5c175dee4135c02c8ef1d55737,64,52,2,224,64,0,09130,2
cd866e272a11b225ae86b0ddb633354c,21,21,1,147,21,0,10200,1
a3d8fa23183043bab73fd67b1d513303,49,49,1,343,0,49,05100,1
abbd781998aa776140eba301bd162f89,261,162,2,913.5,261,0,05040,4
6b7dc2777c28ac19744cf413d8366982,78,49,2,273,78,0,05040,2
8b570d6b1afad6e8a584d8d47be28493,24,24,1,168,24,0,05030,1
991a0e822879cc9279e512763e1859a1,91,48,3,212.33333333333334,91,0,05040,2
68c9bcb702d0434188964d76f7b2e4fe,52,52,1,364,52,0,05100,1
d5c5ea12b85be81b61ed161a3a73988c,219,92,4,383.25,219,0,05040,4
871fa2f56f3e3ae28de4d2b7ab976cf7,67,50,2,234.5,34,33,10028,2
95b11b7af0be38a15abc85b5f2f4eb63,19,18,2,66.5,19,0,03090,1
18384a3552896531b77f866540619917,117,117,1,819,117,0,03050,3
73b002308e33ac259e551f016cb7e9c3,36,36,1,252,36,0,05040,1
d93978ac78424a2f4c3fc604926ef8a7,95,86,3,221.66666666666669,45,50,09150,3
036f06c72acf0e2a6b97904ebdf2b165,158,121,3,368.6666666666667,158,0,04060,3
ad47cb4b02e9ab337a79621f7b3d1fc0,178,102,3,415.33333333333337,138,40,01012,3
ad250321875c3a15f0cb46618c0cc829,32,22,2,112,32,0,11100,1
94d5cfe66ecdd217b02fe3ab9a6fd88a,6,6,1,42,6,0,14261,1
f2fa3ffea5598ccfc3b153d4b8b8aa8a,186,117,5,260.4,140,46,05040,4
cf4baa31bb362ecbc34283ab685de822,57,46,1,399,57,0,01026,1
1b0e7a93d920aca37e1daf66dc9c3e12,8,8,1,56,8,0,05030,1
e185cb34955e652e37a99dcdeaf0a683,84,61,2,294,84,0,10028,2
8fd29057b32343551fb8172b7bce7494,180,97,3,420,119,61,01026,3
3130bfb72eded8d3911d647b684ca397,270,122,3,630,82,188,10200,4
8fcaccae9b4ec35d00767e4c0a73c058,194,130,2,679,194,0,05040,4
889580eb06f6d353b9691ce55e84ab59,21,21,1,147,21,0,12591,1
50da00b60fb1974d7fef2fae17ade325,24,24,1,168,24,0,03070,1
8c69dec393811c94cdbf8651fd7a5af8,25,25,1,175,25,0,03070,1
d1f6178447970c80672185f67bfe26bb,24,24,1,168,24,0,05040,1
8992d11c8ac4332abf1c0ba5a588c0ff,37,37,1,259,37,0,10028,1
be5dc3c38e9fa2ed83bc9469bd92e0e6,108,98,2,378,108,0,10040,3
9680c65112035f21c908683153bca2f6,85,70,2,297.5,25,60,08052,3
61fba814e7d28514d6f9f24a774cff08,36,36,1,252,0,36,05040,1
4afa47d72a104f622e095031f5798229,80,67,5,112,56,24,05100,3
652edfc861a9f9bfd941bd76986a6697,54,39,3,126,54,0,08051,1
0dd0dfddec25ea39813de28ae2687d57,14,14,1,98,14,0,05030,1
9649d8d8ece8bdd5c7d5bf98c415ffec,46,39,1,322,0,46,12650,1
4dcdf129b28f28f891b60cb8ed23ee2b,49,49,1,343,49,0,01026,1
7baa7421f028ced8aec7be68be35b132,167,109,3,389.6666666666667,167,0,01026,3
8cb5ee00f163d12b72b1ef49e0a198a5,135,73,2,472.5,135,0,10080,3
254823e9828e5e40adb54d79ecfaefc2,44,40,2,154,44,0,10240,1
37d62446c1f539242432778d31c17e8c,124,69,4,217,124,0,01012,3
63abf69c6902345a9bbf0931b9ea1094,586,186,5,820.4,300,286,01027,4
e270c4638c8d4c190750bdf0297b2e1c,241,139,3,562.3333333333334,121,120,01085,4
105b4045ed6ef789feea39d5737ef9c5,317,119,4,554.75,161,156,06120,4
3ff5e96c3db2c20dd261bd122a6a2d9d,23,23,1,161,0,23,11100,1
90e44324df685663dadcafc0fd7b2e41,68,51,2,238,68,0,05040,2
f3c0dd32dab34dbbf8c48a30f60aabc3,6,6,1,42,6,0,12470,1
1dfa3b4ece1f7574db5d201e6e37fe9d,278,75,2,973,278,0,01012,4
d07a77a62583d82486456ae95dea0842,34,34,1,238,0,34,02650,1
699eab7cbb1cd9dc7dce4b62f79b2ff3,159,105,3,371,139,20,01012,3
ffe2feb2bb2fd5a502494cd273977c4f,13,13,1,91,13,0,05030,1
930c81bc9c8af543b37ac9e418af551e,28,28,1,196,28,0,01027,1
a1ecc750e6b1e16d353895dc4bc98878,12,9,1,84,12,0,11140,1
7213664102158a43647623d7b93fc184,78,59,2,273,78,0,03033,2
ea153177e98300c9fdb382eb2e768d38,133,62,4,232.75,118,15,10200,3
de82c089de13931d22dd0386772ff1d6,30,30,1,210,0,30,01028,1
589e7bde40057b13c03f00d47f73ea86,158,82,2,553,31,127,05040,3
225ea70e738935ecb1d34b776a7f1d99,62,57,2,217,62,0,05040,2
f80bc8061ff2d524b2c5f8b9b8e1d06f,137,96,3,319.6666666666667,137,0,10200,3
33f40c7e635d3ae08b01fc13cf547c94,8,8,1,56,8,0,05030,1
22eb9888cb3dcdf3d24888044476e92d,558,155,5,781.1999999999999,323,235,11140,4
885dfd81098a39f5a0954876a5e33b6f,8,8,1,56,8,0,12470,1
8e6e90e0495c6ae893bf29e1cfa8dd9b,106,73,3,247.33333333333334,79,27,01026,3
c76a60d04c6247d45c80bf810cc8ad41,5,5,1,35,5,0,05030,1
177f6a2114e10afd9b91f4023ede32f8,30,26,2,105,30,0,08051,1
ae2e40d1ba7ddb3620e543d9bba9bf27,106,80,2,371,50,56,11100,3
e6429e4ac9a350428488b911e0ededad,27,27,1,189,27,0,11080,1
499c0297c6367266320b54bd60e2efa5,119,89,2,416.5,119,0,01012,3
1db37c47b299f9e5f1c3d325f120d0ab,271,74,5,379.4,92,179,01013,4
46d50283ab3617fbdb89184a1431f1d9,121,58,4,211.75,96,25,08250,3
a0893c47dcdae9a421726244bd953727,75,60,2,262.5,75,0,01026,2
463315b7ac4d8f3c9e60547ea0e45678,83,63,4,145.25,83,0,05030,3
124193dca5c8f70af6e8674bb8f26dac,25,25,1,175,25,0,05100,1
61f4aa0f2c8152f4dbccbd39b5be7553,24,24,1,168,24,0,05100,1
8f723d7a5ca707d97f3da208edc8c001,276,113,3,644,276,0,01026,4
1cb9e14b4b032d8e367a238087ea43ce,6,6,2,21,6,0,08032,1
a80f2d9b21fa680e1c8dc0a873b6d09c,100,55,3,233.33333333333334,100,0,01027,3
357f1e168c0b1d9449e828e373975be3,16,16,1,112,16,0,12570,1
0b10bfe8fc8ac798f16ee00665e53e3c,684,146,3,1596,684,0,05040,4
55b5bf2aaec81b9827c93513f7bcb1bc,128,90,3,298.6666666666667,128,0,01012,3
4782500b529bd3b63f008b1842bb39a9,83,67,2,290.5,83,0,08231,2
73c6e23806ddfe80855302c35228981a,291,131,4,509.25,224,67,08314,4
f5ac2782f10efaccf0beb885be1dd457,189,124,3,441,189,0,01026,4
805084a37d1c91a0595a062a807820ee,41,41,1,287,41,0,14301,1
6989918f5602e534599c127246df9bb3,95,75,3,221.66666666666669,62,33,01014,3
339ca2f9d3371b9e8e685208ef967440,81,63,1,567,81,0,08230,3
18bd22e86db4af40a6c409b9865cdb44,10,9,2,35,10,0,06100,1
e8c54915d64b3da278e3ce03d4077b3d,83,58,2,290.5,83,0,01026,2
f50dc9836593afb682b2e5be4cd2f700,75,39,2,262.5,75,0,12500,2
b8163b42a904bb5558fbcfc8363b89ac,332,136,4,581,332,0,05040,4
f7e77f5eaf1e7b4e9fd0f308a6d70e01,20,20,1,140,20,0,11040,1
10d1d86629c339bd3c92383a956659fb,17,17,1,119,17,0,05030,1
0c3433ee7f3226b836256278a1e88f28,45,37,2,157.5,45,0,04020,1
9dc882fe1054bc71b0be35091c654b6e,78,78,1,546,78,0,05040,3
38ff94d89b7741839b3fc4021ff3e8d7,280,96,4,490,246,34,08314,4
7b35bd1b8bf805e42a01465455e773d3,19,15,2,66.5,19,0,11140,1
9cc2d5eae3c1e75933c4120aceb2e552,174,99,4,304.5,174,0,01012,3
4f09943b656722ac1da9a1d0226acdf2,13,13,1,91,0,13,08010,1
a595e14cabc96f3e0deabbfcd0daec38,15,12,2,52.5,15,0,01012,1
1edb27c4aa1bfbafb699e742af22b320,48,48,1,336,48,0,09111,1
0b9504f679a28b2ea6c839152279a0e1,157,84,4,274.75,103,54,01012,3
2aa50db39e1a292b15e1846740b627bf,17,15,2,59.5,17,0,08314,1
ebd9657367e5df70a8543c15fceaf060,26,26,1,182,26,0,10200,1
407c115b27ccf2f4f8e72ea644d2efff,13,13,1,91,0,13,01026,1
13eff522682f637731b753d2e7202881,26,26,1,182,26,0,01013,1
3561501d8bfe11f049f5c52c8ce051a1,75,53,2,262.5,38,37,04201,2
0c5ee7b081f8cd55742a96c6efdc053e,57,39,5,79.8,57,0,09130,2
a0f952356ec6abdfb1bfb1a0edf7b147,41,40,2,143.5,41,0,01085,1
7aec3a25708d4006a0409399bd40930b,18,18,1,126,18,0,01201,1
efe1ff0c58400482e39363e750442ac1,35,31,2,122.5,35,0,01012,1
2352eb6aebe4fe3c015ef3b14a6c3b10,293,102,5,410.2,293,0,05030,4
5a45dacfdcfbc49ec28d0913205f0bef,411,197,3,959,411,0,01012,4
69d99d0d4c48707e0c941d9b2e9650d3,26,26,1,182,26,0,01085,1
9441a477e1d5d560c7a95066498cd6e0,37,37,1,259,0,37,01027,1
1e07532d40235c13fe856a561812110a,15,15,1,105,15,0,08230,1
44177fad14d52e507c4a3ff618c5e2eb,31,31,1,217,31,0,05040,1
e4568d5b7ebf3f8dacfb7a72da92fe3f,64,64,1,448,0,64,08132,2
13c1371c01ec15a7230bbc6ea6092682,54,27,4,94.5,54,0,11080,2
43ccf45e5c8c59a44735e31049b5c6b6,25,25,1,175,25,0,08032,1
c39e354235c2bcb27a17de07ae644c7f,18,18,1,126,18,0,05100,1
2fc3002f71fedaf920951421433e2d10,18,18,1,126,18,0,09091,1
5c33a28cb3348ea524caf3a69fc436ac,8,8,1,56,0,8,01014,1
3d889683c7daff13dc3dde46bd165766,294,135,4,514.5,254,40,01013,4
d33b49abf5f00e8fdc45e088bf9b22ba,11,11,2,38.5,11,0,09130,1
7f1cd448a7c3c1f6a62cc8b64eb59e4b,84,38,3,196,67,17,11104,2
9d85052aceebfe8f12777df1482ad8ee,26,26,1,182,26,0,01012,1
510657e8048dfcafe3f72118bec68510,217,80,4,379.75,217,0,08312,4
3cbfe7771537c3c2c66ac6e6cede5101,122,83,4,213.5,111,11,10200,3
59a958fd42476f59aa8e66312fb4d091,45,45,1,315,45,0,10140,1
f929187e00377074e88cf8df727228b3,22,19,2,77,22,0,05030,1
7c28fbeb3381a1dbf929cf69ac37a61c,1,1,1,7,1,0,11180,1
fb349bfcc93af337e7bdcea974ae7663,91,78,2,318.5,91,0,01026,3
2e41827d54de1a3375f7aec7952adde3,16,16,1,112,16,0,08313,1
ba46882e4c2d465b1d848fa8f61197e3,13,13,1,91,0,13,12500,1
5aaad63be04968f7d0f4f837c777565d,117,96,2,409.5,69,48,04020,3
33c8d7057b44628281313dc50546ab93,40,40,1,280,40,0,01026,1
22e5c375c4573cfc236098acffc5093f,25,25,1,175,25,0,14301,1
9295b5f2a51ed0487b5d64ba0708c7e0,130,72,3,303.33333333333337,130,0,09130,3
5590568fbd4a60d2d7dc331a06af9e55,607,201,6,708.1666666666667,577,30,01012,4
bddd63b1bfa1bc0ed610335180c79710,44,44,1,308,44,0,01027,1
ffd97b017d5c5a6b131bde1ace296ec2,147,81,3,343,147,0,01026,3
0e8322564a999472dad9dedfc3f4176d,272,165,3,634.6666666666667,169,103,09130,4
060407f3ffcd7a56b87bc9dffe45ccf0,33,33,1,231,33,0,01026,1
20b1e12802762b1858b9e2863e479a84,86,72,1,602,86,0,05040,3
7eb65fff75170d5f88611a1f7eacb47a,18,16,3,42,3,15,05030,1
ed8856f19f9f0f0dffd5b0185fa03f1f,16,16,1,112,16,0,09130,1
7428ee7b3044e69a0c4dc8954cee1ad6,1,1,1,7,0,1,11140,1
c263e6004fd79858b08b049aeed8bdc7,74,74,1,518,74,0,01026,3
fa737189e7547577b0bf6039043b3166,16,16,1,112,16,0,09130,1
ca28abc8a3f3e3475530a17f0c208e18,65,50,2,227.5,65,0,01026,2
7c5e16ef0c5641746888ebc081ee212e,80,60,2,280,32,48,05040,2
9d81e3703dcf04787831e6b6bfb79b93,88,66,4,154,88,0,01012,3
fb2c76f67f7d7a90648c5eb8dd15a0b8,47,29,2,164.5,47,0,10200,1
e194d42f7c34f57e8be4858734e58d6f,47,47,1,329,47,0,10200,1
104e53dc9afb7bd4dbb00be26e53a493,182,116,3,424.6666666666667,182,0,05040,4
e8e31f9b3edd52e9ea0f8d9b4d195ce9,65,35,4,113.75,39,26,04020,2
9358176b55c0715ec4ea1b8bb839caf4,63,53,2,220.5,63,0,11040,2
fa73074abdedf2699cf3401521a914c0,13,13,1,91,13,0,05040,1
02798a3b159bf3cc62891dd8bcb7fa25,249,103,4,435.75,212,37,05040,4
1b32ffa81ea1b22837485f74daa17fcc,200,106,2,700,200,0,01085,4
da071e72b7b775131e72182dc10f08db,110,74,4,192.5,110,0,01026,3
d45d19a8795d20f4c19c4ead4aa7024d,9,9,1,63,9,0,01013,1
81b03749860bd34140b5bd52458c0cc8,8,8,1,56,8,0,01085,1
c61186ee36de2a31fe3dac06133a1721,29,29,1,203,29,0,05040,1
bd94dd4ace36b923b9cda1b3459b2157,121,93,4,211.75,82,39,01026,3
dd18d946b2258905f46aedb5d60ffc6d,194,120,2,679,194,0,01013,4
e90f24026627ed0cfeb86a1dc6f2d984,276,149,4,483,276,0,01026,4
d2fc9570905a943276888204228ac176,77,62,2,269.5,44,33,01026,2
df8340a5da58cbd9034743c3c2079d9e,345,106,3,805,273,72,03050,4
01b54d9bf91fe460669778a9e0fde857,62,53,1,434,62,0,01012,2
95ca70ca5731fbd560ea53f39e2e4e3c,39,39,1,273,39,0,01026,1
329dfe5355845737949ba7a4da893fad,121,72,3,282.33333333333337,121,0,05100,3
bc1e23cac8cf3f583e4e142ccc7461b4,20,19,2,70,20,0,11100,1
5dbe3de6a3b4c23c67ccb7312d9e0a45,52,39,2,182,52,0,05030,1
f5fb11677c6847741e0d2d7b565dc85c,61,44,2,213.5,61,0,05040,1
6a24efa55d252cd8c019c38d8052a020,173,91,4,302.75,126,47,01026,3
7f2987636908bd8a798cc619a0cef927,23,23,1,161,0,23,10152,1
71717fa0f4eddf33d947346c355328c1,313,122,3,730.3333333333334,236,77,01026,4
69b33f54f70e764b2751a7706f920eec,65,56,2,227.5,65,0,05030,2
552b29d51200edbb29d5cebd7d36db04,31,31,1,217,31,0,04200,1
ae0a9ba28c41084d9c654e164ec3fac7,28,28,1,196,28,0,05030,1
36b039543ac77ba12eb9c9e0390b6d54,90,72,2,315,90,0,11040,3
e1c9f05035d4501cedbd476b23cf3299,63,59,2,220.5,63,0,01027,2
9d0602f001e257c3fde8a76a2bb53f62,329,52,1,2303,329,0,01012,4
2585715e8a5415843b565ea737585600,56,56,1,392,56,0,08010,2
6172f3eb494672145ebd209b202df74a,224,112,4,392,184,40,05040,4
fad42389678fbc013ab9981afc629004,225,168,3,525,75,150,05040,4
24d59ea580e0c034bf5fa5a481fdd274,81,81,1,567,81,0,03090,3
49010aec2b841125c38f059e39f27ec0,133,103,4,232.75,112,21,11040,3
05c11a7d61fd65a3ac6048388be49119,14,7,2,49,14,0,11040,1
73a1aded082f528eb61006e437010641,22,22,1,154,22,0,01013,1
d116433881c0c31a97c6dc8fe39c71eb,17,17,1,119,0,17,05100,1
c02c6f11479a6a3d6beeb4408815b7e9,222,102,5,310.8,195,27,04020,4
e588d4d0e432636acaffefbcb7fa59c9,118,84,2,413,118,0,05040,3
bcf40c4b9fd7a1b8d1c2c841c7fe99fe,18,18,1,126,18,0,05030,1
5e470a4616ae1c0f075dcc85ddfdcd85,94,71,1,658,94,0,03070,3
18b367e93200dce0e5d871ca0d06f01a,41,41,1,287,41,0,12570,1
ddca4650846157ede0cfd6e27c707223,210,143,4,367.5,210,0,01012,4
a8686078acfb4c3109fcd88d9fabca2a,644,151,2,2254,644,0,05040,4
4ea0508532fd20acf5b139012cdf2f65,25,19,3,58.333333333333336,14,11,11040,1
c7ee267d494934c866c7b28b6167892b,16,16,1,112,16,0,11080,1
fcf98f33e656bdea719718a0e66c45e0,133,101,2,465.5,133,0,05100,3
29711027f7b42c276cd84e302852f2c9,250,162,6,291.6666666666667,209,41,01026,4
e8142b109d3d6e36f81f82e5cb38e4f2,132,119,3,308,132,0,03050,3
2f7edb990d4ee490226e6973908825ca,110,88,1,770,110,0,01027,3
e21567d96dceeac372092bd8adfad30e,14,10,2,49,8,6,05030,1
d7fd6754820cc6c9a2df476cd3e3f09e,49,39,3,114.33333333333334,49,0,01012,1
9dd11282fd3e76bf37a79743de03ffe8,9,8,2,31.5,9,0,08100,1
9ac7a5826469676267968d37705de888,209,122,3,487.6666666666667,155,54,01026,4
1a157d62f3bc4a509446827091f0c356,5,5,1,35,5,0,11100,1
b4a6bfaca186935cc24d6ae3e599b551,34,34,1,238,0,34,05040,1
e58a31d2de9aa285fe9c8a7d48b61439,23,23,1,161,23,0,09130,1
f27c506b5b51ff528a2c1e4198249a10,29,29,1,203,29,0,01026,1
d3b35f1309fe0e02d25dad1aa73ce8a1,200,117,3,466.6666666666667,141,59,10200,4
9a58765a1f2fc7b6a53cc202e7b908d9,269,169,5,376.59999999999997,215,54,04020,4
b54a2949d4b21752b8b4e6fc2e8f1c2f,164,97,3,382.6666666666667,58,106,05040,3
aca30afae48ff77044e7a465ab884b3d,30,30,1,210,30,0,02691,1
fcdc8f1af64245d48108086fb8f78162,215,130,2,752.5,124,91,10200,4
e05966bc4f2afca064c4f3abea6b6bb6,68,49,2,238,29,39,04020,2
6271313c2d393f80b7048ac36edb8f51,361,179,4,631.75,259,102,04020,4
3416f0e5ec1dde8c8b63f92c9cfc25b9,26,26,1,182,0,26,13953,1
41abc0e4345e10f670381595aa0835d3,27,27,1,189,27,0,05100,1
48f4b7220699021e721cb07e04845082,365,130,6,425.83333333333337,304,61,10261,4
6a9f565ee1c71d0977818bf58cb30c4c,82,70,2,287,82,0,11080,2
9fe2489c359eccd0cf76dc08d1f82be4,52,52,1,364,52,0,02620,1
e1e2f4cf2c6d2f91733425aff34cde29,42,42,1,294,42,0,09112,1
bb67614db606918504ee8b837187e948,2,2,1,14,2,0,11040,1
5181713f257bce7e355335c9b1b7882e,69,59,1,483,69,0,01026,2
5a92b9bc7f6b6ded267d5ceaf4312a2a,103,80,1,721,103,0,05040,3
53ed6dfc5f3f7e57d1325dce984f7492,19,19,1,133,19,0,04201,1
a0d188eaf4b496d111c611fd716489e2,43,43,1,301,43,0,01013,1
5ffb402e369c158787abbe1c44c5ba5e,213,102,4,372.75,180,33,05100,4
d144e72c8d046f3c9d6c2c0eaef70d3c,33,33,1,231,33,0,01026,1
e5b21c77d09246117943c137d49be208,18,16,2,63,18,0,01012,1
6b657de44ebf36dac4e292ac02bde79a,129,75,4,225.75,101,28,01026,3
35244647fd80a668a274fb6b1ec2680c,45,45,1,315,45,0,04060,1
d7a69439b8f0f92fc34f4dd923871d91,65,53,2,227.5,65,0,01026,2
c6b4e2b3117427a0c8357cfb4356ab1c,12,12,1,84,12,0,05100,1
425871824eb6ff2e2c5c55afcfa3f41f,97,74,3,226.33333333333334,61,36,05100,3
f1e595e58416fd045fe97558a88fff2b,46,46,1,322,46,0,09090,1
91493a09988d6b279e5a1cbec9467093,113,75,2,395.5,68,45,03050,3
e750e5b31e620c9f65e20a5d5bc36a3f,79,44,3,184.33333333333334,51,28,08150,2
5c5e91a31fd0550642d1dd7be6c27887,238,112,3,555.3333333333334,238,0,05040,4
10e54f68760ef1e4b0d5fa5610b9f861,52,52,1,364,52,0,04201,1
c3efdd9407108a463f12c7477ddb8c98,16,16,1,112,16,0,01200,1
1da9583017b0f68ca9560ff2b1a5bf8f,50,50,1,350,50,0,10153,1
8843ecad09de5b69d88594dba9309b0a,102,45,3,238,102,0,04020,3
59433320d3369fab8f0ae7ede0f97a06,18,18,1,126,18,0,01012,1
73b30963b3f0f1d655bafe37f5cc89e9,107,76,4,187.25,107,0,10200,3
5e00107df01e28e667004ba1425a50bb,212,106,4,371,77,135,05041,4
8997f5aeb6a045610aead5118154f3de,97,43,4,169.75,73,24,11100,3
d33c4ff189b834f4d8e94bcb4ebaa675,149,92,3,347.6666666666667,149,0,11140,3
3d87146b3de2dfe659469393406b904e,31,31,1,217,31,0,03033,1
e89e2bac736e181a2130ede815bb6753,20,20,1,140,20,0,05041,1
43c966b428e6f0323af9f16477860fc3,87,63,2,304.5,87,0,09110,2
fd610e8ac088b1709c612ba8b45b7dbb,42,18,2,147,42,0,08150,1
3e3c841db8e4d5f663b45cebacd2dc43,288,159,4,504,288,0,05040,4
92f282d8e1728f978791e4a1d48aa8e9,97,64,3,226.33333333333334,68,29,05040,3
ea30779fc78e79cc758df51afba996ea,68,68,1,476,0,68,02650,2
881264c317c9a93eeca7a301d81119c0,123,91,2,430.5,123,0,01026,3
e66c87cc59880b1e0f23c73a517d76ac,202,115,6,235.66666666666669,110,92,10200,4
972259bef3e5a0bbb3f924a3d360dcaa,103,89,2,360.5,103,0,04020,3
69ab5ad38b3adc90ee6ed97b2b2b299c,45,45,1,315,45,0,09130,1
17ab5afe749980671b565714682d4869,122,92,3,284.6666666666667,122,0,05040,3
fce83813407729f295bc884b38e0e933,131,96,1,917,131,0,08010,3
18dcc5ffbe3267056e8d040b5f95fd6f,6,3,4,10.5,3,3,11140,1
9850b91b1de18cd83d04beca8a5e4784,32,32,1,224,32,0,01026,1
8cfadc7d25b47255a9a1fc9017d7e85e,33,28,2,115.5,33,0,01201,1
d4264b57439b681d177f4f138a55dc94,505,143,2,1767.5,40,465,01027,4
04fa92b4bb305e0c0ccf84c8bf05b06b,20,20,1,140,20,0,08132,1
15d9fbcdc61680dbcf246a22cc742e8f,31,31,1,217,31,0,10220,1
8f6a41c9b1453bd1f05b1582c00b9b4e,22,22,1,154,22,0,05160,1
344e80dc26af97eb5aa3a64e2448c1e0,191,97,4,334.25,129,62,10028,4
74dd006cf8f8a95dd52628b8c70a4035,31,31,1,217,31,0,05040,1
46b02f881ca68d3ea5294c0ce30fd62b,13,13,1,91,13,0,09030,1
d5709d57c0807d4b630706d04b132939,46,38,3,107.33333333333334,14,32,12570,1
a1c9d22ec73adcf4c950d0774c0d42a0,85,63,2,297.5,85,0,05040,2
acef5542d4516d14e7b2c101bbf40661,33,33,1,231,33,0,08230,1
956817e2f25e8885d646d676864105a3,154,106,3,359.33333333333337,126,28,05180,3
470f2096267dd06f989ac37a617fac07,37,37,1,259,37,0,01026,1
2d0f724cdc5decfc130375ca2b651fe0,192,101,3,448,131,61,05100,4
c965ed49fb1549a64810acb36e507b1d,21,21,1,147,21,0,02750,1
a3d971bd95f8c15e38b95598eb82a839,17,17,1,119,17,0,05030,1
0695d680bc394aa71b00ece0ce982265,156,119,3,364,156,0,01012,3
b1c48870682f4f3d176107a426c2debe,131,96,3,305.6666666666667,131,0,11140,3
a4ecbcd57321d107e2374c1cb19edc6e,53,52,2,185.5,53,0,01027,1
f0cbcacb75c710b10771d13fe2fed9a9,145,103,5,203,145,0,01027,3
2393446f78100466fd5618925513f8cf,52,38,2,182,52,0,10200,1
486420ff6cd7a69099f1f8b630521b21,11,11,1,77,11,0,03033,1
b7c2a33f375fdb36b952f62617e4264f,42,42,1,294,42,0,01013,1
67b7997ba1c69eef20d620fe4f1348d7,136,88,4,238,136,0,01026,3
21cd6b3c7cbbc2f70e8a435dc29d4176,52,52,1,364,0,52,11140,1
e488dab03b76535215a63710c9548415,49,44,2,171.5,23,26,01026,1
921c0eecda7231e64f82be77c05bd311,118,81,3,275.33333333333337,118,0,01026,3
d04db6ce16887dd717de2001fc315939,26,26,1,182,26,0,11103,1
e788ecac605b3ab6af5a98990291f794,99,81,2,346.5,48,51,05100,3
b24255dca9648ceb4115edb62be16784,16,16,1,112,16,0,08052,1
d680507271d728d506cb81bd71954e73,71,52,3,165.66666666666669,71,0,10200,2
6cbd6a4f9720caa4ea8762352b918064,497,140,3,1159.6666666666667,273,224,01026,4
e6544c3f8af9ae96a4c33536dc8576f6,29,29,1,203,29,0,03050,1
5805cce9b4667d821f4947cd82b62363,216,124,3,504,191,25,04020,4
4011949511a6c4afda4a7042f39cadc8,99,78,2,346.5,99,0,08031,3
d96135c5f279677a3d42abc1871f099f,19,19,1,133,19,0,10240,1
8656a8976e584110655725bfa4ee2429,19,19,1,133,19,0,05030,1
4a7af196a771c5ce98a8f3d6d2c3ba35,146,52,2,511,122,24,05040,3
b475ecd1a0ab95cc5d69c6ee17dc3a09,19,13,1,133,19,0,05030,1
7a6f7ff186d451929ef7aa529157b23e,12,12,1,84,12,0,12570,1
ae6b1b641cd176c696a470c8bf6c05fb,33,33,1,231,33,0,05040,1
b916573e7947adc3d7b0a5d3f735fd43,20,20,1,140,20,0,05030,1
2a24aaf813c4907df3fdde265cd634b1,18,18,1,126,18,0,01012,1
9cb9540e41e48c635765c477841eec40,192,105,4,336,173,19,01026,4
53e2b5f7686a2021257bb5431f741cf9,8,6,2,28,8,0,11040,1
38b8b6ac15e5935f65f50ac9b6c03635,20,20,1,140,0,20,05040,1
e5bb71d1a320e282ca3ae514f18a6f93,95,79,2,332.5,95,0,01201,3
f70281fdf2269c5f1d8ed390335a5e0b,102,47,3,238,67,35,08452,3
babb1349a8b1b8b5cc6903defbe912c7,57,57,1,399,57,0,05040,2
7e3dd017cfb7d9cf51345f1351ef2679,40,40,1,280,40,0,02751,1
7dd1b86f6dff44cdf70d6df1bd0bbf98,75,75,1,525,75,0,09030,3
9a767ca15796a670f7f2a434fb6da1c5,22,22,2,77,22,0,01085,1
e37e637b103fd18d77f66ddf50f3676c,45,43,2,157.5,45,0,01026,1
ff28b14782c6b369b889460448ed80a2,39,39,1,273,39,0,10200,1
35ae65e14c9afdd51f4a5d2d73a05330,46,46,1,322,46,0,01201,1
116d1cd07d87c6aece803410d2616a4c,109,60,4,190.75,109,0,12410,3
6e81c6f96f8c5d9b35dd68194edb908c,194,80,5,271.59999999999997,150,44,05040,4
4bcf9cb401edae625ff11c4fa334602f,14,14,1,98,14,0,01012,1
54006020f36851cb36016979ebff0e2b,9,9,1,63,9,0,09010,1
22920c6065e5b694c14490cf047f3d4c,51,51,1,357,51,0,01026,1
1f59f759bef2935c5a7c46a242d5a957,44,31,2,154,44,0,05040,1
3587ab924d45c47ace67d4ea046d6f7b,176,83,3,410.6666666666667,176,0,05041,3
3cd05fc157a8956110c01683ee02afb2,15,15,1,105,15,0,08100,1
7a6424219848b5774b51cf9d85b894d3,69,62,1,483,0,69,05040,2
b917b4fe877daaf15ef99048615b07cd,96,75,2,336,96,0,01026,3
638dbcce089320d58d386f02d9ac46b3,114,75,2,399,20,94,05040,3
690d4f68f1272dea54e53963b988434d,79,63,1,553,0,79,05040,3
bd8a3d32200b46a12870cebe0c88cd4d,83,68,2,290.5,83,0,04080,2
67851b8a7cdc3f524e8b3bda7a67bb86,79,54,3,184.33333333333334,56,23,01027,2
be6f53a8991c5916f5b35e792496c2ba,23,19,2,80.5,23,0,01085,1
3b6f304235553187042cd5479fa0e6e9,91,73,1,637,91,0,05040,3
3f9fa83b28dda941072b796794598d3d,38,36,2,133,38,0,05030,1
2cb18b81a28faed8457c48427e7053ab,146,84,3,340.6666666666667,98,48,09130,3
44968be4045a96612e241174715888b4,15,10,1,105,15,0,11040,1
188db362ee7ec426f92fb5855b461eed,168,97,5,235.2,142,26,05100,3
16040b28ce58dd285017250847b94380,20,20,1,140,20,0,01013,1
3c1bf2d274a454594f87e7e7c19a9708,51,46,1,357,51,0,10200,1
09f6b99e934d571a7bb054339ddc5833,30,27,2,105,13,17,05030,1
74bff60049a5829cd506ba74e74ba9b8,36,36,1,252,36,0,01012,1
af85931f267448c66fe7eea7edca28ae,70,58,2,245,70,0,12501,2
1cd0568f0a6a2fa1902bfdd6fbfcc2f5,121,85,4,211.75,121,0,01026,3
d5d32a33ee2ccb92b9c79188e8244b07,88,68,3,205.33333333333334,64,24,01012,3
0185fdcfd756a8715b3c213b8134246e,11,11,1,77,0,11,10200,1
117606eeffcfce53d00f64745a9b751d,19,19,1,133,19,0,10220,1
6affb68b7f6f1c34a9f1fe0fbfb554dc,176,96,3,410.6666666666667,146,30,05040,3
2fc2a577ef10ff4a9ca5b63eff7c7bfc,15,15,1,105,15,0,05030,1
10dbf3733a6c40eb5a92993a9f982a0b,45,45,1,315,45,0,01013,1
05edfda8bdfe26b5328d22a437630b30,332,124,3,774.6666666666667,332,0,02690,4
124ed36274552c3b0c83d09d6de50004,15,15,1,105,0,15,11100,1
2d3dc07526e2001a17f2dfa677c49c14,16,16,1,112,16,0,11040,1
562acad068bdda606f1d4f6c9e5b907a,14,14,1,98,14,0,05030,1
d65451406fab58faceade7091eb103ba,23,11,4,40.25,19,4,01013,1
9de59f177dd36703a5cef80819d27139,74,63,1,518,74,0,12590,2
7f206533623d810196984141e1e3d5ed,26,26,1,182,26,0,11100,1
bb373ce5d815ea882b806af066e97839,33,33,1,231,33,0,01012,1
a4b1aa1493a6edc99ed7add22084ac36,22,22,1,154,22,0,05040,1
aef061c3ec436abb348b80e2a3357268,136,72,2,476,136,0,01085,3
54c2dcb87d9ac4d9c28ba1837d6187cc,49,49,1,343,49,0,03050,1
05904a3556a9a36fc056ca1541f2da08,511,165,3,1192.3333333333335,511,0,05040,4
c811c9c7661f385c6e0056386fe0b008,56,35,3,130.66666666666669,38,18,03070,1
f9fa2ee03b8ad5a9b929d2cee20b94c7,39,35,1,273,39,0,01027,1
8747e8b15557460a81dfa2ae5ee8c521,42,42,1,294,42,0,05040,1
dc26ed56d81e2010e9f9f117535b22aa,109,81,3,254.33333333333334,109,0,10200,3
bddbdabaed98226037217bfbce69daeb,144,84,3,336,144,0,05040,3
4b789a02bd21888af94c73401378227d,34,34,1,238,34,0,05040,1
3a16cffffe167185e15fd87cb6529ec6,27,27,1,189,27,0,05040,1
b2e830d48c19cee329eef0a663bfc00a,359,149,4,628.25,359,0,01012,4
10b5424c9ae11ed0ccde18b9fa097f00,68,50,2,238,36,32,04020,2
d2e0511614e9dfb4846e12a9176cc1d4,100,67,2,350,69,31,05040,3
70206856a6eb8abe39a498a7d2853454,42,32,2,147,29,13,05041,1
57181e8cde60ada432cbd4e8b8b242d0,14,14,1,98,14,0,01026,1
96214e727818e2894ff5fcaa232f1a0a,342,124,3,798,342,0,05040,4
51b622c7fa1b7fea60a6401f4e97cb8c,639,181,5,894.6,639,0,05040,4
0f300552f65029a439a9f2caf6491935,315,138,4,551.25,315,0,05040,4
2a5f7106b8bfd9d2788ee9f1a2edb258,55,50,2,192.5,49,6,05041,1
ffe007e71c1ba4cadcf6e62299a8b7be,48,48,1,336,48,0,05040,1
cbc5a951df4cad80abde6acb7b716ddf,63,58,1,441,63,0,07131,2
df7d8b100abaa794a4d2ed012d5d35f3,348,133,5,487.2,316,32,05040,4
7cc26a5df739cc4a5ff5729d7dea2c64,79,53,3,184.33333333333334,54,25,10200,2
47ef6cb8491201a8faf584d3efb6473d,130,95,2,455,44,86,03090,3
3e761209e334dcc8c8243addd83e5e8a,82,56,1,574,82,0,01013,2
5b5bc7444b2ea0b56de22184b64e7d62,29,29,1,203,29,0,05040,1
93b379bf740e2d21833deca51fec8101,38,38,1,266,38,0,10200,1
71d80bb22cae11ff58fd3a47b8878bfd,46,39,2,161,46,0,05030,1
7f42bb110c3f9f404df7cb742f3be442,30,30,1,210,30,0,04080,1
016a3b2687f1e87ec2a384ab2e0dc8f8,199,125,3,464.33333333333337,66,133,05040,4
df034a23449f113cf179b929dd448f97,112,62,3,261.33333333333337,112,0,08314,3
41d144f57ea76e0bfc7c269ed6403ec9,136,89,2,476,136,0,03050,3
633c7c8c15a6d233c476fa6e17496ac7,5,5,1,35,5,0,06100,1
32f2be0173fd495e0625e9974e94462a,71,29,4,124.25,71,0,05041,2
a79a426a1f80c4bcfde48c175a61d52c,41,30,2,143.5,41,0,05040,1
8f821b0f80d9ff66392f0f6f057853e8,196,85,4,343,196,0,10028,3
07385b11615d01a89f40357d67195342,105,82,2,367.5,105,0,10200,3
e764c5aff0dd050a4f3cceceec3a52bd,31,31,1,217,31,0,13820,1
09d70bd8ed297adf834f39c15246c7ba,117,93,1,819,0,117,05040,3
c87ae0ef02c43d5d1e577f36022eb105,62,45,3,144.66666666666669,62,0,05030,2
2931e04ab316f954cc2c23985b736b63,49,49,1,343,49,0,02620,1
b995190ec43d24c59f084189710c5087,44,39,2,154,18,26,05040,1
d4bbee1d1d0193d692f1aa986b5b2d50,31,31,1,217,31,0,01026,1
00054553b480893c05f2e044625074ae,18,18,1,126,18,0,13490,1
0b7900f95adc5290b914ab7b28e60408,266,103,5,372.4,266,0,05040,4
167419b09ff04233828760ecfb8dd866,81,63,3,189,41,40,08010,3
998eb105559f2f9f4e3de0931f6f17a2,46,35,2,161,19,27,09090,1
d79818bc703c9ee3a7238f87d5d9f5c3,57,47,2,199.5,57,0,03070,1
66846e430f88310bc0da8a61fa9fab4b,209,102,4,365.75,209,0,01026,4
1c9f97c8d973c259e0c2a1468ea906a2,48,48,1,336,48,0,05030,1
7e2ca7f1a88f31ce04b17de3920f1b3c,37,30,4,64.75,37,0,08010,1
5df37389cffdf24bba9383d9706bd7e9,159,76,2,556.5,67,92,05040,3
4117284e70df587c459f9bcec49e7ed3,228,89,4,399,129,99,09010,4
0427110dc4545670afa7ce114313d8ec,21,21,1,147,21,0,11081,1
3efbe24ca6aea9b243116584895c0eed,49,45,2,171.5,49,0,05030,1
1114bc75b6490e78ebf88ab1e2977f13,320,122,4,560,320,0,05030,4
c0b718b3ef1efddc9cb2dd245ea01b33,241,107,3,562.3333333333334,241,0,01026,4
e8f6462c299575c8a45a4466afcf265e,230,129,4,402.5,194,36,05040,4
33549fb6b78bbddee68791f608ab6c59,15,15,1,105,15,0,08052,1
9ac9202a1650c7bff66d09d5a1fcdfd9,13,13,1,91,0,13,10200,1
67da88046944a0150156749ee1ef19f3,480,115,2,1680,480,0,01027,4
7547759081536ec06b9d5eeb3f56aafa,16,16,1,112,16,0,10220,1
36bd4dfc1fb91c28016702e03a771208,44,38,2,154,44,0,10220,1
9d49e7e23b05c603c042b953b0fcf966,65,57,1,455,0,65,01013,2
3521e95af041739167351b3100ff4f27,82,71,2,287,41,41,01027,3
02edf57d306605a7eccfe21f41194c97,89,59,2,311.5,89,0,10140,2
609f55db6d9248b4be752ef13cb765b8,75,35,1,525,75,0,08010,2
97a0207678c3ae34078738e730d8f089,34,34,1,238,34,0,12570,1
b9029c45d4ca554303f6a2ce951e5c81,137,59,3,319.6666666666667,137,0,05041,3
e10c207a1c0237067c29ee0d9b44102e,28,28,1,196,28,0,01012,1
a24dedf24d8da3ef4061c13e0ee40054,17,15,2,59.5,17,0,08031,1
e5e951307f47b55fe25f76964b29767e,255,138,4,446.25,224,31,04020,4
de6eb56c62621d1d480aa145e7ad9764,84,57,3,196,84,0,09150,2
b7f5a24da9a946bfd01209656b5e7b12,232,111,4,406,232,0,11100,4
19892d22d1cda4c24314b529b7570dfb,174,83,4,304.5,124,50,01027,3
46f76ca00720f0e7dff2dd33a031425e,36,28,2,126,36,0,08100,1
d8ca0b6908a20362ce172df14173cc3e,32,32,1,224,32,0,01012,1
720e6bbc702161dadd9e3c08d1400f01,296,172,6,345.33333333333337,295,1,01026,4
3acd8745ffdc48c214e960f8e579f034,19,19,1,133,19,0,09130,1
d7f979f78cae3e2926ec712dda8a1f8d,467,208,4,817.25,250,217,05040,4
4bfb6d9a713293c6ae90e58bae65cb66,325,152,4,568.75,297,28,05040,4
63691da05ef05f306e3036eaa3ff3ce2,12,12,1,84,12,0,05030,1
666029a9ad41096597578767cc54e662,35,17,3,81.66666666666667,35,0,05030,1
ac2f9a45e2812ad8521f233335b726e8,13,13,1,91,13,0,02620,1
e749068906ffac5ba608ef5f64fa8477,43,43,1,301,43,0,05040,1
30d979eeb4bed710aa50ec88754359a7,61,38,4,106.75,61,0,08150,2
e53f7987013536fa91f9523ea62d8e5b,1,1,1,7,1,0,05040,1
0de9f6d9710322dd4f8ebf6cecb37521,13,13,1,91,13,0,01027,1
70cc485dd72d81b1ddb4249bf4da1ff8,24,24,1,168,24,0,01201,1
121bdc3fd77ad6b096a1650319b3aed2,32,32,1,224,32,0,12742,1
daeedd9b611c3acc15d499fde24f9e8a,180,120,3,420,180,0,10200,4
d5db4c68c33c13d6cc3f5e6818affee6,146,86,2,511,91,55,05040,3
2dee94d7413fad120912380db99887fc,26,26,1,182,0,26,02690,1
82841403fe854d8911a3102872126b64,141,56,6,164.5,130,11,01012,3
8663b1b522465a4951521dfcec849fdb,33,33,1,231,33,0,01012,1
de9fff87b4ca1038809e5e4b1294eb48,8,4,1,56,8,0,05030,1
84b4b9316e9e33255b35834357f2b134,155,90,2,542.5,93,62,09150,3
c01057b36221af495af71caca78010d0,24,24,1,168,24,0,05030,1
7b9dd68879694acc36d1c345c73762ea,41,41,1,287,41,0,01026,1
0ec3ebeefc828e37ba854e99afbcd430,32,32,1,224,32,0,01012,1
b2e144ac28804f4c006372cf44ea772f,151,77,4,264.25,151,0,10200,3
005489dd6890d9947744045d5cdaf630,51,51,1,357,51,0,04200,1
6eb5bfd80fff9d178d2e53d46029e895,64,51,2,224,64,0,04032,2
457120dc845b5e1b39b7382bf0b6b58c,69,50,2,241.5,31,38,01027,2
54e73abd31bc23eda8b9bdf5fbebdc98,150,96,5,210,113,37,11040,3
375fa4419e071ec1ee001f7cd8c5075d,298,127,4,521.5,298,0,01027,4
054ab4385e3e7fd09ce8a9e6454d0a7a,22,22,1,154,22,0,04032,1
dd7dae6b0668be3bada3c9e0dccaa923,116,85,3,270.6666666666667,116,0,01027,3
e1726bbc3440a1871b5fe3e5cf74fc60,56,47,1,392,56,0,05100,1
2ce1460ca5a1ee8c4205c0775db0b8c3,502,258,6,585.6666666666667,418,84,05030,4
6d347e93fb1c4aff3ae3feb619d8b426,72,54,2,252,72,0,05040,2
4e6bf86aaaacbcfe62c68d909c2bfd9b,156,108,3,364,156,0,09111,3
a8950a23fbd844003cf55408a94cab95,76,76,1,532,76,0,01026,3
4431af759c9d18acb4b9d914d680415b,106,79,2,371,106,0,01026,3
3477baa67296e54cdf78d059791b7a24,89,48,2,311.5,89,0,05040,2
3f43869050d252682167237b381e564f,51,40,1,357,51,0,09010,1
8c5573cf8ade4499ebda2e51a7dc0288,19,19,1,133,0,19,11100,1
0b363f7563d4050e7a348ccfbb6cd591,37,37,1,259,37,0,03090,1
f0ef273755c995696045c3a66c14413b,47,47,1,329,0,47,04060,1
f86d6c2f5a53152edf5bb4d993d81f8e,96,68,2,336,96,0,10200,3
e2b4e5ae8afa1992a96d8f7b9c793cbd,1,1,1,7,1,0,11140,1
121d11604d9996ed7bf8598e368198a3,23,23,1,161,23,0,05100,1
ba6a62b8b8730eb1844e6c613de00e79,32,32,1,224,32,0,03070,1
cbc8f6c1cc1fbc81a8340002613e0544,15,15,1,105,15,0,02650,1
1337409299499f1a68210cd297562738,20,20,1,140,20,0,04032,1
bba13fcc08267242c693422cbdca929d,97,86,2,339.5,97,0,05040,3
e7a8ed02eee29de926707ec1552c17e1,23,23,1,161,23,0,11080,1
5340f9630a2cc063b9f3ab2775f4ed6f,79,66,2,276.5,38,41,09130,2
8505059b597b6d2a27b3ba1a61986d3f,23,20,3,53.66666666666667,23,0,09091,1
94a7bc5b65f2ad2f2e5dc16878608342,29,27,1,203,29,0,11100,1
5ce18412d7b84b26c25000f2241487ca,72,72,1,504,72,0,04020,2
a0caf24dfb79eb2df09f610705cf72fd,63,63,1,441,63,0,09130,2
97b6071ea9b4c4db7cec5d134e593143,30,30,1,210,30,0,05100,1
68c80fc4cf4fd6a7beedc9082c344cd7,38,38,1,266,38,0,01012,1
cd98d736688adf49ec5aa94ce5977352,158,89,4,276.5,138,20,04020,3
a283e17b3993d9406267631cf16e3b92,85,59,2,297.5,85,0,02690,2
0dcdb87f27a2ec1a3e258d1ba0b003e1,383,130,1,2681,383,0,01026,4
779a0bee985801efeb408d2acb161bc4,411,137,5,575.4,297,114,05040,4
21555a3d475bcfcdc2b303c0ec6030a2,46,41,2,161,46,0,01026,1
4152f19b5099b15f1eae7f807d6f4354,14,14,1,98,14,0,02620,1
0deae5e2d1d28e26e77a1867bd8753fa,261,103,4,456.75,198,63,05041,4
8b11831c48294ba0ae9701feb86d8a89,101,65,4,176.75,101,0,05040,3
d83b3395da824090b5df0fe8ea5f64fb,41,41,2,143.5,11,30,01012,1
94394e14deb73fc488127992c352fa52,93,76,4,162.75,79,14,01013,3
a05c952b37a767e9bc1c6772b1381d7f,123,99,1,861,123,0,05040,3
ace67cb16da068f7396288e162e8454a,2,1,2,7,2,0,11080,1
b2894a3092af03a83d0976f1c4e5c53e,22,22,1,154,22,0,05040,1
15aff63c4e7ad3f50e5cb322a5386e4a,29,29,1,203,29,0,12501,1
8ac8d6ac08030cd97af07435dabbf063,40,40,1,280,40,0,10200,1
1b852a69f60f2a209dca6cc138b131aa,16,16,1,112,16,0,09130,1
e31ad8b00c3cf165dfa62c07ee4fb372,34,34,1,238,34,0,05040,1
e66f41082145fae858812702f6bc3b9a,40,39,2,140,40,0,02751,1
bc92e15cb414043a13a98304c1d45b7a,34,34,1,238,0,34,01026,1
85bd3896c78c316408740475333acee6,8,8,1,56,0,8,02755,1
473b841556e5699f0c28f87d15049714,67,45,2,234.5,10,57,02691,2
04141e2a8d3f83fe28912ba7010d7f7e,137,96,2,479.5,137,0,01026,3
bd3469cebb5dc1227671d2fb092246bb,92,57,2,322,59,33,04020,3
c1bcb1884abf23aafdaa45149dd4d38e,75,44,2,262.5,55,20,12670,2
4dc49891e2aef29e428aaca9f900c18a,538,147,4,941.5,356,182,06100,4
24aae9f41e2d5a8bd2a67f0b9fe52085,507,129,3,1183,507,0,01012,4
3c10ed21dc8442fe9dd10f50ab320158,43,37,2,150.5,43,0,05030,1
ea576ce7268626813a968a5ef930d5fd,16,14,2,56,16,0,11040,1
5d3311b181dd651583785ac70a214798,79,67,2,276.5,79,0,08100,2
7ea315700e199e1a27b8d708b8ef7668,6,6,1,42,6,0,01012,1
d4909c983a7761e3958c98b288749a8e,144,108,5,201.6,144,0,01012,3
6e991be31a306f3ec63b779d9fc1cc2b,305,83,5,427,279,26,01026,4
c24149897f9b766d3850ab7ae353804e,85,60,3,198.33333333333334,63,22,05040,3
7361c1e54c05c6d10c9d63751f508587,35,35,1,245,35,0,08230,1
db0ed47b59b9463522f50694646ca0e0,77,50,4,134.75,57,20,04200,3
908440d83d7e8bbb80969860fdce61de,75,50,1,525,0,75,08010,2
8803279dccd81b2d6e65a165eb2f8bea,247,139,3,576.3333333333334,247,0,01026,4
424fa9d2b7fa69daf5fb0d4c1a2f4a2a,49,49,1,343,49,0,08230,1
8e78b9ebad8633123f9787479453e8a2,30,30,1,210,30,0,01027,1
d6cbbe392d563b9c96ab5f725cfdebce,290,142,1,2030,290,0,02650,4
f1d576db9527857010e8d7b7ea238346,39,39,1,273,39,0,09150,1
6c7a4f1c2b865c9f708223a2077db0f0,25,25,1,175,25,0,03090,1
a45199e274b9964952f9c10b0e797d21,26,26,1,182,26,0,04060,1
7599da87332fb22aa29c69badfd8f0b5,597,185,2,2089.5,269,328,05041,4
7e002cb343ea7e183902b7c7f73339f9,173,90,3,403.6666666666667,132,41,01012,3
21679c725715458d5d848adbb49b7cf6,33,33,1,231,33,0,05100,1
c5b906217a215780331d57e5825f7715,15,15,1,105,15,0,05030,1
61f44a3be39e33fd945889cbfdf261bd,41,37,1,287,41,0,01026,1
074084d73844891a5da52207cc5430a5,64,64,1,448,64,0,10028,2
87ce7ec59490fc8033336da3eca6a2db,169,80,2,591.5,169,0,05040,3
85ff13c0e54cd1fff59fe6f139c43ad7,155,94,3,361.6666666666667,99,56,08031,3
c8ba66912d5b545ef3dc5da15142d737,54,38,3,126,54,0,08150,1
95b12a26d7a7148e2aa9417a1618e8a7,17,17,1,119,17,0,14301,1
ec8d4e5c91b34e55d17741f2336eaa48,142,97,3,331.33333333333337,111,31,05100,3
1dcd05f644c1f611ba2976537a5f79f2,135,96,2,472.5,135,0,05040,3
d4a0aa06abdced1f3db7c1d63a6fd9e3,3,3,1,21,3,0,05030,1
fa1d12c73241a016886a4da0a2592150,25,25,1,175,25,0,11080,1
c8dfcb7002ab8b42390603a60a1fe842,14,14,1,98,14,0,01085,1
7330ed3165eaefaa4182838c21b94144,15,15,1,105,15,0,01012,1
4cfc92db0c6e1df7f0ef4d71ffaccfce,40,40,1,280,0,40,01012,1
360b37733e1acdf221f2c24ae8fab207,149,99,4,260.75,117,32,04020,3
ca4a6c072c85af3d347a4cde9f084818,76,71,3,177.33333333333334,76,0,05030,3
0a7e22366508ade3f8ead1193faf1549,9,9,1,63,0,9,05030,1
8882889a15b5e076e91e5997efdea47c,327,196,5,457.8,192,135,05100,4
0734c82d79e5c5c3b9ec9821256104b2,401,128,2,1403.5,146,255,05040,4
3b4b8909b7d4071b47f2321fed198d40,33,32,2,115.5,33,0,08230,1
09caa662684843018663f08dc60910b3,109,90,2,381.5,56,53,12590,3
30a4da11b0ab929f376f04626efc6ea0,295,112,4,516.25,295,0,01012,4
41776b617136b8bff619424682613b0e,184,118,1,1288,184,0,05040,4
f8af5c8f4650e6cadde969f3e9342603,22,22,1,154,0,22,10200,1
d12aa3ed0a08c62259a83fa25e803b27,258,119,2,903,165,93,10240,4
690c443965f39fc61102effc448ec077,256,139,3,597.3333333333334,256,0,08032,4
97642939c77c871d29ed936c90ced553,169,78,3,394.33333333333337,83,86,05040,3
092a8fe9962f57c74372b071575aded3,113,89,4,197.75,85,28,05030,3
da38e3557665141969b58b0e33333da1,27,27,1,189,27,0,05040,1
fc4a2b833fbce2a219ae82e994f925ca,77,40,3,179.66666666666669,77,0,05030,2
e2a92f0ee71c8086b134f1d6ae4fad6b,121,65,5,169.4,59,62,04020,3
b8bc155f6b55e73b57cd26705d1fea3d,56,53,2,196,56,0,01026,1
9b8fbd2adf9a52c85c9e72c21012d4e5,13,13,1,91,13,0,04080,1
700e3fbb50c429f83553949b050b5791,96,75,3,224,96,0,06100,3
66c3d5b74544f54c0d54fa84b60b3cdf,69,38,4,120.75,54,15,12610,2
5485cf25981ad1f5a4776c75afc2c8cd,24,24,1,168,24,0,05100,1
61d96437f04830b9a13cd966217f8c06,72,66,2,252,72,0,11080,2
d19ff29c1fb0465bbd02acba2cd17823,42,41,2,147,41,1,11100,1
04b293216a7e701dd58367552435d463,48,36,4,84,24,24,05100,2
4d2165961cbd269b67c62febf0013eaa,314,84,5,439.59999999999997,314,0,05040,4
3beda7e0762a073441fc2e5192f8f628,43,37,2,150.5,43,0,01012,1
e460c2b9f1f555199561a34805610986,75,53,2,262.5,75,0,05040,2
969ca6317e64e190db4764a1020cd4c6,56,51,2,196,56,0,10080,1
95675bd1cf7cd0cde15510a03dd26b7f,117,107,1,819,117,0,04060,3
f97d6b6c7b97203bd6fa1a61f9456fa2,191,98,3,445.6666666666667,191,0,01026,3
7f8be972ef5c39fa6b72ce6b88670992,153,126,2,535.5,153,0,05040,3
7f60a85201227e9b039e017a5be2650a,22,22,1,154,0,22,01026,1
149cd313cedfb9ced0e030a4efc46dbb,198,106,5,277.2,128,70,01012,4
ffdacd29e2dfe3ed3bf9e0152d2bba15,33,28,2,115.5,33,0,05030,1
44e6215d54d5b1707f3b12afd20843c1,16,15,2,56,16,0,05030,1
308a4e532ccc6f334c5878d1554bb085,252,126,3,588,252,0,05040,4
ba75d9ca064d86069240124fa1d6bc63,41,41,1,287,41,0,06120,1
3af14f5a6e0f766b62ac0d52ba8323b4,27,27,1,189,27,0,08031,1
aa11a443ea607e57f6b5d076351d77a5,3,3,1,21,3,0,11040,1
a1c7a270ddff06be797d22a180ac024c,50,50,1,350,50,0,01012,1
3b38aca635c4caa67e8c26d53c034c16,23,23,1,161,23,0,08051,1
82dd9d0365e60c61172413bfb6761bf9,23,23,1,161,23,0,10200,1
08d27e6d181f3da835a1cda71f3c6e66,52,52,1,364,52,0,05040,1
f29c1ffa88c5e81e4d6623aca33dbf75,88,61,2,308,88,0,01012,2
cbe393191d6fc49d60c900646e0cc2c2,34,34,1,238,34,0,01026,1
5603986c65e4174dd5e7f3d2ec8c71bf,24,24,1,168,0,24,03050,1
1c41e2cfe2447b5efec77c458741b30d,27,27,1,189,27,0,05040,1
4af939cdbd103b2532df3fdf4872d584,42,40,2,147,16,26,05040,1
e6dbd75892f61ec779bb8d0208048a3f,40,29,4,70,32,8,05030,1
37edd44ca86c48c82ce20465a5ae47fb,29,29,1,203,29,0,12501,1
9e1b8f40b8cc7afd953343c0676521f3,46,46,1,322,0,46,01012,1
15642218d548545b7fc3674d0ffe7771,84,44,3,196,84,0,10200,2
675014f25e7d9b1d6ff76225f11ed461,24,24,1,168,24,0,04130,1
2a9f7ab98aaff142788e4bc43fc21bff,27,23,2,94.5,27,0,01085,1
8aa7c69d0d4e4294aa21d59f14036169,82,68,2,287,82,0,12590,2
efb93d8de63be4c09791dbe4d363cfa1,99,83,4,173.25,99,0,01026,3
c64999b0625f02be387474884ec882a5,167,74,3,389.6666666666667,68,99,06100,3
233758b06821d4e85794fe170c9249aa,207,121,3,483,207,0,05041,4
493b9a2e0a3eb2047b9b04cfd3c6eab8,116,84,1,812,116,0,09130,3
0df5d8caf770c93e656a9ab5e36d34a7,68,51,2,238,68,0,10140,2
dbb9bc140498264a710e9d1367a085b5,49,49,1,343,49,0,10200,1
fb8627e9d8f6a83f028e70d4809a185f,547,192,3,1276.3333333333335,462,85,01012,4
188f10a6c9e3069b845b4ac3eb00b053,21,18,2,73.5,21,0,09010,1
472f049ea9975d2c2d594848ca7dc19f,84,73,2,294,84,0,05040,3
6cc194cd7f91742830ded4ce35ff3392,139,113,1,973,139,0,02650,3
8b83441ae26dd2d7446d1beac6a72b54,27,27,1,189,0,27,05030,1
809a9a2fdc0f627a2d4cf5cfb4111e4a,53,40,2,185.5,53,0,08452,1
c62b44ddfb537fc4595c292c6050afa3,85,56,3,198.33333333333334,85,0,10200,2
cf5e67c8d782cf1bc4eb1174ba0541dc,69,67,2,241.5,69,0,09150,2
905ae805c515a4f25e0ca2c7c9fa5b3f,52,50,3,121.33333333333334,52,0,01012,2
9a9736bfc0adb9c007f88fe8f5bf98b1,42,40,1,294,42,0,05030,1
1534671d91eff9bf3665d7e48cbea1e8,24,17,4,42,12,12,12650,1
f27ad0b84bb3aec68f83b1470e3169c4,28,28,1,196,28,0,01026,1
455f91a211e44df4fc798711debf7056,384,133,5,537.6,384,0,05100,4
16a3b4d25f7683bcc5dcc63814b5816b,85,62,3,198.33333333333334,75,10,10200,3
94e80945ac3198a41deb69444bae4a29,30,30,1,210,30,0,08051,1
2498f21221eaae85ade57fffc85bddec,69,64,2,241.5,69,0,01027,2
ce0e1b92cbc059bbd53693512a606a62,43,43,1,301,0,43,09030,1
3a8485f2bc55ed80643225e08b50dbba,97,70,2,339.5,58,39,09130,3
a1dfcc25db5b4c7bb83b774032b8aed7,43,31,2,150.5,26,17,10080,1
ec4ec7b516b3074b4cbef198811fc6cd,277,158,4,484.75,176,101,05040,4
d2955469e0cd3dec04eb208cfa14cee9,12,12,2,42,12,0,04060,1
27f1bec521e279cfb16f7578f3371765,11,11,1,77,11,0,01201,1
3cf6fa6618d3bd55fad93538804836e5,362,166,6,422.33333333333337,290,72,10240,4
63b82b302627c7adf7e44c58aa0ec4cd,66,52,2,231,66,0,08314,2
040a14b059c9b3fdab2c15dd6e672eda,59,45,2,206.5,29,30,08100,1
8009453acd886ccc8eaa05bac06c0c95,26,26,1,182,26,0,05040,1
28e35a21414a8e52533e60582cac48d1,222,103,2,777,222,0,05040,4
8b43a95749441c7cf2d863302073fa06,44,44,1,308,44,0,03050,1
acc986cd336ed8bef5ea85f8fd542e46,63,38,4,110.25,63,0,08010,2
cdc2fc755090847fb1a962cfa97a1325,32,32,1,224,32,0,08051,1
4bbd2d2d75e056c22b8e67b79588fa84,15,15,1,105,15,0,05030,1
e3c76587d131e723523818077640fb06,10,10,1,70,10,0,05100,1
00a2e7caacd9bc2dd7d0cd844136d487,8,8,1,56,8,0,01026,1
80612e37419b7b409a4f8866a0729f9c,29,29,1,203,29,0,01026,1
011f2a13349e88c0617222d80f4dc7ba,333,191,5,466.2,292,41,05030,4
790849e2616e4bead5b2002cdbc2435e,56,46,2,196,56,0,01026,1
8873902bfa3a5d647d364eaa0caf1489,53,49,2,185.5,53,0,01027,1
8ded463b262830f03c1515aa583032e8,51,51,1,357,51,0,01027,1
5a4d9f6de9bf3a2b36e1e6eadb4cc41e,31,31,1,217,31,0,01026,1
ce904461b398855479d06d82b7114b24,25,25,1,175,25,0,01026,1
aa00cda292ffe065a755cdb4484e59be,182,91,4,318.5,182,0,01013,3
12fabdbefb317132947bfc243860256d,40,32,2,140,24,16,08032,1
cc53610c979531d6fcbccb77ee01e7ce,4,4,1,28,4,0,13930,1
d79eb789330676e4f6bd0ed2631339dd,124,66,4,217,124,0,11040,3
ae52ef189ba6a61c0b2e3d4308140790,13,13,1,91,0,13,02650,1
cef5d2931f6bf349d17de97e952e0199,367,171,4,642.25,214,153,05040,4
207b4762d35fc246d0f2e63642dbacd4,19,19,1,133,0,19,01026,1
eea3598ded224000fe91039602438fca,240,112,4,420,240,0,04060,4
e38d93514e6045b18abfeacbcb9e8532,187,103,4,327.25,152,35,05030,4
14055f006f8b61ea0658a78d3f2f2111,29,29,1,203,0,29,01012,1
9e5658b6a3b0816ee368411ea230a5ad,63,40,2,220.5,24,39,03050,1
ac4b80106dfc065e7e3efc60a5cccfad,1,1,1,7,0,1,11140,1
a8d1e29e21c96b2fc9c7d37eb46df749,29,29,1,203,29,0,05040,1
60b954c79382b401db7b7e4dbaff3a30,95,83,2,332.5,40,55,05100,3
73251b179506d53d62cffc559bab6876,9,8,2,31.5,9,0,11040,1
b27d1efe45f88c232b270a392e72a691,30,25,2,105,30,0,01012,1
c07cd5223fab70b8e25c297623fabe3b,48,47,2,168,48,0,01026,1
057afd80dbf5a63974633274d6226f01,52,41,2,182,52,0,03090,1
d7aba1b0dd0ba7f3544432633ebfcb65,47,32,2,164.5,33,14,05030,1
a13d07ce8d4745a4114944fdfd0c3a5c,238,114,3,555.3333333333334,186,52,04060,4
978ece9e88b6e6216dab1d287c868676,11,10,1,77,11,0,08315,1
2d172507f8f900e4f12499acbfad3188,9,9,1,63,9,0,05100,1
66c5ccff01c15f356b1b4d6e85e7b203,63,63,1,441,63,0,02751,2
06d7eb735ef97ceb3e712114385f727c,223,68,5,312.2,223,0,05040,4
a662049063244c5583d0b7771f2a77f7,16,16,1,112,16,0,13830,1
277ee9288088ee74dd8ae63cdea9147e,296,116,5,414.4,257,39,01027,4
45313561e8168c18e0e3c7e3b0d878a0,62,47,1,434,62,0,04032,2
2940e9e176c1bb521443565021d091f4,31,31,1,217,31,0,05040,1
f803e92386f83d662cbc092b90011cf5,26,25,1,182,0,26,09130,1
c8bd39ba7fd5004dc4067c517a7011aa,35,35,1,245,35,0,01027,1
1c113082a6a4f8fdfed474a698452c0a,32,32,1,224,32,0,01012,1
cf834808144379f6b02e651fc517ba94,78,62,2,273,39,39,10200,2
627abce782576a79233f7d7e05bb822c,115,85,3,268.33333333333337,115,0,01026,3
39883bbe31892f2f5ec1040b03554580,24,24,1,168,24,0,02691,1
15e0dba39e4a4befdc7515e8c215cb9b,294,160,6,343,255,39,08051,4
d9253caf8043fdf0ef61277a99848ffa,16,16,1,112,0,16,05100,1
437563c7e7886b3cc2689645723779bc,33,33,1,231,33,0,01027,1
e08d998ab39568f1927b44f6b3a14ec8,329,158,4,575.75,187,142,10240,4
ec61c2e2e27c3173188e1256e03ffcb5,119,86,2,416.5,30,89,05040,3
c3af1f7fb732abed18a8ff8b965e4df9,47,47,1,329,47,0,08052,1
33588dd4413692492dc314216f8341e3,172,106,3,401.33333333333337,172,0,05040,3
2c602177d7fd3739597794c479ee6110,75,52,4,131.25,58,17,08010,3
f1f9fb0590d083057f0456e33bc34a8e,36,35,2,126,36,0,11080,1
a66699563694d6a35addf616de93fac8,9,9,1,63,9,0,05030,1
073bc48eb2cdaf47387a9ee7492ecd9d,54,40,2,189,54,0,09091,1
5c6bacd959cf294ff799aff953a327bc,38,22,4,66.5,32,6,01016,1
6cea51787ae45e8e65392877c3b29642,100,66,1,700,0,100,04201,3
053a1638b3e11fb894d182ef66939e39,20,20,1,140,0,20,08314,1
a9001eaf99e141eb611569ed354af08d,74,55,2,259,74,0,05041,2
60630d42668688b76f77f6884bed4c0b,474,119,4,829.5,101,373,09111,4
f7403eae0fa07abe9cd80b5adab11898,52,52,1,364,0,52,05040,1
c2688f05c29ebeb224b3464c5ad7569c,30,17,4,52.5,30,0,11040,1
c01141b109e773e91bca2492d30c304d,210,93,3,490,171,39,01012,4
6e170316edc4a250fab1cd78463932e4,191,104,3,445.6666666666667,191,0,09170,3
13b3689ce11c88c8f5d36bc46533176a,9,9,1,63,0,9,12410,1
6cc8a08636fc591a42ba02fa5a5f21df,2,1,2,7,2,0,09010,1
72d55c0897d20089fa4fb1b2938bb9bf,19,19,1,133,19,0,01201,1
e454d87b6c8f915d6a9e8479b94dfa50,38,38,1,266,38,0,08010,1
28b7ba8e56f72e4c086e40eedc1b4ec9,74,34,3,172.66666666666669,74,0,01026,2
11c9688fc69fa98670947871c2dfa49d,286,105,4,500.5,234,52,01013,4
895457eef6cac70cb70941dcaf6ea84c,14,14,1,98,0,14,04020,1
9a95ea0b7a5c86810b8d5d33be0d5232,309,126,6,360.5,261,48,11100,4
af4be4343b3cde8c85f4d653f2b0d270,44,33,1,308,44,0,05040,1
953a0c8fe113cc05708775970591884b,324,149,3,756,324,0,05040,4
ab5e4830c3d54572d2b33f4f5739ea13,359,59,5,502.59999999999997,300,59,01012,4
fed5bc14b7520bfe39250d803db9f3e9,112,71,3,261.33333333333337,55,57,05030,3
4b45796167cc2af9779d51a58b631eea,113,62,1,791,113,0,01012,3
16f064dc906f5e29d19a158ee6a8aca2,156,88,2,546,156,0,05040,3
baa15eccafae695f979dde6e87b76c42,134,48,3,312.6666666666667,134,0,05040,3
ba116dc73f982e035f393f81d991dc5d,378,127,5,529.1999999999999,378,0,05040,4
488d3e3e8981f80b1a5f86069ddd3dd2,22,22,1,154,22,0,05100,1
9701c28a6af04c61c2edd3b3ad0cfcec,60,49,1,420,60,0,09130,2
00bba0548dcff6c684fd956fc0ec7cc4,132,81,3,308,86,46,10040,3
3ba214b095fadc5ce28a3e4a484877f8,175,126,4,306.25,148,27,01012,4
db93fb83664d24ca955c3bef24664b7d,32,32,1,224,0,32,05040,1
c66906c31ac60aeb52562a7841ef5afd,159,120,1,1113,159,0,05041,4
3029aea11cfbf6526264142da8d84219,115,86,1,805,115,0,02650,3
f19877838e1f302e6a711d704ef2e5e6,65,50,3,151.66666666666669,38,27,05030,2
6736b44508077ff28ecc3160ce89f6bd,45,32,2,157.5,45,0,14301,1
1127b5a5c06091b2ca9fc499fc08fbd2,30,29,1,210,30,0,01027,1
9ae045baf9d81cba8e75cb6dea291764,73,69,3,170.33333333333334,46,27,05040,3
cd7bfd51e6da3d10c534524a58d0a4c7,63,54,1,441,0,63,05040,2
772f7e91033ff60964b711fc33032be2,425,143,5,595,253,172,01026,4
24a76878591bd890b7560e3922df2e7c,130,83,3,303.33333333333337,89,41,05040,3
7fa9d215c75f6a4348216a27b6da2c54,109,73,4,190.75,86,23,01027,3
4f78271923cd5fb3506af36db7f3cbec,74,62,2,259,74,0,10140,2
10d2892c4c48d84260dbca3798cbe13e,294,118,6,343,254,40,02690,4
b72a9fa99aba52f32fb1afb0ae366727,119,98,1,833,119,0,09130,3
b43eef5517a0f94b04a0f2b8cbb1c11e,47,25,3,109.66666666666667,47,0,08090,1
76674cdc234b84a9cdfb8f2d390b0fb2,43,43,1,301,43,0,08010,1
10d5b9f1356e439551ffa438c2e4b105,196,109,5,274.4,155,41,04060,4
3310fbef1626ae06d5b2d09cfdce7567,194,105,2,679,19,175,01013,4
56ca66f0e5c34fa4a35f8c90a9fb7606,35,35,1,245,0,35,01026,1
02ddfa2b01c516b6b66924bbed3dad37,107,84,3,249.66666666666669,107,0,01028,3
f24105e2b310996049a22d417c2138f7,176,72,3,410.6666666666667,106,70,01026,3
20428dcc8bc01c02747f3726f0f9fb73,83,67,2,290.5,53,30,05040,3
ca0d66a81aa8bfebc25ec57265401553,89,57,3,207.66666666666669,89,0,01027,3
656a7272d1233fdc4231ace3c0b1e3b8,5,5,1,35,5,0,05040,1
7540d139131817cc34210b85edf0008d,96,69,3,224,96,0,01085,3
ee72bddf182ab808ac8dca56f8709d2f,64,55,2,224,45,19,08032,2
917dd60080003960e1ab75739a58aa74,45,45,1,315,45,0,01026,1
60641705a95acc5fd38c55cb4ee0cb71,31,31,1,217,31,0,01012,1
ee74a5c6f41214c0e8a4fa0277477255,34,34,2,119,34,0,01013,1
54f6712ac6a2d20b1821ec43a6bf1da4,32,32,1,224,32,0,10200,1
099a8dcaa96bd1e37cb33141499992a7,161,68,5,225.4,161,0,10261,3
2cdefe038d726001e45d5a8e45a6e923,229,111,5,320.59999999999997,229,0,01026,4
a35f5087e6ac25bffd79299d8541d8b0,60,27,4,105,60,0,01012,2
570237dd3ff321f5b72012aa8ff569a2,260,157,2,910,260,0,05041,4
2123ce9b1078c85a90788885b5e6993d,163,75,1,1141,163,0,01026,3
bbd1b3a7f7e9dc1a3503e23b5696c6b7,24,24,1,168,24,0,13820,1
56e73244ea79740ce3db54a8384f3dab,34,34,1,238,34,0,09091,1
9681e08f3e8e852ce9b83cabd8edd6ef,203,129,3,473.6666666666667,203,0,10153,4
c4d863e3ccb23ba3504288837f16ba19,211,117,6,246.16666666666669,115,96,05040,4
bcab05228959d876d7324b24a9b46af0,24,24,1,168,0,24,09130,1
0d82a96aed73bda527abeb15cdd9f7d2,126,105,2,441,126,0,01085,3
185636c36a149d0d2b95cbecc4e9f153,33,33,1,231,0,33,01026,1
dc1c7298d48f1dfc7be7a5b7df7718e5,319,115,3,744.3333333333334,259,60,05040,4
a606ccfc7a0e3dcc3ee1e05a0d76610e,31,31,1,217,31,0,09130,1
982110c9e22c37430103b42bfc21e421,79,68,2,276.5,58,21,01026,2
b1546682ccf2a0c41a45dcd02d3748d2,172,82,3,401.33333333333337,172,0,05030,3
b24ddc6dae242248ee0fbab51c2b8d22,272,111,5,380.8,233,39,05041,4
b617e92311e32ff26b0b6ac6af5b745a,56,45,2,196,27,29,08010,1
ba1d4bb5df76327b6d040e5815b773f9,94,54,4,164.5,94,0,09130,3
15ab82fae0ab20d956de4aaa30afc806,1,1,1,7,1,0,11040,1
0ddbb75ec2fed177f034c50c0feab011,59,44,2,206.5,59,0,09010,1
644c8c04ac595ebf5aa5e57179d3cec0,22,22,1,154,22,0,10200,1
9df527b328b122d6c6d698dcf8c85bb0,87,56,4,152.25,63,24,01027,3
e0a1015540dd013f5cc0d46d94975bfd,36,27,2,126,36,0,10080,1
1a07f2f2fd09574998c01cc1537e8128,25,25,1,175,25,0,01026,1
21b8984a16d6a8adc858c937a0ae839e,129,108,3,301,92,37,03050,3
a357f6758e52250f1a11a209ca4cfebc,38,38,1,266,0,38,10028,1
9031d3a69956a3f93d9982f5faab997a,12,12,1,84,12,0,12670,1
7e5f946c8a47ac0b173fd842a57e06c7,43,43,1,301,43,0,10080,1
b78b04ce9e40b021a45f9af7074f523c,34,34,1,238,34,0,04032,1
68f8230fac0c5200bfc867f61e0c9d83,55,48,2,192.5,1,54,11100,1
f6d68e3a2b4c141468885c9e03c6b71d,79,67,3,184.33333333333334,66,13,01026,3
590f35726eff20d6586d08ad0aac3b23,14,14,1,98,14,0,10200,1
8048b844a113a2f3d16a6fd25962f268,109,66,3,254.33333333333334,109,0,05100,3
7945d40a5a7024e82882af787ff823bb,43,43,1,301,43,0,04020,1
19ac058230ebd4926b01bf911f52da0e,84,49,1,588,84,0,02751,2
0175f6e65ef5532fb3d09295ca98af67,88,65,2,308,88,0,05040,3
686b22aa14447b2175884756a03b05ac,235,115,4,411.25,109,126,06120,4
2c0a276d82afe2cbf2a1aa00e82b2bf9,10,10,1,70,10,0,03070,1
a35966745187425c55b49f4b9a57c56a,62,47,2,217,62,0,11100,1
76939a21f3c69c4854b7dcd10917a180,30,22,2,105,30,0,10200,1
3190595136a88655cdd7545ccc566c2b,32,15,3,74.66666666666667,27,5,08090,1
c3641ed4b1238dfe2ba19c6a6cd6c655,266,118,5,372.4,266,0,05030,4
86baae6f7d183b5c06bf860408961ede,33,25,1,231,33,0,10140,1
a3abea716c331ce246e41fb74f058c73,34,34,1,238,34,0,08010,1
130fcf501ecf564ea3d8312e23ce9ebc,326,178,3,760.6666666666667,326,0,05040,4
b99f5e3785b3ad46a0d504932c90b953,117,85,2,409.5,70,47,05040,3
8aacde05cd8ccc6c4a4c75c8a33dd39f,33,33,1,231,0,33,01026,1
5fa81c88f0bc3fc3322b7f69f148c34b,8,8,1,56,8,0,10080,1
aeaa2fa4f6fb8f926ec6247b3f43983e,301,97,4,526.75,301,0,12650,4
4ec5aa1c53dc491ba007104d8121a5de,40,35,2,140,40,0,09130,1
5b6935c5472e0b6bd8dc055586cdd59b,70,52,1,490,0,70,09071,2
32c5e578e75c66614ee0d03ae7b61cd2,42,34,2,147,42,0,05100,1
0b47bdcc2a6dbd880aa86a6dbe6bd802,27,27,1,189,0,27,01201,1
531e2022f6fd98b019084b14e9f83650,51,51,1,357,51,0,01027,1
facac2738ec8f7865f1d574e0145e3f5,47,47,1,329,47,0,05040,1
78eb4b96ff5de276f6ba2da07df3385b,21,21,1,147,21,0,01012,1
38488983c344906ed71ee0664ed3af21,44,44,1,308,44,0,05040,1
af5b111ea6f659e3ca8534aae3ae62e0,424,121,5,593.6,389,35,01026,4
fc2262d24e539815f015459769cabc77,101,75,2,353.5,101,0,05040,3
dd77c8702c2584d25e9713d185d85031,85,64,1,595,85,0,05040,3
a71022243e9621ac68ea57c7866bcbf8,167,126,4,292.25,167,0,05040,4
a640c151193d58531be5ed18e2636015,40,40,1,280,40,0,04020,1
db9b70986abfeb715b00fa391655c136,46,41,2,161,46,0,03050,1
6594b0e031030d78af6a869c405c1794,63,63,1,441,63,0,01026,2
e0f849ed271b00d0cfd3e951fab46de2,138,71,3,322,138,0,11140,3
42e997185b0b494c1899712eac13062f,244,122,3,569.3333333333334,152,92,05040,4
8a35a047a5bd5576c082288d1f7d1300,60,48,2,210,60,0,07131,1
d515e91ca42f8edd1a97392420e0d1fc,41,41,1,287,41,0,05040,1
2155912c8f2f51aabfc4b73fba9b7e40,143,103,3,333.6666666666667,143,0,01085,3
36ae651f6c0e7eb79a495531a532d54b,8,8,1,56,8,0,08010,1
a60035522811577faf2002da30081ce1,31,31,1,217,31,0,04032,1
e362a89f14f45da3168367feae183c98,24,17,3,56,24,0,10140,1
c020a02577bb9c874dccb822c6416e03,15,15,1,105,15,0,04200,1
b4471311fd45a8e9efe33627fdffbba2,85,58,2,297.5,85,0,03070,2
b234da439514239f8b1a3c7fcc693ccb,53,53,1,371,53,0,08031,1
63f9d0e6cbf0b2768cf21ee155a57560,30,30,1,210,30,0,05030,1
c8d8d3189c670c82f70b1ef1c8431830,35,35,1,245,35,0,03070,1
d714d28407e3be62ffaf605e4c22f2fe,35,35,1,245,35,0,05040,1
3b9ca819d39a1cf54dd114e4fa4c7936,323,104,5,452.2,288,35,05100,4
0db9b587cc577b442c5a2175f00dea86,14,14,1,98,0,14,09030,1
406997796ef027e60f0156427364bd4a,22,22,1,154,22,0,03030,1
83cb61ac9f1bbd77e247e676ed53e2d8,43,25,2,150.5,43,0,10240,1
84e208f90e1425dac23871ece30dfab9,268,116,4,469,115,153,05030,4
b3562793f73afa4946315cd1b071ddd2,112,52,3,261.33333333333337,55,57,08313,3
f6510909bd3b1fd211f50d0ce7edb6d9,287,82,3,669.6666666666667,270,17,05040,4
3c9e2cae8b3f80ce699419c5e52267f1,48,48,1,336,48,0,05040,1
44c5d1ec7c9ca507b11b2e1029ddb181,15,15,1,105,15,0,05040,1
49c004628d40d1b2de9b40f2baab2122,149,103,4,260.75,149,0,12670,3
7b2def7db381a8037c00ecbb705fd984,26,26,1,182,0,26,09150,1
99e6f1fc9f7047eb37ea007c0551f779,114,85,3,266,71,43,05040,3
4dd9e79c2a66cf851d15c405ae4afb5d,204,109,5,285.59999999999997,204,0,01026,4
b31400d9acbe7df895aa14dc3bcd5a50,29,29,1,203,29,0,05040,1
3fb680b48437849aa4b50dc663478073,39,39,1,273,39,0,01026,1
c25c1ce1f48043dd9ebbd2f89bb74f4a,99,52,3,231,50,49,12500,3
6331e1418d89ded5dd2a887bb9f06995,26,26,1,182,26,0,01201,1
ffba763e90e79a877dafd5ff6f01159a,16,16,1,112,16,0,05100,1
7a0a4e01435edb8cf190572223129ef5,138,87,3,322,138,0,01027,3
c1d6c609ea238826aa33a0a2987b1cbc,146,110,3,340.6666666666667,106,40,05030,3
b92b514345e53b79d36809daa2f1bd92,42,42,1,294,42,0,01026,1
8e7736dd68e22629172d10ffc8577c80,93,66,3,217,93,0,06100,3
628375736f6f6d0287079b34b5ab2b4f,46,46,1,322,46,0,04020,1
7301199bd0d7cb63afcd04e7c7ecac8f,35,29,1,245,35,0,08230,1
a427a05d69ed17c72a334b0048782bc0,10,10,1,70,0,10,05030,1
9791f63f895e5c85e0ccfa175e7dc6bd,662,144,3,1544.6666666666667,202,460,01012,4
bb2d1ee9eb0ff26bf855c140c6d86306,8,8,1,56,8,0,09111,1
92c084683518ef0c4ce952ea4dde11ba,182,112,2,637,129,53,01026,4
cf3f5393188aa3c67224bb52b209118d,3,3,1,21,3,0,01014,1
74223d4c9edb693d1225ea5d0c3909e8,218,125,5,305.2,201,17,10200,4
fe783718583ea1e2578aadca73bb89af,449,137,4,785.75,407,42,05040,4
bdcac29230b863c2a562db668b3cd7be,86,73,1,602,86,0,08090,3
600ee83c6c8cc751601bec3b45cdacf8,49,35,2,171.5,49,0,11040,1
68205609f8744e7795270aa3278503af,467,140,4,817.25,467,0,06100,4
9f797e96ed0b6e7612c0c7dd8a9edf4d,50,34,4,87.5,33,17,04200,2
1ce7b2f29f6dce61d941795a30a420c4,24,24,1,168,24,0,04020,1
5045894d9b42fb6aa55895d7515063d7,236,100,6,275.33333333333337,217,19,04020,4
7635f820f67875adc534d9cabd890897,107,76,2,374.5,52,55,05040,3
3ce43440f5f9c7e43a2000fe28717a4f,41,41,1,287,41,0,10200,1
0e2f1d7d1c8d3382aebfedfdf7e54090,296,97,3,690.6666666666667,296,0,05040,4
79eb524151124b6f5921ef8e62f34dae,27,26,2,94.5,11,16,04031,1
c9fe05c35eb5b045ae089e25bcdf6398,24,24,1,168,24,0,01012,1
76596a5b8da1628e427ec9dddc64e9c1,8,8,1,56,8,0,01201,1
6616bf11ec0d17586a5ebad9a26251e3,129,63,5,180.6,129,0,01012,3
9cc7f32f07b40053dcc2b197f2c4877d,15,15,1,105,15,0,01085,1
a47bf7d57cad017070af5b69576f946f,267,103,4,467.25,200,67,01012,4
f6d77b10a9b2e4d281af416b8181e64b,289,128,3,674.3333333333334,289,0,05100,4
6be3b2530ff2f349b83a2e578495b34f,12,12,1,84,12,0,01013,1
c4b9ced872ea8929fe41028f30aadb86,28,28,1,196,28,0,01026,1
ed402b929d3ea624132f202d7baf8b9b,45,45,1,315,45,0,08100,1
01a9c296e09abf03734f86e91ef72bc9,329,128,4,575.75,37,292,05040,4
ebc4d77c4613b2e9e1c00a39e1cb7aca,16,16,1,112,0,16,01085,1
bee9c0cfea75b7812e3eb0012ee93d7a,365,148,4,638.75,365,0,05100,4
9375029abfff2d6a74047616f9aeade3,37,37,1,259,37,0,10101,1
8d3d35d7910ec43f772aab3fb699b9ec,1,1,1,7,1,0,13690,1
89df531bd23a32d4cfd7a68f26680d3e,116,87,2,406,62,54,04020,3
77d75c497ffad7c3a6de2609d5e9b989,150,80,1,1050,150,0,11140,3
3ad5f6cf2109a60f05f50ee8dcc42895,126,89,2,441,96,30,05041,3
e2df250d944a97eb92413b16c5b61593,157,78,2,549.5,157,0,05040,3
6c660c8230424f18196da3599c905f46,100,53,1,700,100,0,05040,3
8ab31fb0a9c1189b567aee225b654111,35,35,1,245,35,0,01201,1
036a9a165619648a201d720a3b094e66,10,10,1,70,10,0,12470,1
9ed152c42398a391070a7ff181ff3c4d,103,41,3,240.33333333333334,103,0,04032,3
fc89a74c89009334a9ce7ad715c40183,953,265,5,1334.2,123,830,01026,4
d32509b8a055f43eefca182c9a84a013,265,134,1,1855,265,0,01012,4
328f60bda002456db4a7a0358b468389,28,28,1,196,28,0,01026,1
c56d10b2db37f156a4bfb15e7c30f98d,104,72,3,242.66666666666669,104,0,05100,3
9bf4795b0f357efb19ae704558542b02,36,22,2,126,36,0,10141,1
1d8ba9e160d461c801f9814ef241d37e,78,61,2,273,78,0,09010,2
6373ecce093f916ce931a4ea2bfcfc6f,15,15,1,105,15,0,02690,1
10cb49814fab2bda121bb54f837eb380,47,43,2,164.5,47,0,04032,1
24995fa7ba8995f09c7ce25f267e0933,64,54,3,149.33333333333334,49,15,05030,2
42e42fc0ecfa874bf143f65a8f484769,293,168,5,410.2,246,47,01085,4
dd0e205f96d6f128339ef9eebec5ae78,194,131,3,452.6666666666667,153,41,10153,4
f067fd9da3d9ae55748332d7b89c126e,283,98,4,495.25,283,0,05040,4
a9c0619226aa5930b4e8ea0d972f38ce,119,75,2,416.5,80,39,02620,3
f264368a06171cf2e148d319684a60e3,77,77,1,539,77,0,01026,3
f3aeacacae68ff5eaf6a85095473068c,107,72,3,249.66666666666669,87,20,05041,3
4d8904727b1be8feafed660e944979af,22,18,2,77,22,0,11040,1
d33f65d57ea1188c458ba734588d1d0d,159,64,3,371,159,0,05040,3
d7b901a07f39985c4596e3fb2495a1ae,43,38,2,150.5,43,0,05100,1
b8ceca506513579e56dcdd89f44c8e3a,144,84,3,336,144,0,05030,3
5a2f080f9941e4cec4bb60e3ce27d078,20,14,2,70,20,0,11040,1
34259cfc4d1391b2e5d5c70670df1d4d,63,52,2,220.5,34,29,02751,2
b5eb663c4dc2fede929421f8fb8a0d18,170,77,4,297.5,112,58,11080,3
a9ea431eef658f9d9528d33cd9fb6d82,17,17,1,119,17,0,08051,1
6c2febee9e1111b1f559abc9a5215e66,64,39,2,224,64,0,04060,1
b9e4f5a642836c5273e3d2509020b017,53,53,1,371,53,0,01026,1
abfc942c0e97a49d52723d965aa044e3,81,62,2,283.5,81,0,01085,2
e6417ed9e1c594ec56bce7fd4c1e12fb,84,67,2,294,84,0,12410,2
be2ee30aed33ab9957d301c7d7d2050d,99,85,3,231,73,26,05040,3
a9b9951f21db48d98d27a7354690179a,3,3,1,21,3,0,13930,1
81620cfbf7d334d835a1071bb296dde0,154,94,3,359.33333333333337,154,0,05040,3
a7f8e105e824fef43fcba0f7810096d1,48,48,1,336,48,0,05040,1
166b23e405ed093b0392c0ab80f4e505,153,83,3,357,153,0,05040,3
399d3f6b79db713812d0274a176fdb17,187,92,3,436.33333333333337,187,0,05100,3
8d87632136bdde4f3e962c4c7e8eff75,153,80,2,535.5,21,132,11100,3
ecbe702e0c30993aa532dd5880fe2774,37,37,1,259,37,0,01026,1
992b5848ba6afac56a9dad40698400f8,238,145,4,416.5,238,0,05040,4
4a3509fcb96e5b5e2ab37aeee54fe9fc,15,15,1,105,15,0,09090,1
721546b4416eaef783ae88151b33cf7a,26,26,1,182,26,0,04020,1
a2be06d1a63bf666c4404b90024c352e,11,11,1,77,11,0,01026,1
5abe7bbfc86d906549edc73f3d21f2d9,83,57,1,581,83,0,10200,2
2d254b8f059f3792199ebce8e2130398,626,126,3,1460.6666666666667,626,0,01026,4
c341b66666b600a5755a22f59e1ca6a6,65,14,4,113.75,32,33,12650,2
ba44879d1375d18eef1c9ac5ef9d7c74,75,45,3,175,48,27,01012,2
6dab2f952e1f74a7242247dae884c967,97,93,2,339.5,42,55,08052,3
db23259a65e765dfe2b0024a24ba6775,37,37,1,259,0,37,05041,1
630273531d5f3380d46fe59857ff2b93,116,70,2,406,116,0,01026,3
a1cb8308a0517e200a6757ce74cc331d,283,116,6,330.1666666666667,236,47,01026,4
9157778c651df0b8895574d2698528e0,22,22,1,154,22,0,03050,1
8a9c2da62f25563ee4be09b4cc3c718a,33,29,1,231,33,0,11100,1
727155295b0bfca40ecef5f900d153ba,79,45,2,276.5,39,40,03070,2
3dd164c342646a87df6ffb31812d8aad,267,170,5,373.8,216,51,08052,4
1e697135a7e5571a4fdc234f275709e8,45,45,1,315,45,0,05040,1
ef72071d07f35943001dba85e68ec073,16,15,2,56,16,0,01027,1
2ec71b4a5ef7b5c3b2b2641bdae35e7c,62,41,3,144.66666666666669,62,0,07122,2
f15b6c97999e13c82db659bce671c993,159,97,4,278.25,133,26,05040,3
9334dc302235f83b6426247044cce625,107,68,3,249.66666666666669,107,0,05030,3
24795a87589e18dd90741a2c4ceb8fb8,74,43,2,259,20,54,05040,2
31952aaa2d15e49139b46a056e5dba27,27,27,1,189,27,0,10220,1
93356b631c1c4833be14d368d5870ebf,307,155,4,537.25,217,90,05100,4
a13555a73889b291aeae0f0e206face0,66,66,1,462,66,0,12590,2
754e559f6f3326d68b7fc78d17cb0cd7,97,45,2,339.5,97,0,05040,2
48925d6e1bb4d1ad5bd10f45e56c91e4,175,109,3,408.33333333333337,160,15,05041,3
5ebb5063b63afe7b0b47ce7dfce13a70,5,5,2,17.5,1,4,05030,1
f808649d2e406e12c9a3223b5bc9d6cd,42,42,1,294,0,42,05030,1
b180642806ab43778adab233e9f00c84,3,3,1,21,3,0,11140,1
055bce272d000df55c6906adb15608c7,87,41,4,152.25,87,0,09130,3
0d531a8ba8668d9b69d0ddfa7e9cca30,63,40,3,147,63,0,05030,2
94737af12f279d865c5e0ff726af874f,21,21,1,147,21,0,05100,1
a4aa7816d437b4c89f3992ecc86dff15,121,76,3,282.33333333333337,79,42,01012,3
098b5d4b06b0f5a79e88a4a39c103f70,29,29,2,101.5,29,0,01027,1
2ed0ace39de3e0fd12f05ad03bbeb468,15,15,1,105,0,15,10200,1
a847ca6871c20a789e08dc96aae77962,189,124,3,441,142,47,05040,4
654599e58f3671e71c862fbbc98ac1c4,104,60,2,364,104,0,01013,3
cefdaff028765b91c42324353f3fa412,28,28,1,196,28,0,10220,1
11b97ce38ee8e6c8866da0d1130c5355,126,93,3,294,126,0,02650,3
3c05d4c5e334443d98d16cb79390f709,482,168,4,843.5,253,229,01085,4
dbfdf16670c084a25641d7f7881df014,117,51,5,163.79999999999998,117,0,01027,3
f9d86e1a551d589d723f303d7ca03c48,91,52,3,212.33333333333334,49,42,01012,3
311d19360b8fb2887464d3dcbe1d81d5,8,7,2,28,8,0,09130,1
7d231c32fd0800b48efbaef5ca90a48f,70,56,2,245,70,0,01012,2
49cf3732a3a8924849a5d10041f03dc6,16,16,1,112,16,0,02691,1
fa08688d67f9c73a99d75ba7b4086998,322,213,5,450.8,279,43,01026,4
e0b89a1af186a17aa316b3d7f2b24efe,59,45,2,206.5,59,0,08150,1
4db93c9524fe1f6de9b4b8327497915e,15,15,1,105,15,0,01017,1
a1565cfbbdfedd2ce605a021df16143f,62,62,1,434,62,0,09130,2
0c5eb4830d62cc9c33b7639c8963d1c8,265,136,4,463.75,162,103,05040,4
c859730c9e5869caf0b6082c4a523d3b,24,24,1,168,24,0,01027,1
8e2614aabfe95c51719e03d7b8badf81,124,85,4,217,79,45,03070,3
5012682c8078b7f77ec907c3d58a444e,57,57,1,399,0,57,03050,2
a7cf6d6bfd5eb34ed7c778e2df7294bb,126,94,4,220.5,88,38,01012,3
cf403d6a0d0791fa845bdf48215e9d2a,16,16,1,112,16,0,09130,1
c3192206e68690c038543cccf06de0c6,46,46,1,322,46,0,01026,1
b99a6e0014ec1f498073baf76211fb8d,26,26,1,182,26,0,12500,1
bb12b9448413c378a6e37feebd7f8489,43,43,1,301,43,0,05040,1
b75c4740345b7fc20228d688dd523382,81,81,1,567,81,0,04060,3
be3a59384c88b2e02d90ab23d1de76f2,11,11,1,77,11,0,05040,1
1bff036a438b57167457b481d4e16d20,69,58,3,161,69,0,01027,2
dd72e9f3f11e3644c43c51078a263bc0,235,142,2,822.5,235,0,10200,4
d5c73890a2c7210a99b912fb6dd89d9e,12,12,1,84,12,0,09130,1
5ef582d501638bae9e062fa55b511243,617,174,4,1079.75,392,225,05040,4
97382497bade25848d91f5647282ca21,115,60,2,402.5,32,83,05040,3
81ef8a4a82a38c5309e9355baa2bfa5e,4,4,1,28,4,0,10080,1
0b6b7e7c52d4f2fa8d0976c5ac1759c8,38,35,2,133,38,0,11080,1
7d3d613a9e3d79b66274f69f14ce5635,29,29,1,203,29,0,01012,1
08739f2fad98140d3251f350cb634671,19,19,1,133,19,0,11140,1
130b7761b4e6bbec08bb8109e9fded94,39,39,1,273,39,0,01027,1
95e48788d338627af43e0903d0fa79e0,122,64,4,213.5,122,0,01026,3
b6e17610efb7edc9dacc715c708c4c6f,11,11,1,77,11,0,05100,1
a1c6e6054aeb107e9cbd4be0021b99b3,62,62,1,434,62,0,09030,2
885be4e22f45dd063c9001e2aa018cb5,10,10,1,70,10,0,05030,1
a074d7e1ae9c26ee0bfdaa13767ec28b,64,44,3,149.33333333333334,64,0,04080,2
3bf4349ea66dc7ba02e538ead06117ab,43,43,1,301,0,43,01012,1
f3fab2dcf72750df66386bccd199f052,13,13,1,91,13,0,01085,1
5d30e8ab5b130b786c8385755c411f0c,161,75,5,225.4,125,36,11100,3
25525eb7d8d875c35cd056a7dbaede2f,41,41,1,287,41,0,01026,1
e65eafc0210cbc770cfd114222d25e62,177,111,3,413,177,0,01026,3
4ac99a24d9e8b2c9b8e2f1260dfa83c1,94,53,3,219.33333333333334,94,0,10080,3
97f18f788ffbb6d35a6e44362ef7ba81,14,14,1,98,14,0,01013,1
1045e7df04eb388279670ad5d3fdb2bb,45,44,2,157.5,45,0,05040,1
bd23506d224215caa2a7c1db8c1aa213,186,130,4,325.5,101,85,05100,4
7073084e6727843d3c13bdc80cc2395a,183,91,4,320.25,183,0,01012,3
d244729dfbb7f5791f6e7480a0ec383f,32,32,1,224,32,0,04032,1
80b492e20e351f53dde9f6133efde9ca,44,44,1,308,44,0,01016,1
227d0af4204821170fa014a3e131e6ca,71,37,2,248.5,47,24,12670,2
6f4718c0ac607d8eb9c650c99619df6b,28,28,1,196,28,0,01027,1
2a08b691bdde14f5a7b0f86731724ec4,18,18,1,126,18,0,04020,1
56e2bd9df2cd73a6c3535bc22cbee9dc,22,21,2,77,22,0,11100,1
9943d18f1ce67e93a1d78375a16e9788,342,103,5,478.8,342,0,05040,4
718ace5ee0c65edd29c0be17ff03ddfe,34,34,1,238,34,0,05030,1
8e188e395be835a716b7aa3063d5a3b7,62,41,3,144.66666666666669,48,14,10240,2
c668fd826e14e9c090ea790887b5dbb9,31,31,1,217,31,0,12500,1
6cd5d21f06364591c093da0d4da24d47,52,44,3,121.33333333333334,34,18,06100,2
8d26e959d3d8a2b2ed450c07aa14279e,41,34,2,143.5,41,0,05040,1
42c751aaff63c099a43d61e00a4fe610,12,12,1,84,12,0,08051,1
afd17523b7427a6f71d7b5b795c7b2de,15,15,1,105,15,0,10200,1
d9b23e1f46782162bed27226535d31de,22,22,1,154,0,22,09130,1
009c3f4f114e5150ef8d8663670df60a,184,120,3,429.33333333333337,145,39,05040,4
bbdb9574a7f9c1f8591376bdda4e8732,132,89,2,462,69,63,08010,3
f73c3b2692156a0134629c3bea29cdcc,12,12,1,84,12,0,01012,1
c24ef2dca35e66d2bc0c2d95c15fb7db,47,47,1,329,47,0,01026,1
64eadbc0f1fa876e53cb3ab2173b0698,78,62,2,273,78,0,11100,2
9f0ad0fc100db52ca56a10aa9d3f9c61,420,116,5,588,420,0,10028,4
a74bf8790bb815b9cd94b4323881f892,32,32,1,224,0,32,02620,1
cda0ea9ef08058c36d6f99370bff4357,82,69,2,287,82,0,09130,2
a73db77875544b372e9e6f409c0e0099,20,20,1,140,20,0,10200,1
5c5d0d37d0a84c3450f16ce3f203c1ac,33,33,1,231,33,0,10240,1
5568287398bcfaa2b3abe1defdf28792,9,8,2,31.5,5,4,11040,1
da0735073894c9e6655fbde3e8324cee,42,42,1,294,42,0,01012,1
60c5a604bbc3993720d20c451da303f9,25,25,1,175,25,0,08134,1
b61aa9baa1fa98a997c64aecf8b7699f,250,131,3,583.3333333333334,45,205,06120,4
a3ae7186da6406dd8cab553c356f079d,149,107,3,347.6666666666667,126,23,01012,3
fa976ba3ed27db19d997efc33fbd3448,93,69,3,217,93,0,05040,3
e42f8a931e9466aaaa2d65707f6c1bb2,19,19,1,133,19,0,10220,1
a10d2237d380168e64b7744af09dfbe3,131,52,3,305.6666666666667,131,0,10220,3
bd331e950158d90bbb7750cf0ba62282,17,17,1,119,17,0,01012,1
982a01c70ff9e32d00bd4fceb484e7c5,75,69,2,262.5,75,0,09091,2
bb1d6d2dd052029d221878e1b7f0d0db,43,43,1,301,43,0,05030,1
fbced8cb4cf2395aa9dca7de6b80bac9,138,111,1,966,138,0,11100,3
5fc54b43e9b7b001967b7697f5bcb95a,19,13,3,44.333333333333336,19,0,14251,1
e551c7c26fadae94a9305a806220486f,50,43,1,350,50,0,03050,1
c4a398285ee0bc69f990aec4482bec7b,10,10,1,70,10,0,11040,1
a0966f0000bac16776b64779ff17d786,49,38,2,171.5,49,0,09130,1
27c0c373e7cdfd773e5ae439fae6ce7c,50,36,1,350,50,0,09091,1
892178997bb2938102c0d8713ef696d9,18,18,1,126,18,0,09150,1
a14e6bc5691c8a1917217db877f5d58a,44,44,1,308,44,0,05040,1
b6705122eef573056023c1d442b2ba49,187,90,3,436.33333333333337,187,0,05040,3
d30f20c7d8d014860b459924c9811c04,58,33,3,135.33333333333334,58,0,09111,1
162b1dc3534c3a342822f0c126117f47,9,8,2,31.5,9,0,11040,1
5027ae823588fa8588046245e4edbbe6,34,34,1,238,0,34,01026,1
353bcc85b8d2753104f393458fef09b6,32,32,1,224,0,32,01026,1
8bff3e665c6a478fc1a05c28ac2e9ee6,100,55,5,140,79,21,01026,3
6bf11697d527dbd7ddadb0d80a839b6a,63,46,3,147,48,15,05040,2
a6e47e4d2e993c2ae747c4137a07fea3,242,132,4,423.5,126,116,02691,4
30f97431fa13016a607abd265e88268f,4,3,1,28,4,0,11080,1
3579d3fadf11ea380c174be2d32a3b20,231,126,4,404.25,231,0,10200,4
f46d567845274b065e869cb96a43a2dd,20,17,1,140,0,20,05030,1
bb992a9552c92e63e4a50176d18d7d2c,96,72,2,336,96,0,11100,3
54f76141cfa2b3005b7f54542bee0083,40,39,2,140,40,0,10200,1
f90081cba33133f04c79ade72c84c041,73,64,1,511,73,0,10220,2
32dc471a978bbfa6faf556bb1968ab61,2,2,1,14,2,0,10080,1
1f74be3ba788fde150e064bb33075405,82,72,2,287,82,0,01026,3
15ee2cfa84042e329985ce95d1b15a49,144,91,2,504,98,46,05040,3
b9c5b260a0d644b52befd13f9ae768a1,164,108,4,287,136,28,01026,3
f5c1891d5485ce35fdff6260f1f410dc,26,26,1,182,0,26,01012,1
c4dbdba6ee41ea7e01cd4217044bd88b,28,27,2,98,28,0,08150,1
2788a207befbd77bbd5fc18c5fa36b48,210,99,2,735,210,0,01026,4
7ddb2e1b89f93bd50cb490aaf63ba3ab,129,89,2,451.5,129,0,03050,3
557ba500deb9f7d6a57b86abb8807da5,293,113,4,512.75,293,0,01012,4
815a627118863660ac9ec17831bcdb7b,15,15,1,105,15,0,10200,1
637a2632df361c09968a4f966bdf91d9,68,50,2,238,22,46,05041,2
886bfa25067a47c37a90bc2f1934a6bd,51,28,2,178.5,51,0,05040,1
f7e7e1fe15e81551b3a01e3334a78a29,341,100,4,596.75,341,0,05100,4
ba641985c9329b93397253ff91e21a6a,90,90,1,630,90,0,05040,3
5805d881371473e0db6f070a772883b6,86,64,2,301,86,0,03050,2
f504935aa50f4b69e5639ede80267273,75,42,2,262.5,41,34,09130,2
a778ca5112ee1f080da14c53d8cac6c2,2,2,1,14,0,2,05030,1
f8f13d343b82e03b607ab4fa39135147,25,16,4,43.75,25,0,11040,1
4f7226a7fc9091db133ba9ab34dfed05,79,74,1,553,79,0,05040,3
d8b99164b7bef02cf9d14a41314c08fa,85,58,3,198.33333333333334,70,15,08051,3
5d9f49e3d0c616702479028e54d8ad95,27,27,1,189,27,0,05030,1
51dcede7faf14413acf2b9597cbce58b,245,108,3,571.6666666666667,245,0,10240,4
7b116916ef8261762355a77f448f09e5,82,66,2,287,82,0,05040,2
671c95c9a33ecfce8bda71596160b327,55,43,2,192.5,55,0,05030,1
5579a129dd48c677ac690d7723bc5618,31,31,1,217,0,31,01013,1
808d30658ccac3e6ff4a9bb4d3debce8,53,34,3,123.66666666666667,53,0,01201,1
4c4ad317638616ba393c62af67794728,153,79,3,357,113,40,11100,3
f5fe46734ada3e4bc59ac8371c1c53fd,92,75,2,322,38,54,04020,3
01f48b5d7a3d04f71683f6cfa6a2631e,24,24,1,168,0,24,05041,1
2c6a839c6423f2b91c7e24a9797e05b7,28,28,1,196,0,28,04020,1
bbbacd1900bf6d0cd235d4358451714c,218,84,4,381.5,168,50,05040,4
b7fc223f527f9acf4ebfe7e6ae0ebd08,84,67,2,294,84,0,01027,2
bc450410e8c2a6d7994d5f5e77602453,43,43,1,301,43,0,01027,1
cbfe1470d49d0724bd7ef1fb182166cb,49,49,1,343,49,0,05040,1
c895101e281edc26e6615a668e2a8407,33,33,1,231,0,33,05040,1
5ca36ff2615960edff08e9ec41bcce7a,9,5,2,31.5,9,0,11080,1
267f3a79efc26c7e6219cbb48e9d005f,114,66,3,266,114,0,05040,3
241bd1a831833dce559dcc78907ab181,27,27,1,189,27,0,01027,1
364ea296a40bb46c8f137991d9255142,52,47,3,121.33333333333334,52,0,05030,2
9a2463a19c536b71c7051df79e039f03,20,20,1,140,0,20,05100,1
d9e5f99a701b611e1439046451f7e42c,66,37,2,231,66,0,10028,1
eac620bcc0666a3b9b2c66d2b6d4266a,39,39,1,273,39,0,09130,1
68915ab308a5f9b2f7e04bb5189ffa56,61,44,3,142.33333333333334,46,15,05030,2
9df4b0292132b1dc11b779f2f299a5e4,148,93,3,345.33333333333337,78,70,05040,3
9fa05208e201728bd5e85e8478538a75,56,56,1,392,56,0,11100,2
f18d286f03442a15cf2e789b877bfd9d,51,36,2,178.5,24,27,05030,1
5769e1f847bc78eb72b3caad5a2aee00,19,19,1,133,19,0,01012,1
6fc6349c26fae249a73d86abc554e55d,77,67,1,539,77,0,10200,2
acb3d0106497141c2044e66176a114d3,47,47,1,329,47,0,05100,1
165f036a8107ab8525b29d662fa436e3,228,107,5,319.2,164,64,01012,4
afd605ab0bc28c6f36b1bcae7a9e6bb8,59,50,2,206.5,59,0,04201,1
e0643c9018e7a40dba2d66496d58bf0f,273,97,3,637,273,0,05030,4
c37b81b5d7f7c3b06575fb5693244d04,177,104,3,413,126,51,05030,3
e4f24e579d0946942381a002fbdc5c16,71,41,2,248.5,71,0,08230,2
8a68a66e6f4ff3bd4cd1c4c18333f499,22,22,1,154,22,0,12500,1
20b12d0e47f26389856da125e408eaf2,128,74,5,179.2,128,0,11080,3
4eb2fb7bfd424e83be37987eddc7d96f,133,102,5,186.2,133,0,05040,3
5d864c4066ac4078a026c6211007a18c,105,83,3,245,105,0,05040,3
147016851f4d557d0bed92f4eafe19e8,30,23,3,70,29,1,11080,1
63254ecd2d8afe186f4417c18de30364,29,29,1,203,29,0,01012,1
54bbdb24316b4288540a2c1b37492507,263,95,5,368.2,224,39,05040,4
cea09f146647332b32cbfd0a0b423d5f,75,39,3,175,51,24,05030,2
682bebb41d87d6cd7acf1ae05ca2f6c1,68,42,5,95.2,50,18,11040,3
aa4a797c10220ff40e7bd2a26c652db4,32,32,1,224,32,0,01026,1
bd331071c0d95ffa4d0f36678582827c,23,23,1,161,0,23,05100,1
ab8412c0710e561858494ba09903763d,47,47,1,329,47,0,01012,1
941d4be8d7cd6c7a190b6b78845b758d,41,33,1,287,41,0,11040,1
6d87b662e2ff2dc19610219134d51930,67,63,2,234.5,13,54,08051,2
b95d77a36696efdef1afb7f0d5f3d9af,103,59,3,240.33333333333334,63,40,05040,3
d5ca2c545ce435580b58bce08f378912,46,46,1,322,46,0,13830,1
c09063ba44514598cfa95a7ebc388d65,39,39,1,273,39,0,02650,1
0b935dee99efc1cba5829c738c79bbc5,18,18,1,126,18,0,01013,1
eabb5626b65bcdb82ee6af78b4045385,27,27,1,189,27,0,05040,1
020fe3c0b8eded2d501a3f727a948dc8,17,17,1,119,17,0,01012,1
ebec9bb758d410499fee752f988c4f74,27,27,1,189,27,0,09090,1
4f58c83c254309e9f6b33e405191efe5,9,9,1,63,9,0,04032,1
d68ad444ba99da2b9f6a877cb61bbbf0,57,22,2,199.5,57,0,11100,1
6a50bddc79d7673f40c49dda67353406,12,12,1,84,12,0,13930,1
fb23193daf018d77d393b9e4ae91da2c,48,48,1,336,48,0,08032,1
4c31b214a1c11c1b5854002cf5405c23,42,42,1,294,42,0,10240,1
9d0e1425be519537b459320ede98cf7b,15,15,1,105,15,0,12570,1
e9d73a241f78536ef11c6af512f6b587,117,85,4,204.75,74,43,01026,3
b202d97b2f6e73facb0eee05077e2a4b,162,117,2,567,162,0,04060,3
7a463c1a53b75b7fafb27ed485fb5051,71,71,1,497,71,0,05040,2
91d979fc876ab23a257b1dfde1f2ac74,51,43,2,178.5,29,22,08230,1
13a20b0a9152bb0add6d4c7b6acae6ae,80,49,2,280,80,0,11100,2
47f921315b9a57f63c27f9c6d66caaef,101,61,3,235.66666666666669,83,18,10240,3
a28e2a133c336ce06ac4adfd90606236,215,125,2,752.5,215,0,09130,4
1a7024618fd002848728374c432ba82e,142,78,3,331.33333333333337,104,38,01026,3
9b5af71e13206c240153af6d7eb813b1,192,124,3,448,130,62,01026,4
ac4d9783b8e644aeba43c6df03e31510,68,68,1,476,0,68,01026,2
228ddb31b75e5aed455a7a2f8c31ed32,414,139,6,483,322,92,05040,4
c2f6b1989aca29bf40b248ba0f987860,20,14,2,70,20,0,05030,1
bf8784b33da839247c4a810cce623a35,11,11,1,77,0,11,11080,1
c1ddd6cf5b33e913b6f8ca38f92c0108,23,23,1,161,23,0,05040,1
796a4279e2f710bb7dd0dbe3c637ae8b,211,71,3,492.33333333333337,183,28,01026,3
f1ccdf2d90a3aa86a1349a3c67d8837f,112,77,3,261.33333333333337,112,0,02691,3
7e88729a675dc54ef792df2d7776c3eb,173,97,4,302.75,172,1,05040,3
639dc0c58a8b527c329de626aa6cdca4,171,113,2,598.5,171,0,05040,3
8abd8608976105a6044feb0fd5feea82,35,35,1,245,35,0,01012,1
54d386a2571b61d237059ec2324250d6,25,25,1,175,25,0,01026,1
2c6a2ee04fa9aa98d0ff84d758464ca9,65,44,2,227.5,65,0,09150,1
f8045c24189d4f00a586e7628fc900ed,14,14,1,98,14,0,01012,1
c50f4b98f42d6642f4791e26c4e8c758,40,30,1,280,40,0,01026,1
b70b40aa345933cb8baaf520e9a14b9e,111,81,2,388.5,111,0,01201,3
3c150146c6b4825a57587af035741c62,3,3,1,21,3,0,10200,1
6d6b86f005af1a7956bea51ee4ec6bea,135,93,2,472.5,135,0,13953,3
b10bfbbd9efe0aefd58b106134325fcd,115,66,2,402.5,115,0,01201,3
9ea76a5a431bfd0069dc3d1ddbb926d6,53,42,1,371,0,53,05040,1
fc39c76472896d5e2b484fd0f3464ea9,101,71,3,235.66666666666669,101,0,11140,3
d0ce56b96d40dcf88c3fc43ac3bbeec6,190,72,4,332.5,157,33,10200,3
e5344004c2e846b1b8a681faeae75f34,113,78,2,395.5,113,0,05040,3
c131d88e526181bb97a518dd362b3ac1,155,142,2,542.5,155,0,03090,3
0a9834cb67374cc7ccf0916aac3271f9,38,38,1,266,38,0,04080,1
e24787a19d7fbb512ebf2e1fb4902b7a,104,93,1,728,104,0,01026,3
28800adfec572876331e419ab30da6cb,103,66,1,721,103,0,05040,3
ad8aaa179b8b7e3157de267d5a495434,110,81,2,385,110,0,05030,3
b74fa2a1383bcec9e3678980fd5f56e6,14,14,1,98,0,14,08031,1
8f9ed813a5512a63e5419cafa32a41dc,169,93,4,295.75,169,0,08032,3
0853379cc25b95f626e1b6cbbaf151db,315,98,5,441,287,28,01026,4
7fac86cc3a73361492756181dddb7e3a,53,53,1,371,53,0,03050,1
d205c8703a5e7810a3fb6d7f19a331e3,334,141,2,1169,1,333,04020,4
16e9adc725fbc0565a7142674c7b5941,76,70,2,266,76,0,10200,2
646cec43a969f6f6ebf22174092ac21b,41,37,2,143.5,22,19,13820,1
f1396e528bb0eeada0c695dbd69bf924,63,63,1,441,63,0,01026,2
2b3ffd0bd51afdd416c44e23c014fc7b,165,134,2,577.5,0,165,01027,4
7a02d8dcd2efa1cbb560453ae4f0e11d,95,62,2,332.5,95,0,01085,3
42c607559b94482c07a178837a91f00b,68,43,4,119,35,33,11140,2
9d14d36aed0d765d2a30765f712b9922,22,22,1,154,22,0,05040,1
98b32db9582aa151cce6b73951e24a68,75,61,2,262.5,75,0,10220,2
f39cb4e37ce23aa280780d4a2fe383ef,54,42,2,189,19,35,08100,1
3a15e10e64e3a145bc30c062d6a815bc,112,89,3,261.33333333333337,112,0,01026,3
bceb8ac7938a881377802154d62dce8f,107,71,3,249.66666666666669,57,50,04020,3
00f8d8c877b797e53ea8de4888c8a0f0,4,4,1,28,4,0,10080,1
8e8315ed119c1382c4d351bbb188510e,229,85,4,400.75,208,21,05040,4
b7c048a5dd53e1c232f979df95e62e60,16,16,1,112,16,0,05040,1
54546f5ef294bd99d22b1b60a02d2538,109,86,3,254.33333333333334,61,48,01027,3
7079840972472906e37800750777a246,352,109,3,821.3333333333334,352,0,01012,4
62f74ea33363147d7dc96414662b3de1,96,73,2,336,43,53,01085,3
2445d9ff8f6b9c0a39bc1198738a7a3d,170,96,4,297.5,170,0,05040,3
f7134c03d9c98714dce40146e5a805dd,44,44,1,308,44,0,10028,1
61271ac964c4a3146f3acce0dc95bf5b,185,76,3,431.6666666666667,185,0,01012,3
457b36c06b1d57de3f09bbb5e291682a,95,56,2,332.5,33,62,05040,3
325b7ec0d2918afe2fd34129706f1fe4,39,39,1,273,39,0,10200,1
65a685fdcf9ac324e8b9405d3b37b263,177,97,2,619.5,158,19,01013,3
bcbb8c41c87442a45d5a493310d4bcde,16,11,2,56,16,0,10200,1
484e1711d72fc6c1de00e8dd1cdcc2ff,31,28,2,108.5,31,0,10080,1
277e7a707f93b1d2eb8404092ba079c2,1,1,1,7,1,0,11040,1
e00ee482007dcb4aa393bd97804de13a,276,164,5,386.4,240,36,04020,4
2160a8109f284962a57eae0e2b67ed30,463,164,5,648.1999999999999,463,0,05040,4
07868c11dde8c6c4957e6f27e38173da,68,62,2,238,68,0,01026,2
5d6318a9a982956fa287f6066e9580c3,60,49,1,420,60,0,05030,2
802bf16f7bb99637391f279a0041f080,107,69,3,249.66666666666669,70,37,05040,3
7979240b1eead332f79c67ac10bc100c,22,22,1,154,22,0,02691,1
149cf555edc6888f01e1d5e54d30eea7,175,105,4,306.25,130,45,05041,3
76d9a0bb4a2bef8937bbef3529f962da,80,43,4,140,80,0,04031,2
e73c418c8d8d1a4a527c616c078f6092,208,105,3,485.33333333333337,208,0,01085,4
f17567b02d4322457416255a868e8f98,94,19,4,164.5,94,0,12430,2
6b990b8e929dee1dfa02808a1ae465ff,187,81,3,436.33333333333337,96,91,05040,3
e0f3ab538e94006f7f461d4319b5445b,46,46,1,322,46,0,09130,1
c0d129d2fe5f5da052d82f6358cf95c6,34,34,1,238,34,0,01013,1
90a6d62bd0f79d2e28880b7f58d76f33,448,171,5,627.1999999999999,300,148,05030,4
e8dc5140459aea18a9fbe6907de6f9d0,50,28,3,116.66666666666667,33,17,08090,1
1cc3af2c9d39d0d9527610bfc61cfd36,149,80,3,347.6666666666667,149,0,04060,3
0e1adb05d947bf5ee444ecff4049918e,124,60,2,434,124,0,08100,3
fa762596679d1bfe60fffd7a8c2fdaa1,9,9,1,63,9,0,08090,1
5497973ecfe3643387f8de3be8c9dd37,40,37,2,140,17,23,03070,1
1385d56f76a4a7e947763b95c29d9fff,52,41,3,121.33333333333334,52,0,05040,1
a686370bf82add52161a12c2f07b971a,47,47,1,329,47,0,09130,1
c7ed3741a7e65968f9129d2c291affc8,13,13,1,91,13,0,05030,1
078726bbba365ad5d161894e89d54d23,23,23,1,161,23,0,03070,1
6142045d6e4d03f72229c0fe3ea0310f,122,74,3,284.6666666666667,91,31,05040,3
9e06b0d93947828d94aae723f2c4eaae,90,76,2,315,90,0,04060,3
e9bdb12036698f8738c79e89961aeef5,197,125,2,689.5,197,0,05040,4
c160ee2df9644261dc5ca09a0b2b1329,168,85,1,1176,168,0,11040,4
9282c521405e0c85480717d5fff28055,175,97,2,612.5,175,0,05040,3
09914302682243b6d83f2d5d9a9c7960,44,43,2,154,19,25,01013,1
500eb248d3de7dc3a50ef9364aaecdca,122,82,3,284.6666666666667,94,28,01012,3
9c707fef5bbce215bc68f77f45442729,23,23,1,161,23,0,02650,1
94a5a963988dd26ad3adf10519cf4186,79,53,2,276.5,79,0,12670,2
c94e29cda601d17e14ada0d8f98a76cf,441,167,5,617.4,316,125,01013,4
dd966c4d68b46e01bb58d80e470e9309,37,36,2,129.5,2,35,09130,1
17349b215fb9be1c0701da1c5829c5f7,107,89,2,374.5,107,0,10200,3
f576a4538ea05cf8e83181990a9448b5,214,116,3,499.33333333333337,214,0,03090,4
b0b85496790182e6c8deb6cb22496bce,42,40,1,294,0,42,01026,1
d579273fa793a72c23a1cd9b17c44b84,23,23,1,161,23,0,09130,1
32c1e11464325a2f60f3957f8fcfe34e,180,90,3,420,117,63,01012,3
44bfe30608868472df3b90ed64232894,14,10,2,49,11,3,05030,1
63099733d2e3becf376e30bd155da7bc,18,18,1,126,18,0,01013,1
13ee29656ff50546c57fab8574198865,500,142,5,700,500,0,10200,4
3f9a500d061df14f29acf62a75d407f9,23,23,1,161,23,0,01085,1
d9898648ef51de9013bc20047a75e6f1,106,78,3,247.33333333333334,106,0,05040,3
59868fd651966da70491bfb64929163e,10,10,1,70,10,0,13490,1
0830067c19aced26403f5353489192e3,24,20,1,168,24,0,11080,1
8214414ecb498e6ae3d098e53e96328a,50,50,1,350,50,0,09130,1
b1864c1bb8308c4a478429574c4eeea1,58,50,1,406,58,0,01026,1
ec60f9a26b907e2b3aad2e47a923c512,59,48,2,206.5,59,0,10140,1
c652360de93a419e64bfc9690fdf9309,42,42,1,294,42,0,09030,1
b73f6621ae9935d4aa9be387a3fe6e2a,22,22,1,154,22,0,01012,1
e31b67e68d7a5442452ad80971ea107c,37,37,1,259,0,37,10200,1
3ad59768e3889a323b99cdd0e0cdc000,31,31,1,217,31,0,08100,1
6956ac9daefeb3711a7275a98e230527,25,25,1,175,25,0,05041,1
bcdfb3a7bd53e8a0d758a5c2a48fdfab,36,35,1,252,0,36,01016,1
696a670be753fa5842e0784eb83bb9dc,45,45,1,315,45,0,09030,1
d61db578691544d7fd7a0d1e9e43b323,12,12,1,84,12,0,13490,1
86ffc2f96171dfd4116217d69eb4fcfb,89,59,3,207.66666666666669,89,0,05040,3
18bd695886dcd471c3947e0d3598db5e,14,14,2,49,14,0,11040,1
b9486bffa4c4dad899db01b464a00829,35,35,1,245,35,0,08150,1
56ad80cbb798a9f1cb467aad0392d0ae,21,21,2,73.5,10,11,01027,1
9a91c39d23245ccef48b20ad6f4cc74d,46,46,1,322,46,0,01012,1
c49970407f7f4bb313df52cf27408448,36,36,1,252,36,0,01026,1
b3731f2556528c95f20c42c316363ce3,103,72,4,180.25,81,22,05040,3
eeb7427a19dd1c93307842e1d82a0ce2,3,3,1,21,3,0,08312,1
59f174ad0a23a069350113eb819d179c,122,40,3,284.6666666666667,58,64,05040,3
feddfeebce0b4ea5e102fffda5f21cdc,32,22,2,112,32,0,08132,1
de9919f4fa21e1d7d0f83f0af9f4b1d3,164,92,4,287,164,0,01085,3
8dd13453794ea746588a68ab80381e30,33,33,1,231,0,33,05040,1
c970fd609c9288ad2278c978d0026b07,16,16,1,112,16,0,08390,1
162a69beb1a57bc66c06f2ee7bcd0a53,65,46,2,227.5,45,20,09090,2
4740fa15cb93bf3678f699c08805b86a,168,116,3,392,134,34,03070,3
f4a2fddc4bfc22ee2a2eda471a067d7d,33,33,1,231,33,0,01012,1
a7df20de58841ce68044110f60b2fb96,28,28,1,196,28,0,01026,1
8cb8019db49226ec8f208f5d522a17af,322,131,3,751.3333333333334,228,94,05040,4
4cffc97c384178177bd58bb73fbd141f,30,30,1,210,30,0,03090,1
693719986ceb55bc124aacab2955850b,186,98,6,217,159,27,09170,4
ce65ffab1ba0373ba8f4233b5eb62661,327,124,2,1144.5,43,284,05040,4
be370453b737d017e6194888d1922cbe,132,100,2,462,132,0,05040,3
2f1eca0822a75dd3f1e26fcfb7e98ab0,42,27,3,98,25,17,09110,1
5d90d97b3f6d33eb6555aa7d23fcbf89,216,127,3,504,216,0,04201,4
a3130120d85d395f4f4aef745ee5f157,26,26,1,182,26,0,02690,1
569ce4d371ab90e5c4bcf6893838b53d,81,47,2,283.5,81,0,01085,2
c16d1d04c3a1acde724966cb97594942,205,111,3,478.33333333333337,205,0,05040,4
cd39f026b93c676c70cbe939b2c13bfd,84,55,2,294,84,0,10200,2
c387fbac0d36ab72702c8a6f226e4d04,85,74,2,297.5,85,0,01026,3
8996194db95f673e7f94882c8a6b9465,130,102,2,455,130,0,01012,3
8dc7d1e44aff5d838b1a37d23dbd0bb6,46,46,1,322,46,0,05040,1
8d09e4c76ed840729f8b2059caade479,20,14,2,70,20,0,05030,1
0b78ded91c53844c7ec672c9e9602f8c,267,141,5,373.8,234,33,01013,4
b96968163799056709898ca04d153198,66,49,5,92.39999999999999,61,5,10200,3
341f7036927615de3e85c3716e27592e,19,19,1,133,0,19,01027,1
4e611cb599ae5c9752e8714f0ed8f286,107,75,2,374.5,107,0,11140,3
ac70d7b19bfbe775f8eb2f4a856a5c03,11,11,1,77,11,0,05030,1
74d19c06e9ff7c26881997862596bcfe,28,28,1,196,0,28,05040,1
618bcd7e753e08c90e41a2872acd556b,15,15,1,105,0,15,05040,1
21c41ab5eb1a190338946c523cba5edc,40,25,1,280,40,0,03070,1
51dc3ab3264a913223f7a0dfe81e3d58,156,62,3,364,156,0,01026,3
c2a3a7ed03bb753ee09dacb7ed7abd76,67,61,1,469,67,0,05040,2
3d4e8228fe72dba2a865b8cd0c28c958,16,16,1,112,16,0,07144,1
4b42099703db892cd77bbdc0d55effcb,88,72,4,154,68,20,05040,3
21e389d596b01310e0d95b05245cca59,81,65,3,189,44,37,05040,3
21da3289081700bf459c76ce2dd091db,99,72,3,231,99,0,03090,3
4b699319e2c6177e720d466f23668e8e,21,21,1,147,21,0,01027,1
c41f537e43b5d9e2e3bf5fdf165a71ad,23,23,1,161,23,0,01012,1
760a5f33acf722e5e1944f7ca395ca05,136,78,2,476,58,78,05040,3
69fa9efd30bf603107a5d97033899050,89,74,1,623,0,89,10200,3
ea2e625690da68cba92ff3fdb088d8ec,37,37,1,259,37,0,01026,1
4fe79b0b26750158b8dc10c1f769dc0e,197,105,4,344.75,197,0,01085,4
ce5dfea21e4f6c3b2bb31a190abcd109,157,82,2,549.5,157,0,05100,3
651114a685672d39b5e4ac6e9a293ac5,15,15,1,105,15,0,01012,1
1a3967f1be58ac6c94ccc3b2402775d7,18,18,1,126,0,18,05030,1
e814fae5fbe46a54468147d148a18ff7,35,32,1,245,0,35,02650,1
ed068287a7963e10e6024bb3f1d6eda5,183,111,3,427,183,0,01026,3
226e6fa7afa14c07809ba7b006b718e5,125,96,3,291.6666666666667,75,50,05040,3
3b2e1e5099ec0b6dcd4f0688c5ab08a2,15,11,2,52.5,5,10,10028,1
38d0608da4b0aa47fe002f565384b7dc,21,16,1,147,21,0,05030,1
a5c5958f407e86f65f69abfee3446849,194,113,2,679,194,0,01012,4
1cf53f40c0fd834c72329a0a9e6de967,255,87,6,297.5,220,35,01027,4
547ed8ffe3b6f399dc5d2f69827c0a3d,137,49,3,319.6666666666667,137,0,05040,3
fdf74cd801fc521451ba25c1124b5264,122,82,3,284.6666666666667,122,0,04020,3
7a2ce1733204d9efd0b90ab78025ddc3,77,56,2,269.5,35,42,08100,2
5b962f353b55908f018d1d6acd8bf137,73,55,2,255.5,60,13,01013,2
a46bd0557214ddb0961450372d9c1a61,15,15,2,52.5,15,0,11100,1
d0e0e60da00d5a6de0e83df26ea05426,248,113,1,1736,248,0,01085,4
d1bac517ab7d5b30d2168662140df0d1,110,80,2,385,110,0,05030,3
7a308924c1b2ebccf27d48a7d78ccad8,16,16,1,112,16,0,05040,1
01e60628e0b0ced3cb6227ad9d59f92c,314,144,5,439.59999999999997,227,87,05040,4
639616f8a680b0bbbed1a936b121f92f,12,12,1,84,12,0,01026,1
b37595307ad4aab33513507f56b7c8ff,52,47,2,182,52,0,05040,1
83d376816f708cf55a92e37b8e284a36,190,96,3,443.33333333333337,117,73,02620,3
b564e29e14c1e7fff9ddeaee01e5ab1f,361,111,4,631.75,361,0,01026,4
6556f33bf0b2101b4eb5149e9f6985e6,35,35,1,245,35,0,01026,1
4e862dd588a71d5564a51ee25076b252,199,91,5,278.59999999999997,182,17,05040,4
c39bb99012f5658bb4359bbf25e84f3a,53,43,1,371,53,0,11140,1
1fb3e8b17268b9503fbe50737a3f034f,225,108,4,393.75,225,0,10200,4
407fd049edabd9ce8895f984ae2992db,100,46,5,140,80,20,05030,3
b1626fcc84c3f1212712789ed6b40fd2,43,43,1,301,43,0,08090,1
923c112a50eb8170b776a6524311398e,218,120,3,508.6666666666667,106,112,10240,4
07176cbfcbebd36e06fb7af0401c0fe8,11,11,1,77,11,0,11180,1
8cf6a6808268b521d0f074c4a50cb768,38,38,1,266,38,0,01014,1
2908dff0e48e13c57095f2729770797e,246,146,4,430.5,214,32,05040,4
54e18983d1fe1c5b1787b1d945e1af57,39,39,1,273,39,0,04060,1
82649e2d43db65e9684d2724e5fa0504,52,44,2,182,52,0,09350,1
b51cdaea1dfcf66d6ed39c9df9b6a4d0,44,43,2,154,22,22,01012,1
ca8a05c0443220084e3a8d8c3c598123,217,96,4,379.75,217,0,01027,4
9a2628c6fedb27f15b9fd27122b5c38a,120,75,3,280,90,30,08052,3
a23c3aa6ce19f97f5e81bd4b33f26f82,71,71,1,497,71,0,04020,2
63a59c83373868fbd0c3b05ae8fc968a,51,41,2,178.5,51,0,05030,1
3012dfe5cf6964ca0b32a7312fc7eed2,176,88,5,246.4,176,0,01027,3
c086807b252e0ea39dcfced9f09d9be3,7,7,1,49,0,7,01027,1
3d86da508f0500b1b3c4ec06676792c5,159,78,4,278.25,159,0,05040,3
9d1388df8c5b26707d1f60aaaecf61bd,58,58,1,406,58,0,08100,2
e6c94f99e6ceccd6beb31f1942f2492c,22,22,1,154,22,0,02756,1
0a48b8333221a615ff87bee834d084d4,13,13,1,91,0,13,05100,1
10b333bce7c872a40a03fed22971f1a7,139,79,2,486.5,77,62,04060,3
a720401a123610b7d5fa6c55ebf5a844,14,14,1,98,14,0,13490,1
d25fcc6b7b2b41ffe2011e131c6c5cec,19,19,1,133,0,19,04020,1
175ea3a75875266646e8cb43af282e82,60,47,2,210,60,0,05040,1
fb06f5aa72f2f259061f397bd17c30f8,30,30,1,210,30,0,11100,1
47dd5e3e2e4d75142f27ff880fd7c601,10,10,1,70,10,0,05030,1
17db71b370537eb684b755640e342014,296,142,5,414.4,231,65,04020,4
f537bc98e7fd6210333df7d3bb1d3fa8,206,130,4,360.5,173,33,11040,4
1678a8209a9984e9b3e7f2814eded942,324,134,5,453.59999999999997,254,70,01012,4
7a4c57fc37f25a7219cdbfd493c55c95,25,23,3,58.333333333333336,14,11,13952,1
0055706d5150d3ef95af9023def53033,49,36,1,343,49,0,12670,1
7b56849d9b9353b955c9bec078828e55,237,99,3,553,135,102,01012,4
8e7d0c604fe1791388e282629864c1da,24,24,1,168,24,0,08230,1
06e9cd4d92284c56f197b5b8428a919f,11,10,1,77,11,0,09170,1
cca1416efe4630c9d075c4dca0f341cd,286,122,3,667.3333333333334,79,207,05100,4
befe78cd1cec350c298bd15ff7894b0d,25,20,3,58.333333333333336,25,0,11040,1
bd888a0447a96740773efc892a4632b0,27,27,1,189,27,0,08231,1
123f391ecad5a12b85da480fa0f4f58b,38,38,1,266,38,0,09130,1
1362fd3da9cee5c29b81fdf8ee0f08bf,131,85,4,229.25,102,29,01201,3
2e76c02ae08f93b943e017146a10d37e,31,21,2,108.5,31,0,05030,1
2e2c8cc41675b6a5de4616cadc987e35,2,2,1,14,2,0,11040,1
b77cd0e7243d0e07ef930c744e37b32b,103,45,5,144.2,72,31,11100,3
9fc28599d3e6581c1361385c280a361e,127,79,2,444.5,53,74,10200,3
690f2b8a36fcfdd2f4973e24c99397e6,322,101,3,751.3333333333334,295,27,05040,4
68649a512394297cb4aba1eba04c28b9,151,106,3,352.33333333333337,151,0,01027,3
2225ead4f1f25d8be049b82e0398e8f3,30,30,1,210,30,0,01026,1
5f6d5941bd51d3393a5f957858831a08,96,56,3,224,96,0,01026,3
380b82d25cab12f9bfeff7c1dc02c598,72,72,1,504,72,0,05040,2
761704971ce81b4cbbd281e235e1af3e,17,17,1,119,17,0,05040,1
217048013066946a3fd15f2a1c47ae1c,40,29,2,140,25,15,04060,1
2d5a9267cdde053f3004ba72eb0a96cd,7,7,1,49,7,0,09110,1
29ab5fb0ec86bfe96af864e4e6d9a62f,63,50,2,220.5,63,0,05040,2
8fd80023f78fdeb6cfd7777a73d5e44f,106,71,4,185.5,106,0,05040,3
4562204abc80ca153cc46ad0fce425b1,13,13,1,91,13,0,01012,1
dbd759667503f19ff4590fdb80a9aa71,270,149,4,472.5,188,82,09030,4
35fb35f833ac8c77d25cb8fa01972cbe,93,70,4,162.75,72,21,04060,3
e5ced8791b9d2e3d82006861a214c9c7,99,85,2,346.5,99,0,03090,3
834dc896fa34e0a0052b5e5b2a4c5566,50,42,3,116.66666666666667,50,0,04060,1
0c37537852abe72980f8518a3ea42857,40,40,1,280,40,0,01027,1
bbdb5969e98eb7025e5e4a7a0f7f35aa,33,31,2,115.5,33,0,11040,1
a8257cda929e29f707c89c369fd412b3,107,64,3,249.66666666666669,107,0,07122,3
d1436c32fed81f71fe4e408780c63bc0,20,16,2,70,20,0,01201,1
8c0a66e492f9ea326155569186798235,221,93,4,386.75,188,33,01027,4
0982c4413bb901069b192ea9b53e1d1f,257,126,3,599.6666666666667,257,0,01026,4
eba4a9185ea60d67c5dbe18645496bab,5,5,1,35,5,0,07141,1
b829db9e19aec8f2174f97812f8f2ea9,72,72,1,504,0,72,01026,3
e635b34290334284340ce93574fa727b,41,29,2,143.5,41,0,01027,1
38e2a0480c6344111e65d9bac59d9291,116,108,2,406,116,0,05040,3
0fa9d51b7364d764777c6ab5af0eaab8,37,28,2,129.5,37,0,01085,1
5bcce7165b4ef70888326d32c55763d9,47,47,1,329,0,47,01026,1
410ae8c1ab8030eb90040732b7c15d25,12,12,1,84,12,0,01201,1
b689f15f7b97f960f0bdb5051af5040f,42,42,1,294,42,0,10200,1
fad4e4787c0d596ac88d82c579d115bf,241,111,5,337.4,153,88,01012,4
14e021794fbf683c680d5641ac56dd23,108,85,2,378,108,0,01026,3
933e3738c5bc043c01b6a4744abe57e0,40,12,5,56,40,0,08032,1
9487d00689525d0a2e5c07520d19f154,156,59,3,364,156,0,04060,3
c17a40b3240feda0700faf51efc507b1,94,65,4,164.5,77,17,06100,3
3eae0c4030e27460e83b3b4daf634cc2,33,33,1,231,33,0,01027,1
8c76949bc17c2b523936d1d24e90b343,278,125,2,973,278,0,01027,4
6fea8d1e28f43d34dc7f33d0aebd0217,22,22,1,154,0,22,08134,1
ac66f36dd972520312877a1743f561bc,15,15,1,105,15,0,01012,1
b21843f07807a881435653f787972bdc,50,47,2,175,50,0,05100,1
4421253fb688d5587887cb77a2b70912,98,80,1,686,98,0,03090,3
ecb6252d0d8f4392edf49e04d1335a1a,1,1,1,7,1,0,08190,1
c17854bb1fae94df24fb9abb964e9ca9,271,137,2,948.5,271,0,01026,4
41c961a9dd62b954f38953a386c0c39b,47,35,2,164.5,47,0,05100,1
e7c1d314a28fe91a50cc54a5e22823d3,87,60,2,304.5,87,0,01026,2
59c6e8634a4c51cf000ce8b1badc6af8,24,24,1,168,24,0,01026,1
1c4700ce09dd1094bf75132eaaafdf5d,81,67,2,283.5,81,0,01013,2
d2e61aa46d2c141254a823bbb144f5eb,103,75,2,360.5,103,0,05040,3
66b4fa00424eee1f658994ea736a62f5,131,87,2,458.5,131,0,01012,3
beff0dc5ca8e89ec603ea73bb91d64a6,242,118,5,338.8,209,33,04020,4
9efc4e12d78b5de488a29cf00e086cb0,53,38,2,185.5,53,0,10080,1
8fbf78b77edc3823bc81fdfe427f047f,29,26,1,203,29,0,05100,1
325a6d82018f4ce4f0945ce1d210a696,157,85,3,366.33333333333337,157,0,01026,3
70141187f7b7325bf12b0e0a796d4b0b,16,16,1,112,16,0,12570,1
fa7c2f2606b1ff488ebcb377d652ddf6,15,15,1,105,15,0,01085,1
73f8c2181b6864817a14b3ab49a1d1df,97,52,2,339.5,97,0,09010,2
2d57c1415674943dc235221026ceb3d0,23,23,1,161,23,0,11100,1
95f95662f34a3a7f541a8d548a1f09b2,35,35,1,245,35,0,05030,1
aa8872a1e2d799fac3ac476567aecb00,21,15,2,73.5,21,0,09090,1
77565d6cb0df0faa72dfc55cb8dee351,81,70,2,283.5,81,0,04080,2
c151a1623d72fd33b75cc0e5eb9fc979,372,99,5,520.8,343,29,05040,4
8d41d8e560b209b3083c8a6a3ddfdeb1,12,11,1,84,12,0,08314,1
d952e76d4f82057f6f81d16ec0511b3d,129,55,4,225.75,67,62,08032,3
2388744a793cf117d1574d8e3a67e694,110,71,3,256.6666666666667,92,18,05041,3
32dd4bd6496e87f866a578336f787413,36,36,1,252,0,36,07133,1
661e91cd02836bd2f265e336f3b5d045,249,76,4,435.75,84,165,01028,4
8a6ab74a1b27be07e8ee2b9be2aadfb9,131,82,4,229.25,131,0,01012,3
328b079972f765a340b3c9cefed4c2ef,26,26,1,182,26,0,03050,1
4420718255f01c7e548060fbca19c6db,159,79,4,278.25,159,0,05040,3
5c7d83bf9c368663b50bc9f2f48278f3,30,30,1,210,30,0,13830,1
2b915d1e605050aec3b75b47c03425bf,30,30,1,210,30,0,04032,1
a66a247ceffb0ae69067d7ee1ddd0865,1,1,1,7,1,0,11040,1
9404f778ea4e2086025c90d2df6279ed,11,11,1,77,0,11,13875,1
00b3d995c6bd6c2caa1270ebd82741c8,8,8,1,56,0,8,11100,1
8672abac1485e9e505172fa55b3e6f79,46,28,4,80.5,46,0,11180,1
6ab85c5f6ebfaa64e7175f37d0984dd8,43,43,1,301,43,0,10200,1
414b46435a10b88f0878121fa80be41b,180,65,3,420,161,19,04020,3
3d81b6e01cc1c494d55df5a204b88867,10,8,2,35,10,0,05030,1
9e05836e8f900fe327b587b57592b7a9,149,92,2,521.5,65,84,01026,3
ab61963dd1b126cd4baab67a5d86f431,11,11,1,77,11,0,01085,1
99075a2542e699dc80b8307ae9c4a09a,50,50,2,175,50,0,01026,1
26ea8a1bead8dc059301019545ab3079,31,30,2,108.5,1,30,08052,1
971ef5102a3a6dba98a7cf68cfacc1bf,95,54,2,332.5,95,0,04201,2
e09acb5b7a3948f1098530424f707cbc,262,110,3,611.3333333333334,262,0,05040,4
3a3c80ffc4e4d81779988004f52533eb,232,87,2,812,75,157,10261,4
babd705bb59c7d2b96f9b89c3ce7ba1c,45,45,1,315,0,45,04060,1
f4de0aec0cae4a0863c1ed1d4ddae7b8,14,14,1,98,14,0,05030,1
cf6ed2533f4daf2eb60cc18ca0c4acd6,10,10,1,70,10,0,05030,1
6ee433aa8b2d7f231f3286f694d98242,67,46,3,156.33333333333334,67,0,03050,2
3a5d2c4ad4d10a63072c90d1e071a846,106,96,2,371,106,0,10040,3
d30a0ac4a9f1777c8063181d8694fd55,160,92,3,373.33333333333337,160,0,05030,3
0c63d4bc934dbfe7fce4c5a8c09f0bc8,21,21,1,147,21,0,03050,1
38c86be12eaad7a02e3c7fb20e171bd8,243,97,1,1701,0,243,04060,4
c97273fb8aa95e50614039b8538596ef,55,55,1,385,55,0,05040,1
9fd6eacb7b95d7da8156c6e34971270d,84,52,1,588,84,0,05030,2
9e05045e4524658137503561e23d25d3,37,30,1,259,0,37,10101,1
04b13891530e4b7347837c29b4447554,128,87,2,448,128,0,08150,3
2a4432b7d2e9b0675a0d317abbef5d6c,51,41,2,178.5,51,0,05040,1
7a0217e4be6a199ac2e46df356f2d1ca,149,89,4,260.75,149,0,05100,3
e92dde26292c1c6547c704041e074901,44,44,1,308,0,44,08150,1
1e58eaa617e815e5bf20492cff698537,22,22,1,154,22,0,01014,1
4d236d6cf4917c2d062539ca88e58569,55,39,2,192.5,55,0,10200,1
77a59d5e89f6ab26c9cbc931e5549837,25,25,1,175,25,0,01012,1
3687bf321ad2a1682c478f35a074b477,8,8,1,56,8,0,05030,1
ca86dab82c1c01c62b947f9e6a014f64,80,62,3,186.66666666666669,80,0,05030,3
664e8b468ea59bb23446e44af68300c3,85,68,2,297.5,85,0,05041,3
5650fd7f0c65d9bc0109ba176e34b40e,124,72,2,434,124,0,05100,3
3e46818cf9a075dad79c6761263c826f,222,99,3,518,170,52,01026,4
e8d9c007594f2c646de02dd8482fd097,92,50,3,214.66666666666669,54,38,01013,3
ae99339d19202743a068fc9c1dbf9918,61,55,2,213.5,61,0,01026,2
a436939cadd8f137212601d2d1d82ff1,333,168,3,777,333,0,04060,4
a3b07620072af21658805b44c730b34b,13,13,1,91,0,13,12650,1
6fc8a5b81e3c6abb84ce57165cb4cedc,263,114,5,368.2,160,103,01012,4
64cb1e024ddc347bd10c60c19f4726c9,16,16,1,112,16,0,03050,1
f8bbbd4cfd6e704fe2c57f7fdb6d79cb,45,44,2,157.5,45,0,05040,1
13220e0f8c5b51efd2a122cd57f5ad5f,127,56,3,296.33333333333337,109,18,01027,3
363d7c1a6475a094ff8fba6a83433d03,126,63,2,441,126,0,11140,3
6695d45209b235fa8459d9a9bd7599d7,25,25,1,175,25,0,04060,1
410569335905aa22e618af84bbb0e0e2,20,20,1,140,0,20,05030,1
ec2e31766c21beaf4af82f795049ea10,136,90,3,317.33333333333337,105,31,05040,3
f6afc87e5fe0fbfb616eebd4add5f0b0,98,66,3,228.66666666666669,55,43,05040,3
ca1fa13102710406988f29dd5f8484ba,42,42,1,294,42,0,03050,1
83de8a543b28df179efdc6617b2ea0f9,10,10,1,70,10,0,13830,1
3e52f454fbb66a069e4fd9f9225beccc,9,9,1,63,9,0,01012,1
afb9998cb38e35e4bd245ca8dabd796f,185,123,4,323.75,166,19,01027,4
f6d2a9593e326dfffa0ea9220c077a6a,27,27,1,189,27,0,05030,1
608f034b1a3e846a3f32a29825b2bebf,43,43,1,301,43,0,08231,1
c274866829463dbfdd8036df415785ef,61,44,3,142.33333333333334,61,0,05030,2
4572c98235b9b80932c33e11cb367d09,147,66,4,257.25,71,76,05030,3
3f70ba337ea1a737d76bcdfc8d06e9ee,55,55,1,385,55,0,05040,1
6020eb62273b64da10c753992ca912fd,196,92,4,343,148,48,01027,4
778d732b9f86dc80758742cad5e3a3bf,37,37,1,259,37,0,02651,1
8bc86bbc6d3652facc125edb223a03e3,64,41,2,224,32,32,05041,1
aaf5a7a85691247d4dd4f9d060cb6071,104,81,2,364,104,0,01026,3
a0482efef32605698c56856aa75e729c,25,20,2,87.5,11,14,09010,1
1f4b021b00b378284d6660f4295345d2,63,46,3,147,63,0,08314,2
2915ae17fb2144619b5a6af2a1adec34,45,45,1,315,45,0,05040,1
f89ab26ab1514ad6a2957c08126dd142,441,113,3,1029,441,0,05040,4
e0a30bb2fe5baec7f7534cf9d9514421,22,22,1,154,22,0,11080,1
c1645f5dc42bda6ff3361b97464cb1dd,23,23,1,161,23,0,01012,1
dab8c87bfe0fac8ceb10b95a9b7f4f92,47,14,4,82.25,47,0,04201,1
da1d49cb1e94ae2acc33267f25b57b7a,164,116,5,229.6,145,19,08314,4
fce45e8bc8368f474b683be73bd71cc0,128,64,3,298.6666666666667,128,0,10200,3
a2f3fe54d3a10ed234fe95eeef66c280,50,50,1,350,50,0,01026,1
4996b17e1fc062afcabee13d03e15aae,203,77,4,355.25,101,102,05040,4
7b0333470a953a69b7cb6c89b2c0a3fa,105,78,3,245,73,32,04060,3
19da16ed6d7b080353c0357937f6597f,21,21,1,147,21,0,04032,1
92ee5df2cc99d63409444290f58ba693,329,127,4,575.75,329,0,05040,4
4647ebed95cb478d0e10c701cda25854,14,11,2,49,14,0,05030,1
9bb19b4b235c3d2bbb64d2cf60b58cf1,75,57,2,262.5,75,0,12501,2
d6cf2dea848b1b3bb6ca8ed5b2ef447c,118,76,3,275.33333333333337,70,48,11100,3
13753fd2c4f43ed691c41e131aaa23b7,208,96,4,364,145,63,05040,4
6ab4d5dfe6275872353d2e9a00d946a9,50,46,2,175,50,0,01027,1
87532d2ab9c878d989f39114fed197ab,152,110,1,1064,0,152,05100,4
0a07aa075419af938ec6ee76e0a17881,117,83,3,273,117,0,01016,3
447894c5995f909b7f40085bfda37ce8,28,28,1,196,28,0,03050,1
86b4b1df1ccae24d2306e44303baf6cd,50,50,1,350,50,0,05100,1
2a51bbbd53a571264af2341957c8d591,133,117,2,465.5,133,0,05100,3
d296d5bb56bcd399d2a66096f1dada00,23,23,1,161,0,23,05040,1
f8299bbea530fd715cd0be220d9f0acf,47,47,1,329,47,0,01027,1
eb0b57f42e1f3c4fe05c9fb8244a72c1,45,40,2,157.5,45,0,11100,1
3d50a78f54ddc946e839e6f0cf064464,25,25,1,175,0,25,01085,1
6a5d0117afc9c227f9802b8b4c670b18,9,9,1,63,9,0,10200,1
57c37a2c944f1f16bcc3a420b4314192,74,43,3,172.66666666666669,59,15,11040,2
590d28c51c227da0d9575b38365ea550,4,4,1,28,4,0,08190,1
d8fe21cde562b7c125a0e95a18fc01ed,24,23,2,84,16,8,04020,1
178e54b11319911b46aab31cbb08b18a,63,47,3,147,39,24,01201,2
99caa58fc5782d4801768a7a08dd0075,19,19,1,133,19,0,13490,1
c5a2e8f113188a756f3e7ffae3a92b8a,83,49,2,290.5,83,0,09010,2
b29013b7a84ac97a1166fde8780c222c,60,54,2,210,34,26,11100,2
9a20bd59036a3a056767e7af4b6279b5,2,1,2,7,1,1,11040,1
631341e7f013f53329646274e964a6ee,117,85,3,273,117,0,01012,3
84354d94624d52c81002ea4d2e45c838,42,42,1,294,42,0,01013,1
15669ff1819182ff00862dd0185f0aba,420,50,3,980,388,32,01012,4
3d9f155023e7e56cf73fc4119d533c92,49,40,2,171.5,25,24,05040,1
bceec7c264a171d8955fd2725f45cc42,89,71,2,311.5,89,0,01013,3
95640e16c2c20217032004217472ae9d,47,42,1,329,47,0,02620,1
028c1c6d631b2478b1b61456b2ac1849,218,113,2,763,62,156,05040,4
b8c12cd9ccff773b9e1eb5e62b6878c6,61,50,2,213.5,61,0,01026,2
d1eb7d3e10314ee9add1764ea1a6fd3c,32,28,1,224,0,32,02650,1
d097ee5e2dea012a0bba14ac15cbfc57,75,50,2,262.5,33,42,01026,2
0d9653a3f3465d8ff5d8c375b8c3890f,23,23,1,161,23,0,05030,1
faecf93c9dbad0903ad4a26e2f842f50,29,29,1,203,29,0,01026,1
0e0a4ac39904ea66bf7b9f815f67de82,4,3,1,28,4,0,11040,1
dc68cb7e2aba23911d417a9b9e483471,144,93,3,336,144,0,05040,3
8257690081f2fded78b3935bdf6a3ab0,341,137,3,795.6666666666667,157,184,01026,4
f062868b6b169599a00fb5bb0619c1f2,222,83,3,518,120,102,05040,4
825995667ef845b6dc796f5b07f67a26,69,39,2,241.5,48,21,05040,2
363a8f0b2b8f66239cf06ebbf093a429,265,102,4,463.75,265,0,11040,4
5b9ad0ca278bab90395128c2e4176d5c,229,121,5,320.59999999999997,175,54,05100,4
19fbae46cb152084f4a1c6c4bf0fc7cc,141,73,4,246.75,141,0,05030,3
32a34a8dd90b8e76bff4b58653c4f1f7,18,18,1,126,18,0,08100,1
b657b5bf33f8d30e70d02e6ca559bc1e,240,103,4,420,150,90,01026,4
2a5394c3c18cbcd7783e99fbdab96853,22,22,1,154,22,0,11040,1
b726f0a53d64000be16ada417e5070b7,38,38,1,266,38,0,10220,1
40d920c9975cf46f68f1f3b2a941cf25,56,38,3,130.66666666666669,38,18,05040,1
d9d66eea2d8a90d7327f47a9d86e6308,12,12,1,84,12,0,08010,1
486528e8f2f671f1041255f9a95c0805,68,45,3,158.66666666666669,67,1,08010,2
3cf111f15dda9d797ca8e4db12cf029a,159,76,1,1113,159,0,01012,3
da7e71aeeeb87b31664ed6a28da1a446,4,4,1,28,0,4,01012,1
ef8ad79072e7db372695732ccc1f8c60,90,90,1,630,90,0,09130,3
c62c831962018d64e5eacc00e1afc923,11,11,1,77,11,0,02620,1
d66dfe18ced7aed15ef8cde2c229b49b,24,24,1,168,24,0,10240,1
678666b4871cf753c4511e8d5c59f8e4,5,5,1,35,5,0,02690,1
b4661230350326467961bc3c30fefaca,20,20,1,140,0,20,12670,1
106a131662ec14225d7dc2a27cfa404b,77,29,4,134.75,77,0,10240,2
fe00e5290de5426631d74ac95e2646a7,21,21,1,147,21,0,04032,1
93f879aa31d32c9677ba8b5ebd893f2a,35,13,2,122.5,35,0,02755,1
eef4d6f800f46efdfa4b20a298310eb6,65,45,3,151.66666666666669,49,16,05040,2
cff3cc7e1ebe0cd871fb2e9373df00c0,236,101,3,550.6666666666667,200,36,05040,4
33f11d522862e5cad54ebbb08d45dc16,17,17,1,119,17,0,01028,1
2f98b93d7d135a91ae1c2ce8903480f3,121,79,3,282.33333333333337,121,0,05040,3
4dde9adae2cd529c8396eea4d0976e7d,33,33,1,231,33,0,05040,1
99f393c905d39041caadb7c9c345b56f,27,27,1,189,27,0,01012,1
e9d9b0493bcfe0cd8428a55c7f5f454d,44,43,2,154,16,28,04032,1
f5c98ca232cb8b622d91671e0a7e46a2,327,166,2,1144.5,291,36,05040,4
d51c4b946026fd5b091726ca44c23f75,24,20,2,84,24,0,05030,1
42e1debd4e56804399eb4c4fd00f041a,57,57,1,399,57,0,01026,2
abd875ad3e363893d9842f43900c6f68,18,18,1,126,18,0,10220,1
da88db0213b2cb70ab786eb2115b0506,34,34,1,238,34,0,12650,1
e76a0193820f8e6ccb0fb68acee4914f,287,96,4,502.25,255,32,03050,4
372539cd0f6be85272b11862166e0292,110,75,4,192.5,62,48,01012,3
fa6b3c1eeb35ab54237a36750dea40a2,181,113,4,316.75,181,0,05040,4
fc3eb091e7c3a44caf4beb9a9117ec92,92,71,2,322,92,0,05040,3
977693fb77705c477029b55d0c85a40b,25,25,1,175,0,25,09170,1
b51b71734acc5362560944bd6b732842,2,2,1,14,2,0,09010,1
6506438082b5c82d5f2b7946d1625ef1,6,6,1,42,0,6,01200,1
3e78f2c3656cc5a1c400ef87e5e9e67e,190,82,4,332.5,190,0,05040,3
b57124fe8add818fb5a9a8264d7aa67a,47,36,1,329,0,47,04060,1
5007ec7b66e0e949950b5b0db91ef4d4,155,92,4,271.25,155,0,11060,3
262e7cc92329525d7aebf59aa52ca5a0,172,107,4,301,114,58,01027,3
97db48fe2e0266da79a944e159d2c04e,37,37,1,259,0,37,01026,1
08f1085741facbfdfdf806f92eeee10f,82,82,1,574,82,0,01026,3
fcfed44000963b8bd8268ee6daccc421,31,31,1,217,31,0,05040,1
a06fd41e7184c8aec3fddf6239ed777c,91,69,2,318.5,91,0,10240,3
8ea53ccc39a9420e03072d17f73e91b6,98,66,3,228.66666666666669,98,0,11040,3
f40512ade5d71d537ab09c25261389d3,477,123,3,1113,477,0,01012,4
40a8d093221a1fc5fdf427060bdb9983,42,42,1,294,42,0,10200,1
9a624515c833d70a9945bf8d72971e23,168,99,3,392,142,26,02620,3
0d905abdfa396688ae55223c68d602f3,165,127,5,231,137,28,02650,4
8b7ca6de3877a60a6b8a7eccc82c9511,33,33,1,231,33,0,01013,1
bae7464d106dbf3313411695ba830819,249,120,5,348.59999999999997,200,49,10200,4
4bb8affe5ffb0075b92106252ae43ffd,20,20,1,140,20,0,09030,1
a5120a070bb5762f841c90ad0c47d2cc,231,108,3,539,231,0,01026,4
6d77311271b42fb7422563346fbc04b5,21,21,1,147,21,0,01012,1
0aaaccfb559477f88cdf59f5cb3c3360,57,57,1,399,57,0,01012,2
d493b8f7a1a2746241690ee4845d3c03,94,87,2,329,48,46,04020,3
3facce7e799a484cdf40337c4c207cfd,14,14,1,98,14,0,11040,1
71666e2a36682c299584b7cbac485545,108,87,3,252,52,56,05030,3
2ddafd765632bf527a9b1d1f8f8528ac,40,40,1,280,40,0,01027,1
204867221519fab0c3bda95126ce4374,159,91,3,371,123,36,05040,3
30c5a3f3a70b0f9316e50b41010b085b,14,14,1,98,0,14,01026,1
af43ddadb861b0d1729f397f36b4c3f3,66,61,2,231,66,0,05040,2
a265cb6464d47a9696407bf1858008ff,156,126,2,546,156,0,01027,3
f41df403737f92fc2c644197d7da5c34,11,11,1,77,0,11,01012,1
7594fc9855b619a3dfcaf2b059775d48,141,66,5,197.4,112,29,12670,3
b0176229f6ac313c29f64832df64d40c,125,104,3,291.6666666666667,86,39,10200,3
9a3ce2780b0d6c07315abb148ecf6cf5,80,64,2,280,80,0,01026,2
7e32655425018e0c2a31248558a9b8ab,111,70,2,388.5,44,67,05040,3
3d9ceda0fda21d26f550e2e15cb4af0c,16,16,1,112,16,0,12610,1
566133c6f8071ef70853d951022a429d,284,93,1,1988,284,0,01027,4
1ffa226f7dda5fe15a363d765b2c3d5f,32,32,1,224,32,0,01026,1
ffdbbdb96c8a8712b84b44c0ceb74a45,32,32,1,224,32,0,01027,1
cde2650d80ea3655463b50033f099f8a,36,36,1,252,36,0,05040,1
7843cdd262d045a26f72b935c188a9fb,384,132,3,896,384,0,01012,4
64e1e87361bcb7cc12c46bee1638df05,89,55,4,155.75,78,11,05040,3
1a461e499c3c514264097d4bda87a7b0,8,8,1,56,8,0,01013,1
4550d11885967877d0efc87f27e0997f,35,28,2,122.5,35,0,05040,1
7eae5bf45832b53cc49190c12eefa3e7,11,11,1,77,11,0,01085,1
9609fbda66703f296af2b692c95a30c8,36,36,1,252,36,0,01026,1
aacddc3feadf26fe57c31ff4edae7d5d,21,21,1,147,21,0,03070,1
73cf0a45b6186f44b2a52206b5cb11ee,23,23,1,161,23,0,03070,1
057a1e1454a927283c2f84b8cce98258,83,59,2,290.5,43,40,06120,2
3030e834dc9de90eb02b21d19c4b2780,27,27,1,189,27,0,01012,1
10c00b74661b14e5071c2697f82a1e52,23,23,2,80.5,23,0,10200,1
2d7b4a7b7184a12abb67b31869bfcec5,69,50,2,241.5,69,0,02756,2
b21ba23df535d18b6fa7427d639ebba6,35,34,2,122.5,1,34,05040,1
5a1ab2401e8046f8da2af8e6ec502a2e,14,14,1,98,14,0,01026,1
3b75a50c8c081153f7ae989ac45aa220,46,38,2,161,46,0,05040,1
f6f6b016adea86d74ef81381c82bc506,27,24,2,94.5,27,0,04020,1
9c5b97b09b9a75253a03cf6ee78b895a,35,30,1,245,35,0,05030,1
4c3d7f93d5b28a56cb81ff0b12435469,293,104,4,512.75,264,29,11140,4
538b3e40200d673cfe751772a87f5787,153,96,4,267.75,123,30,01012,3
935fe29da00a8f8557fc051c0944556f,65,45,3,151.66666666666669,31,34,11140,2
0308fb87556476aa63e6a3e1c75b1065,22,22,1,154,22,0,11080,1
e5e1adce9dc9ea9beb5082a78b811ce3,387,139,4,677.25,387,0,09110,4
6eea30322ddee1a2d56ee8920282db25,245,121,4,428.75,207,38,08314,4
5e16b80604e710447d326642dd37c9e3,4,4,1,28,0,4,02750,1
0d2531ec1888e9b247140bf97b039c79,75,50,3,175,75,0,08230,2
cc8106adf9f793788cd8d33aabf55faa,56,43,2,196,27,29,01012,1
41a02f025963b1296b71da9c34ff937b,78,65,2,273,42,36,08010,2
e45914396c8659b94db94083d32e1658,51,51,1,357,0,51,01026,1
3fa001965419ea5b8a61f5d5eef81c06,40,40,1,280,40,0,10200,1
c408d9a22bebb57f36e360b316349f1f,58,44,2,203,58,0,12670,1
39288f07b3239c347eedd127430dc1fc,22,22,1,154,22,0,05040,1
ef8814a99e4ba701e47f1ad376fa15c5,25,25,1,175,25,0,08132,1
4554b3f2d96f0c770a1aedd7d182db82,3,3,1,21,3,0,11040,1
d2f27ff8e2d2ea19f80c2495fadd8118,33,33,1,231,33,0,01013,1
381cd055da4f27bc7239f629b417c5ae,95,58,1,665,0,95,03070,3
67058912541a9d2cb989178d538b71fc,164,80,1,1148,164,0,10028,3
0b9b1e329b7330b19cabbc24721bf64c,39,26,2,136.5,39,0,11100,1
e3e8d7c40176d8f60b712cd72f9fc3af,169,108,2,591.5,111,58,05040,3
e70b63ee086b5b1db76bc29994508990,105,97,3,245,58,47,08232,3
7d101b61027b6341142b68c558620325,68,54,2,238,68,0,02650,2
55acd59cf44d4682750cffdf61d4b898,11,10,2,38.5,9,2,08315,1
89ec6ff202811a89f7edcbb254bab91c,34,34,1,238,34,0,01201,1
e3a1ef0ea1ba80c38f8ac7100ad1b29a,89,72,2,311.5,45,44,10200,3
89f83c35cc979fc211142495f5ddf6d2,75,61,2,262.5,75,0,04060,2
e6665af67af1776d41e8443b67f56ec0,34,34,1,238,34,0,05040,1
7b0b501e7e04a4f3e1f07e944988252a,15,13,2,52.5,15,0,12590,1
09407f81c523f2676457c0cd291dbdc0,36,36,1,252,36,0,08100,1
67c3b5fbceed8356405ebecde27bc359,24,23,2,84,24,0,05040,1
1c0e42173e6e993d005614e8c8d67676,79,46,2,276.5,79,0,01012,2
b9fcec48ebc2a3432e44fee533095fc0,236,118,4,413,236,0,10220,4
b7265fa90694977ceb29805fde9ec27f,353,110,3,823.6666666666667,353,0,02690,4
2d89f5b0bfc17722992a790e1fe91a1c,132,104,3,308,74,58,03050,3
26e6d27044c30a8d9be3406539899263,140,112,2,490,100,40,01085,3
918b596e5639f6d6d0ea0b82e3f8d6b7,143,97,4,250.25,143,0,05030,3
13efb19c7ace21feadd868d6d917de80,5,5,1,35,5,0,08031,1
7c5da85421df27de81aebaad1fb9be90,37,37,1,259,37,0,02751,1
1fd27222de4e3fa4cd7a12eff7deccfb,180,96,4,315,149,31,05030,3
84bdff08908978dfdec039017e168e94,63,55,2,220.5,63,0,01026,2
355dbec80d29336774238419e54b5da0,48,48,1,336,48,0,10200,1
85d73473b9ca4afb276c45e264620b8d,41,41,1,287,41,0,10200,1
0cee47455c9b6eef2ab89991b41e89f8,30,30,1,210,30,0,09070,1
125a1ce1457ff1afb2b19536e349ea5b,144,70,5,201.6,131,13,05040,3
6d2f024f488128972af2a7be2695183c,10,10,1,70,10,0,11040,1
b4a9535b99067a05ec3d1c3aee759269,11,11,1,77,11,0,05030,1
55c1b79c0128498d80e5335fa5c381f0,36,36,1,252,36,0,05040,1
884871273fb343467845b1c4c977255d,12,12,1,84,12,0,12610,1
5a9563e49d247846a970ccaa82b565ec,197,141,3,459.6666666666667,197,0,05100,4
4962ee820f94a47e2b0f5309bee9896a,90,64,2,315,0,90,05040,3
97826069022ba92f2b75100444677dfa,18,18,1,126,18,0,01016,1
9e1dd61b700431f0b4a27799de8dd760,23,23,1,161,23,0,10028,1
6e40409813c5aa9377e03b64873d7cc1,36,32,2,126,36,0,05030,1
2652045330099324b8ed5cf413e09cec,42,42,1,294,42,0,01026,1
0efe6647d4a9ff2c5b07c683ed73465a,16,16,1,112,0,16,13490,1
8f9e6113c6548472bc95460e9d123748,87,55,2,304.5,87,0,02691,2
ab66e4a762eb6b5869be9759e5f2cc48,61,11,6,71.16666666666667,55,6,11040,2
b3d9e9ea3dfe1b54233624a9dd407d65,492,118,2,1722,399,93,01027,4
7cf52a9a2624026fa74b58f72a7dfbc9,355,91,1,2485,355,0,01085,4
4728a3963d8e634154a55a3ce1a3653c,238,92,5,333.2,201,37,10153,4
8b1b96dd8574b40c4fb5faa48c2bc4f9,38,38,1,266,38,0,01012,1
b5986eda0ae3b1e95427148e8c439444,13,13,1,91,13,0,06100,1
54a4f1b555291691c0b5428b2b496e23,85,35,3,198.33333333333334,85,0,01026,2
66e1071ac939997a20d7e43c8cf614fc,5,5,1,35,5,0,05030,1
ddc9d55a0cefd878321d4ccde95718f9,108,97,2,378,108,0,05040,3
8004c385e2943794c32c6e3b81045ce3,16,16,1,112,16,0,09130,1
fcf66d8695003f9b66c5c4d77bdaf4c3,85,68,2,297.5,42,43,01026,3
c00e2356198087c6ccc4d498ec57ee80,51,51,1,357,51,0,05040,1
26ad529731eb2aadf67492c28f177123,13,13,1,91,13,0,01201,1
9e99eb4622c667735ab658d0b4d99963,98,61,3,228.66666666666669,98,0,01027,3
a01bcc3bf7810a62cac2b693393f5d2e,33,33,1,231,33,0,08230,1
cebc23834e52e3311f885a61b7994a4d,206,92,4,360.5,206,0,05041,4
fe22ad62ed25115a354c602078785637,331,135,5,463.4,331,0,05041,4
36f96728cb112c9c7f2195aff7b90053,28,15,3,65.33333333333334,28,0,05040,1
297f5ed3753ebe0fbb73cc13c3999c41,203,64,3,473.6666666666667,173,30,05040,3
056550e966f7b5d3d3a65d4fd09cbcc2,299,102,6,348.83333333333337,258,41,01026,4
feda4dcea675e4ce02e45162af37f04b,124,78,4,217,94,30,13830,3
588f5b9929ecf3b8f2c3dd5fb2e2a52f,143,68,2,500.5,109,34,05040,3
08bd8af8607e6b3e59911b8e13544c7e,30,18,3,70,30,0,05030,1
d741decb46ffbad513f9719c91165cda,35,35,1,245,35,0,04020,1
1b061e33d2daa300131684922eadf799,48,48,1,336,48,0,04060,1
05bcdffb4f5109fd58d96408c0d5969e,23,23,1,161,23,0,05040,1
e1f65f92a5a3464eedd99078a3ab7d3a,502,184,2,1757,469,33,01027,4
17df732c07eeab7e5c9b38da3f891599,185,98,3,431.6666666666667,95,90,01026,3
3288d8daf663b752dd016eb7056a5062,190,110,3,443.33333333333337,64,126,05030,4
6dbc570fd5192e71f609958b3bb1e505,164,78,3,382.6666666666667,164,0,05040,3
1de1439cdb78332e5ed32f838bb8e882,38,38,1,266,38,0,03050,1
4196ed4d84240bf9d7b86fc33575cc19,216,119,3,504,216,0,08100,4
1864c426882a640ec9e1d55261fe5ff9,260,148,5,364,260,0,01026,4
89ae4e5bd248a9134f7607dc36a2537c,25,25,1,175,25,0,09150,1
4addff3ae464d0306f7fb14aec72b1c4,32,32,1,224,32,0,03090,1
cff77248c12cfe4cf64a500c60b0e1fc,36,36,1,252,0,36,04060,1
860ac1ac1447260b786b3810c7be5251,56,39,5,78.39999999999999,40,16,05030,2
a5d4b77eccb8af8330a8e4a1a58d76f2,14,8,2,49,14,0,05030,1
6c359d4dad7b55baabbbbc74d2f0611b,125,56,5,175,93,32,05030,3
6ee840b1540753470a3a4810562b70b6,44,30,5,61.6,36,8,05030,2
2378b8c63ea288dd8fcf95512a8c4127,93,66,3,217,61,32,01026,3
d55f592d8fc4a418716763583c1c1e30,10,10,1,70,10,0,08100,1
0689cc685d43ea80fcc88d515fdcb758,270,85,3,630,127,143,05041,4
065725c3c5b1503f3f652fa24b280aa1,25,17,2,87.5,25,0,12670,1
d40b21e785e0f14baea2bba5da2bbbc8,124,111,2,434,123,1,10040,3
a286302991cb06741bfd45077fb3ef34,2,2,1,14,0,2,01028,1
67dfe6eda7322859537d3ed8efc6e2e9,31,28,2,108.5,31,0,09010,1
cda5a91e8083a0f4909228baef685a73,12,12,1,84,12,0,01012,1
9d2c6ee8c8e86011b24ea1a99d8a44a5,158,111,2,553,54,104,10200,3
e448cb0145fa72d9c13ab36407a86577,27,23,2,94.5,27,0,11040,1
897c6565ee9dbfca151977d3531d5aa0,191,101,4,334.25,191,0,04201,4
476d4c8e32527b414a84b3bec1d93a31,83,58,2,290.5,58,25,01026,2
1565386e3879c3d661555c7cdc37cda2,19,19,1,133,19,0,12501,1
7a5122f0a1f1e92ecb598b4bbb8d3be2,217,120,5,303.8,190,27,10200,4
af3b10ab985b61088b3e9de2cd800eb0,20,20,1,140,0,20,10200,1
b9d80efd84a390bba3b5d0b14c24a7ae,37,37,1,259,37,0,08100,1
c072b3575b5c6cb3223cebe9b17eeea7,92,69,2,322,92,0,05100,3
9a88006707229d212e675c821b333e84,285,109,4,498.75,285,0,11060,4
370002713a3b44809fcd81a207ad4d5a,46,37,3,107.33333333333334,28,18,06120,1
5a9982668fa851da740eb006ab6224b9,39,39,1,273,39,0,10200,1
79d786fb8e826f82d34f8a830b682089,263,131,1,1841,263,0,01026,4
965e8bf3b4dd56d8ded18ed2567af2ef,25,24,2,87.5,25,0,05100,1
6023dd86fc68af0ff59f47f2a7b751e4,40,40,1,280,40,0,13877,1
de620911ff51de5c9e28633d79dc5da0,77,55,3,179.66666666666669,57,20,05040,2
e4eec248bcba1d09935364980705f733,12,12,1,84,12,0,11100,1
b88e1d787f20414ff2e843e0487308ee,28,28,1,196,28,0,03090,1
f8299bfea98add411b23354200dae3d6,195,98,3,455,77,118,05100,4
e6b82ac0fcd22fc18337423d62801cdc,110,78,3,256.6666666666667,110,0,01026,3
884487f155caddab942ee06a976559bf,58,49,1,406,58,0,04201,1
fe5474017562a1a027e81c10fbe7768f,88,63,2,308,88,0,10153,2
c34e943b0998b385d62a8345f6140c4f,48,48,1,336,0,48,01026,1
1262da621317df74ca88531766beea35,37,37,1,259,37,0,10200,1
15c41f18c0a6674c8f48d817e1f4f4f0,103,61,2,360.5,103,0,04020,3
a58c5c49b14f107b8d7c4f71ee3c5b1b,152,124,2,532,52,100,05100,3
9c479e526eafdf35b419663ff4392283,117,78,3,273,61,56,05041,3
7f32cbccb59f6a793dad7826b860fcaf,73,57,2,255.5,73,0,05040,2
193f6c4eb2f0c101d7563277139f2ec6,32,32,1,224,32,0,05100,1
da80e20faa75b2728e213c1acf5e963f,28,28,1,196,28,0,03070,1
43ae4287c6b4eaad4c42da0c9dca28a9,147,74,3,343,92,55,04020,3
1aa8dcefdb9b118edbe7044bb68343fc,33,23,3,77,26,7,05030,1
0819146edf781ea2e99cc19cefbfcd46,295,114,4,516.25,244,51,10200,4
9d305ae3e68e02ef03eb09a8186baec6,172,85,3,401.33333333333337,104,68,10200,3
572793597c5f9aad3a653f1e2d3f73a0,28,28,1,196,28,0,12470,1
f7d68ad164798ea71496896a322cac9f,10,10,1,70,10,0,01013,1
a2736c9e6eed87e18e958a974fe0a7e0,14,14,1,98,14,0,05030,1
e7095181f5b680635e3ee566f97cf1f1,15,15,1,105,15,0,11100,1
764408c5f134bf59d4cfb95420f2262b,38,36,2,133,19,19,09150,1
3a30206c2c8087f05807ede287f3ce32,39,39,1,273,0,39,05040,1
33d47be5a720fd83ed8e0f1df96e9c4a,19,19,1,133,19,0,12410,1
b1692d37b727d41c252e7da3c86657de,59,41,2,206.5,59,0,05040,1
608e163507aa1ab11ef85d2b3007e36d,485,127,3,1131.6666666666667,485,0,05040,4
5f8e65ef1484783669b2ac53920aac6a,164,82,2,574,164,0,05100,3
7d8bbd5f37701d4a00a4e4ea096c3f7d,22,22,1,154,22,0,01026,1
a258b8d441a961fe125da85635d20a9f,35,35,1,245,35,0,12500,1
d34c9b4e3b4db2cbeabaa289f53bbe34,632,167,4,1106,632,0,08100,4
76cd276765ea3e0de78b54393a070a16,15,15,1,105,15,0,01014,1
7b2a6bc758063d82f8bb6f0a5bba59ab,24,24,1,168,24,0,08250,1
7cb21f41e404a4ce6afd8045e374e4a2,83,83,1,581,83,0,05100,3
9172ede1647384dc75ce7f69fe719a4f,75,70,1,525,75,0,05040,2
100b6fd9ff74947361661d1fdefcc9a1,48,48,1,336,48,0,09130,1
9f9b6e097a97b5fc9abf67e532f1c4e4,76,59,3,177.33333333333334,76,0,01013,2
e97a989cb2c2699025c77dc8905fbba8,40,40,1,280,40,0,05040,1
6b00f9c1f2cf7c1ce7e866fe13bc567b,198,125,3,462,198,0,01012,4
6f3a9ac7b7dcae2431f021b361de5082,39,39,1,273,39,0,01012,1
1294ff57cb23052f4d9a88e19d6a8b79,125,60,5,175,101,24,11080,3
53862e53a0ec790cab882a6bcf3a13c9,162,112,4,283.5,107,55,04020,3
62b85dddbfca4874ab67a40cf68fb5b4,13,8,2,45.5,13,0,12570,1
3b05af1ab3c18840d4e38c792e986f26,59,59,1,413,59,0,03033,2
281a24479f27c3c5bc2a07a68a433d74,20,20,1,140,20,0,03050,1
c976c20a649e06de0f35ad1af164ae2f,64,53,2,224,64,0,05041,2
88ad1c665ddd6089df82e47575d96d7a,50,37,1,350,50,0,11103,1
a60569b887f1ae4f807ccad9a8f344e7,22,22,1,154,22,0,01013,1
822511492e69b6c7d699c7205ca7073f,12,12,1,84,12,0,08230,1
0a3100233ae1d152eab1095d67dceebf,98,76,2,343,44,54,05040,3
1e24a68678eef02fc34c6ead6c548e7d,49,39,3,114.33333333333334,35,14,01027,1
1913073ee726a99543b3f09e32deafda,95,66,3,221.66666666666669,95,0,09130,3
82072080309c7507dc48b4722fd9af9b,289,156,6,337.1666666666667,214,75,10080,4
b433dd55423d07701281a6214bf882e4,14,14,1,98,14,0,01026,1
36aee3ba8b84d4719b2542d480ee2736,184,78,5,257.59999999999997,140,44,10200,3
da1cde57d232dcf0aaf0f5c9eda75521,69,53,1,483,69,0,01012,2
5018a47c66570ac0d56e27ea3a1dcd51,143,79,4,250.25,120,23,01013,3
f67020a202861e66c107d2042c62a989,56,52,2,196,56,0,02690,1
14e9afdea9d38457fff350237834b14d,226,99,4,395.5,226,0,05030,4
448a7b4688ff398b4a4c0a7dd6df2d87,7,7,1,49,7,0,05040,1
537f5f5f2ea4425dc9092034b6b92521,158,90,2,553,158,0,01026,3
fd0077b994f91a2207579f52cd5ef5c2,19,19,1,133,19,0,08314,1
44448278bf9ed17311bb3532034e289d,29,29,1,203,29,0,01026,1
b1ceadd4738d1b117bb1a9d0a2ca720e,173,110,2,605.5,173,0,05030,3
85dc7ce73839432f833b03dd1d65e586,234,178,3,546,179,55,01026,4
bff9e744a247a4bd921a558424d3bfa2,14,14,1,98,14,0,01012,1
671a7b7b9341262ff77851bf8a7580b6,73,64,2,255.5,24,49,01026,2
738abcdd5e8a3eb382dc3d47209843a5,24,24,1,168,24,0,04060,1
71950a01d31bc55e949d13100e4dc3be,263,136,4,460.25,218,45,01012,4
a22a715d54e618a6c7cb96b241d7fc60,5,3,2,17.5,5,0,10080,1
be944d5ac03b738e392ffb59e8d1e0a7,105,61,4,183.75,69,36,05040,3
d7cfc3e31b17ddc3bab336741041a4bf,27,27,1,189,27,0,01085,1
40428e8cabebcdcc5ba7db4d7d87098b,64,51,2,224,64,0,01027,2
b037d5b8edad570ff3b47dcc51c6aae6,46,46,1,322,0,46,09130,1
d058856dc7890ac4474aa0d4448bd377,15,15,1,105,15,0,05030,1
2ab430a3d5956fd518ff99bf952c4a29,467,144,3,1089.6666666666667,467,0,05040,4
548a39457b9fd7e00f823bedd1f1d251,120,85,2,420,120,0,05040,3
73ffedba02dfab0636ee78a6b3c4cd80,312,89,4,546,291,21,05030,4
bd9bf66d1154e204f727b7874d4f7b39,12,6,3,28,12,0,12500,1
04a79204a1d0ea8b14192bbb4831c108,28,28,1,196,28,0,05100,1
e8a1016c3facee91fdf30f5a7f0583d3,116,71,4,203,95,21,09130,3
d9a4a0a433911109757ac6ec98f63bf3,57,42,2,199.5,57,0,05030,1
01f89c9273cd4d1c16e84265b2a342fd,27,23,1,189,27,0,05030,1
c0ce1749b30ec16c3e0bdff0a11dc123,52,49,1,364,52,0,08150,1
b26e502822d2a36a5f8e0cfabe0b1311,51,51,1,357,51,0,08451,1
0d399ae7e26d67f4a591638c67220f08,12,12,1,84,12,0,10200,1
19c8bcf0c01b4d5676e794e26921c92a,158,92,5,221.2,131,27,05040,3
879cd1604c3895d649ce35de6a4a4826,16,16,1,112,16,0,02620,1
1499f9b12b93bbec748a5178bb8c4377,24,24,1,168,24,0,04201,1
71d5e5f6dd3d9423edd0a367b81142bf,45,36,1,315,45,0,08032,1
b3ec2116792def1d1f64333508e2c3a5,57,49,2,199.5,33,24,11040,1
8a790bff83acb9ca69f264b4bd82d7cc,70,50,2,245,70,0,10200,2
8b8d15482c03f0785cbcbe494b595cf3,13,12,2,45.5,13,0,05030,1
55bbba4b77e821d01b8bd50422baff58,56,56,1,392,0,56,01012,2
331c5cb6e22c527ab24c9f61cf0680b0,87,67,2,304.5,87,0,01026,3
b7ea40db986a9af0f2d28a577eed459a,115,77,1,805,115,0,09130,3
4c8eee269b54c37f8f1f7fdd06510f41,256,94,4,448,199,57,01013,4
2462cdd4edfa378e4530c65b9e78cefe,65,43,3,151.66666666666669,65,0,05040,2
0ae0e87e613c29d9bf5f8f0c3cc63abd,63,50,3,147,63,0,05040,2
b309c7868b3055f74ea60755cea423fc,22,22,1,154,22,0,02650,1
b405ba18d0d1971f6b22d1dde2583668,156,81,4,273,111,45,01013,3
79d661e6df398318f18cca295bf84296,28,28,1,196,28,0,01027,1
aead7b1eca0b2569cd6e68d96159cd1c,158,95,2,553,158,0,01027,3
1715d03482cd9118b96b9bc013f2c351,51,43,1,357,0,51,11040,1
d2bfd63f36c3c48882cc2dad0c735d6f,94,75,3,219.33333333333334,94,0,01016,3
65c9f6f1a747598de3bf99c339270490,62,62,1,434,62,0,10200,2
f66021e3b131432c4cf4e81001cafd94,266,108,2,931,170,96,08052,4
84088cc71acf168715e64d4f08910e42,223,67,4,390.25,160,63,05041,4
55a191ee8063a9597c2f35f39733a363,67,67,1,469,67,0,01016,2
3543e67346753c8c91a21f995704b57e,26,26,1,182,26,0,05041,1
b9486b280a3ca3635cac696226805989,58,58,1,406,58,0,05040,2
3e0eecdbe8b15cef549a1bbffcd96a67,43,32,2,150.5,43,0,11040,1
c8147782d3aafee32e1b9bf8f137c26a,47,38,2,164.5,27,20,05030,1
b07038592ecb0cb9e4b2a2741c1e61c7,45,45,1,315,45,0,09130,1
df09f48821b13800fc9ce9b77cb553cb,154,110,1,1078,0,154,05100,4
880343a18a97b91762fcbdc828b68155,241,97,2,843.5,200,41,01013,4
8ca6bd19e85ef51ccc31aea0f9a7b594,23,23,1,161,0,23,01012,1
d63744f15e5dbf4567617826e1fe814a,20,20,1,140,0,20,05040,1
ffb7cfe63297cf9b2047fdca82713259,107,34,3,249.66666666666669,107,0,03090,3
dc719b2ed143e3df3edb9672c75cf564,52,52,1,364,52,0,08032,1
1e0eef8c3bf451615fafcd7acb3690b2,21,21,1,147,21,0,05040,1
fee4fb2e62168d7f0c77d85653b06aed,406,138,3,947.3333333333334,406,0,01013,4
b009dd29926715cda5616986cad7732b,8,8,1,56,8,0,04130,1
bc3e9b69dcaf57a01b0aaed9a69c4cf4,65,53,2,227.5,34,31,05030,2
e8a1d59718652b283ca28d3eec36f435,10,10,1,70,10,0,01028,1
6ac6cc689dfb2e4c1047db1d312e74f5,24,24,1,168,24,0,04060,1
3df553e970795344f2f85b71d4cdd2df,33,33,1,231,33,0,10200,1
ddce0db4b1b2f9780ada7a7826a9488e,13,13,1,91,13,0,04060,1
d2a4c76eb442009a810b5085103c2a2f,27,27,1,189,27,0,01026,1
d76ea1af00a1532499d3c07efd4dff3e,1,1,1,7,1,0,13520,1
10727ad15be65d615aa9cbce2830fa3c,80,53,3,186.66666666666669,32,48,11080,2
9defc1310c626067dd2025b6db9b29b0,47,47,1,329,47,0,01012,1
3a97b43ad39e267219608720af6c8b6a,103,53,2,360.5,103,0,11100,3
8b1ce45066101033edafd5de46027c4f,366,202,4,640.5,217,149,05040,4
7a6fbd2bf8682353a81d4b31c953f0bd,25,25,1,175,25,0,01012,1
038ee7262ed2db2a087757e504c650e3,34,33,3,79.33333333333334,24,10,10080,1
3ca69292a9cce4143f03cc9a905070ab,35,35,1,245,35,0,08100,1
211f838bd013fe27ebc14f0ea521ee75,242,89,5,338.8,154,88,05040,4
fea71a17bcaac7638122736d1595b243,100,100,1,700,100,0,05040,3
f254dfc49bccb2f444da0d3597d958dd,46,35,3,107.33333333333334,46,0,01026,1
e3966fb8d6d0672e9fe79d8c26be1a6d,56,56,1,392,56,0,10240,2
160d866ae75310f21bb94d76b84eee7a,62,62,2,217,8,54,05040,2
31976b9b89d0510106577e65d0da950d,182,112,3,424.6666666666667,140,42,03050,4
6d172e3a84ad12ed64a2a166217fab2b,402,146,2,1407,264,138,05040,4
bf9756f2fcdee86d1648a67149767a30,19,19,1,133,19,0,11100,1
6f73a52c2005edcbad564adcc2ce6975,80,46,4,140,62,18,01028,3
e70507b8cd703b2f177ed0c97c3f4ecd,113,83,2,395.5,113,0,05100,3
0107008d30fef8fa7f0f8a2641e753b4,62,62,1,434,62,0,10200,2
97f6e5fc6f33750f8f00f2f7e0dc2a3f,319,127,4,558.25,261,58,01026,4
9e88a525bd9ae4ae3bf0469908e9dc1c,47,42,2,164.5,47,0,01012,1
9e164d5c575feb7b5d593069aab7a19e,90,71,1,630,90,0,01026,3
d1e01b8da324ae1cc692bb0b53ab76ae,182,119,4,318.5,125,57,09010,4
86485d8270d7bcef2cca5b1dba983215,27,27,1,189,27,0,01027,1
c87738e5659bdb61bcc02c8090814535,10,10,1,70,0,10,02720,1
7a403e227fb1b1971a95945a47686769,107,50,4,187.25,107,0,10101,3
838c212b45b2453d9318181251b0bc21,88,68,1,616,88,0,05100,3
6b39f47224238573f6ceb5e2070d7a60,17,17,1,119,17,0,08032,1
f36974df6366c3d699f15ddd06867b21,15,15,1,105,15,0,05030,1
6433debd82517392f57b520d29b184f1,5,5,1,35,5,0,09010,1
95029908881b3c01e539ba4850a73c11,23,23,1,161,23,0,01012,1
60a8a4c40628cec69e70b857f555f420,54,45,2,189,54,0,10281,1
1fcf158e754a87e2c6532ab6cad728c3,242,140,5,338.8,203,39,05040,4
3aa330e55cf68ce5f2bfb49f94e058a3,12,12,1,84,12,0,08052,1
2d2ecd0b23709653249cc0105d32299d,17,17,1,119,17,0,01013,1
b685f0192c9adfe99f88a147e2062b7e,44,27,1,308,44,0,05030,1
0c68358bd74a3df82c2870b9b5e43cb0,53,49,2,185.5,25,28,05100,1
b484e81d4a152813ffd503d1f75c1ca8,65,65,1,455,65,0,08051,2
e9e99432d052ee863ae8d2b9296b03fa,157,109,2,549.5,157,0,05040,3
5bfbbf8baa26b2b2787655210e43e51d,250,109,5,350,208,42,05030,4
fe7dd267e5f6d658f8fefad8d5a1820d,37,37,1,259,37,0,08010,1
339911d50d614a358d86c7a1904524c6,156,79,5,218.4,131,25,05040,3
dc9e5c55b305d7dd31beb06d7ffb4a94,11,6,3,25.666666666666668,11,0,05200,1
e570768f60a493edf38a17d6414fee2d,51,34,2,178.5,51,0,05030,1
734dab0cf658f8ce18ae98720f6ddf07,385,152,6,449.1666666666667,300,85,04060,4
a74dfddf3ee1c7d8b33e2da0bb4b2de5,64,64,1,448,0,64,01085,2
cdfbd9bd316e2a60138ddbd747c342d2,212,122,6,247.33333333333334,165,47,01012,4
9ea401bbc4996e6688622becca63d8c3,68,43,2,238,68,0,05030,2
c55ec7df41c0f5c7033a8d6225ae718a,69,49,5,96.6,52,17,05160,3
79de8e4572103439d7093c2d62b8fbf1,151,109,4,264.25,151,0,05040,3
a104a356de0fd3035e3f3821b2e6391c,79,70,1,553,79,0,03050,3
f6750a6b34573c28bbb127a5fa045d17,6,6,1,42,6,0,03070,1
bf81da02d2e04a318e1d7c771306c11b,83,63,1,581,83,0,09090,3
42439be586eeaec69035811196fb6de5,170,81,2,595,170,0,01012,3
83877ea6023a340698edccc1c7aaa8cc,368,112,3,858.6666666666667,368,0,12670,4
f79dfd3b53f99d4fbb844a8cf4e72c6e,29,24,2,101.5,18,11,05040,1
c84bc6a6a94ea348306b1400b32cd15d,47,40,3,109.66666666666667,29,18,05030,1
eef12bb39768aae84dcf458802182fcf,89,68,1,623,0,89,05040,3
e54d5c2fd1d9570a1c47ab65423e56b1,481,155,5,673.4,293,188,08032,4
633008b9f4d7ed9ceadd2ecb0c66eb48,43,43,1,301,43,0,01027,1
f525d984faa084e01ad969a6db1e4128,37,37,1,259,37,0,06100,1
416b29c4e87d3282378566c010b36806,38,31,2,133,38,0,05030,1
9aa18aa5821cf6a0d6d9a0878a465e8d,21,21,1,147,21,0,08090,1
ae20e86a95efc668190fa1bf616212c9,27,25,2,94.5,27,0,10140,1
465e5cb6c6861a88e5e5b079b31649e6,48,48,1,336,48,0,01012,1
ee16c3adb2d6bd84e0b405f2b6154bbc,489,138,3,1141,489,0,01012,4
7593c390f3de91955f6eb191154bb574,34,34,1,238,34,0,05040,1
5710b5278bd63b61b13673aeef7038d5,30,30,1,210,30,0,10101,1
63145e21000f08c4c718384f9b2ee1eb,83,60,2,290.5,83,0,05040,2
ad710462be606c7083759ce13ec30088,26,26,1,182,26,0,01027,1
c114277c608eda0da27537315a32f2e4,17,16,2,59.5,17,0,01026,1
52eb1dfb79e67fe7ca4490842d5942af,65,51,2,227.5,65,0,05040,2
850d4ddb9bd34b0c88fe3d655a889e2b,31,31,1,217,0,31,09030,1
24d65c9f886555713ef18450322defe4,27,25,2,94.5,27,0,11040,1
044b402b6fc4e1fc85ca68b63f7c71c8,95,66,4,166.25,95,0,05030,3
4e29dddecb5bdf000cc73d52567ffb3c,103,73,2,360.5,32,71,01026,3
393673137f37a0391f04d9d30e461e71,40,40,1,280,40,0,09021,1
4e8277b8568aa186f0b406bb70875baf,17,17,1,119,17,0,11060,1
9a4d81069d4aa0cf63ad8d64bd1d38af,155,108,2,542.5,74,81,01085,3
14284423496f7d28c1c4e647fe9bb92d,307,158,4,537.25,198,109,05100,4
be290d825281b1d603fbc151c71cd69d,44,44,2,154,44,0,13877,1
e31a74562610d97e49429b51ef4c7715,207,101,3,483,207,0,05030,4
35ac4dc0fdb7a41d03a18ff2a9cd0605,22,18,2,77,22,0,05040,1
5f6b3671ae594a73ac0c8fbe573d9045,25,25,1,175,25,0,10200,1
d456ac393d4b562ef09e211702a24123,290,128,4,507.5,252,38,01027,4
cf5f4e74f603b18d91b0e41bad1c4f92,52,44,1,364,52,0,04060,1
d0c14f1e2438a5aa0a1df6978a84adfd,41,35,2,143.5,41,0,05040,1
ee913a598bd7ef3a72f46e9d1d7f15f9,28,28,1,196,28,0,03070,1
2fe69f4e95b246952a93c53f1da44965,69,69,1,483,69,0,09170,2
cecbb4156d51a993e5d4887d11db4e77,243,107,4,425.25,192,51,05040,4
f7fc404c490ed340245a837ec95b7a01,51,44,2,178.5,51,0,10200,1
efef810b7ff01c79b1137b378e0421b9,33,30,1,231,33,0,12650,1
b7684eb690b77134d5d1b6aa3777d75a,47,34,2,164.5,47,0,05040,1
7f7852c87e20331d710b4481847294e7,18,18,1,126,18,0,05040,1
2d54b04c02e31619fdbbbf1f48e78955,19,19,1,133,0,19,05030,1
3e60e01416516a84d2f4cb497e5a916c,78,59,2,273,32,46,05040,2
065739b0c8d2aa9db22304d32d692ff9,30,30,1,210,30,0,01026,1
e29861d198a332fd6c74a000e8137ea2,102,81,2,357,65,37,05040,3
a2ce9a9af802b6de0c5d15fcc114225d,66,46,3,154,66,0,02750,2
e2a50d5c36e16db3ea65ae045c75524c,7,7,1,49,7,0,02650,1
5f25c2c0e880179c9b833e4f02d42b55,100,67,1,700,0,100,05100,3
685d7efc40b7d3c1abf9f35276972417,17,17,1,119,17,0,01027,1
24495ad088875e9e93dfde548a897ced,30,30,1,210,30,0,08230,1
525606239fc7452cfe5cd5b1fb1e427f,158,86,3,368.6666666666667,158,0,01085,3
28af4016a4f98aed96c4c1e6e3351ce4,62,61,1,434,62,0,03070,2
052b7ca649c8d9b643a76ac6043fb0d7,279,196,4,488.25,245,34,05100,4
64fb9844fa6d1c086ec10b27d5bd34bf,27,19,1,189,27,0,05040,1
e381be3d5379e6f2f95c3100eea39903,24,24,1,168,24,0,01026,1
63c06ee4026cbebac9a67af2d10b00ea,27,27,1,189,27,0,08010,1
5cb6e8b0d9e6ae76a7fc3a232fcf9fa6,8,8,1,56,8,0,03090,1
e2f45fed31bf589c9ef76743bb8d3d17,23,23,1,161,23,0,05030,1
f3ae3a63f8ca59bbc03ecaceb7703a42,186,117,3,434,79,107,10240,4
90e5513486a44a33bbb845a1312887b6,407,105,4,712.25,245,162,05040,4
60ab076e1ebea550781bf870d8fd9ce5,148,77,4,259,98,50,01026,3
24ed8ea7346d6bd7d8cf15c00adb8163,122,94,3,284.6666666666667,108,14,08150,3
ceac88130ff794f1145386cbee3866ec,18,14,2,63,18,0,05030,1
09da28a2b99e15618101609f520d5297,19,18,2,66.5,19,0,05030,1
988bcc187f4d594c61fb25754fa400fd,18,18,1,126,18,0,05030,1
35b2dcd3eac8cd9c16fbd700025d461a,18,18,1,126,18,0,07131,1
2aa913f3631ebfd1e5c390ad1be3ecaf,784,148,2,2744,784,0,05040,4
cc0dd67c669c929e002e8e296edc439a,63,48,2,220.5,33,30,04201,2
0ec8ceb5812b9efe8ff096618c501ccd,49,49,1,343,49,0,01016,1
4c6dc22347c95566b1d9cf3db662b403,16,16,1,112,16,0,01027,1
b5b6fdcd5ce2bc87be0e0898357843f9,98,73,2,343,98,0,08100,3
68a90213a82c3e099494d3938a6f62f5,29,29,1,203,29,0,10200,1
469294727b67a0c1a38a267590f795f7,22,22,1,154,22,0,01085,1
d4c42b81eab377ddbdd5ddddbf1afe1f,84,68,2,294,49,35,05100,3
da24d93d4b026a86df8121593597b13e,44,40,2,154,14,30,08032,1
d95ac215cfdae0b13c81a563b6f082de,18,18,1,126,18,0,11040,1
2947ea72ca103a5086e25e7037866cf1,45,45,1,315,0,45,05040,1
b856784ebadafb33d6cf8cc69c1fb669,19,19,1,133,0,19,03090,1
f86535051ccc5de4aee0a71dd2126ad5,10,7,2,35,10,0,05030,1
b391a0a6f4afa8a3cb18c67e8ef760e2,23,18,2,80.5,23,0,10153,1
7908688e2be9f5a391fd5c8aeb026963,55,49,2,192.5,55,0,09130,1
60017c18e434f22f75c54d5c0a3e5a28,31,31,1,217,31,0,05040,1
76a72043bdf57e92e65847752185b255,122,53,4,213.5,122,0,08150,3
30889f5e829aa9bfb099ea8f84040414,151,77,2,528.5,110,41,01012,3
d556baccf1be5d789cadd88b8a7903b7,223,113,4,390.25,198,25,05040,4
1cfe3d33a6b83c0904b505e1d0c528eb,149,72,4,260.75,149,0,06100,3
def789a410a66a7fe8065c27f1241039,34,34,1,238,34,0,10028,1
7dab8ff9bb4c77a6c318e39a301e9bdc,26,26,1,182,26,0,10200,1
0d7f7ea5d00b5b0758942e0f2109b064,214,106,5,299.59999999999997,195,19,04020,4
6fa11016a6cfa237715aea0943156ef7,373,121,4,652.75,373,0,05100,4
18a0b83af6f581b69664e555b11799a1,85,71,2,297.5,46,39,05040,3
d03173d6f6f5e4fa8970ed18251124be,151,74,4,264.25,99,52,05030,3
02e7729c39af023037d6668521531a3a,272,160,5,380.8,227,45,11103,4
613015637c26ad092738c95ad37fb028,80,54,3,186.66666666666669,80,0,05041,2
1a2322d34b708174f4e6ce48a9fb1579,21,16,2,73.5,12,9,05040,1
759616c9184ac3e9cc19b04402b5c06c,18,18,1,126,18,0,03070,1
e2642c6807e9f2eaa1eeea8e157f125b,47,37,3,109.66666666666667,21,26,04201,1
c45e0b33113715d7e1dfb309f7f71fd5,141,115,3,329,141,0,01085,3
1c5df01e0fe9caa3a96c5caf8896db85,12,12,1,84,12,0,12500,1
53c4fa596e60194234d9fc56eaf4af9b,6,6,1,42,6,0,05030,1
068c017dfc3ae93ec8559f593896cc6d,22,22,1,154,22,0,11100,1
1e329343538377085566c9ff8ec078dd,3,3,1,21,0,3,01017,1
f4d83783531e99fab16ee52ae8af51c6,222,92,5,310.8,183,39,05040,4
509eb28eaf2539f5068ee004a9b0b7c1,48,47,2,168,21,27,05040,1
0007144f84dec495b2efa9c44fffaae2,2,1,2,7,2,0,03050,1
9ebc71360d6fdf60dce41f2e99880500,40,34,3,93.33333333333334,40,0,12410,1
548a78c340a8a9ac1d3d53bd2c436ebb,54,53,2,189,54,0,09130,1
1c8bd98a91834d65110757fb0418a3dd,61,45,3,142.33333333333334,36,25,05030,2
695d6f448f28eeaeb59277244bd2ea49,210,99,6,245,185,25,05040,4
843bbfefa92758223def6c1ae9998a77,85,70,2,297.5,85,0,01012,3
4179c5c1eb159642d832001741815dd2,18,18,1,126,18,0,01013,1
36862b25d582e84c4428f731bbbdb688,31,29,2,108.5,17,14,05030,1
6f969c5a55d38c4589c0c986e5bcaae5,27,27,1,189,0,27,01026,1
ebeadf2c1f64ef88a22fcaea97415194,60,60,1,420,60,0,09010,2
dffe6fceb22e1689a8a4e95e36c134c2,180,79,4,315,152,28,01012,3
744f6202fddc8731b57b679a50687e28,24,24,1,168,24,0,12500,1
cf4696edce7f2833e5c16fbd98b2a9a3,19,15,2,66.5,19,0,04080,1
cf3ac128d4579cd46f0d8f0c28ac2116,38,38,1,266,38,0,01026,1
5a1d5080d8ac47316a1f70e0b9aff85d,27,19,1,189,0,27,05030,1
91790d330f2e8993a588b15b293e3cfe,14,14,1,98,14,0,05030,1
d540924931bc01c9707bf05b26fca3ac,32,32,1,224,32,0,01012,1
e76ce52bb54de37d84319b7330564d79,108,55,3,252,108,0,08230,3
02abaf7b7c62daa18c673f44be9f1eb3,58,40,3,135.33333333333334,42,16,09090,2
292e7c0a1d56b59c8471a96047c3f4ba,19,19,1,133,19,0,09030,1
3b00ca7d93065ac17238d7c81095c582,28,28,1,196,28,0,04060,1
e14dba7264599aa087716b7844593228,55,48,1,385,0,55,06100,1
1e3643d3ca150bf88e2d25216e0ad140,88,59,2,308,12,76,02690,3
45030e00139ee098b84ea761938fed57,18,18,1,126,0,18,03050,1
2b72e806103811a8573940998e782af8,174,75,3,406,174,0,05040,3
620e8010c846b55968617b3fef1a81cd,209,115,3,487.6666666666667,209,0,05040,4
a9034a59af6172dc1042e5704a7eb524,63,63,1,441,63,0,05040,2
8ac45582401f0137f2d5a8d2d69275bc,89,51,2,311.5,89,0,01026,2
53b99f29c39beefaf3222f8ff8579644,10,10,1,70,10,0,05100,1
e4a5c7946491c32a70838c31588c8dd5,61,43,2,213.5,61,0,11040,1
654a32388bc340e2892b7bf5d84231d0,42,38,2,147,42,0,10200,1
3c5e482939be7e619bc4f2c338488939,62,45,1,434,62,0,05040,1
8a7a3e5c43ab2f881d271ef09ad9229d,33,31,2,115.5,33,0,11140,1
3c8dd491321a3f641445b94597cc4727,28,28,1,196,28,0,01026,1
df6eee9475407d3b1bb6d51413fd593d,66,48,2,231,66,0,04020,2
0647b700f8bb37602e39b9955fc12a72,99,99,1,693,0,99,03050,3
3131d022ed680815e162ed26ad8cb456,22,22,1,154,22,0,13930,1
5e464938379cd7f3a7a7aeefcd4a672f,69,69,1,483,69,0,04060,2
b0ced32cfb433e270a59b706210fc80d,31,26,2,108.5,12,19,05041,1
2d6d9e307ae45b8d4ef82e5160f8acdf,92,83,3,214.66666666666669,33,59,01027,3
1312f593cac0e1fcdc0357fa98978b6e,35,35,1,245,35,0,12500,1
99bcb64167886461a7751318f7e0c2a9,37,27,2,129.5,19,18,11060,1
3db7d83d73ed3dab772d85d6227ffe67,61,49,2,213.5,29,32,11140,2
ce35c7dc3a1706449904957139ab198d,157,94,3,366.33333333333337,102,55,01026,3
fc0f569d25a3cdfcf2c41418e551bff3,25,21,3,58.333333333333336,25,0,09170,1
acea51e0ddc6ce3d2b94e956f4e56583,98,90,2,343,71,27,05040,3
abf00e66f695851e6650959e507ad765,18,18,1,126,18,0,05030,1
d6e3f33ff7df564291974b8654bd0eeb,35,35,1,245,35,0,01027,1
60e9ba894b2537fec57e96e4e61009d6,98,49,3,228.66666666666669,98,0,05041,3
51fa96422ccde0dfcee37e487aa0b8df,31,31,1,217,31,0,01201,1
d06ce85b4d1851be05b761c12a8faa57,44,44,1,308,0,44,01026,1
31738d7c094dab70527f330a39db2258,62,59,2,217,62,0,08100,2
e3703c72ec381bae06e5b10df4c6ea0f,17,17,1,119,17,0,01013,1
9c5de4bf538d56c6f25e4805a76391ce,91,72,3,212.33333333333334,91,0,05030,3
763588f65cc64a5a7af9e8406ee67518,20,15,2,70,20,0,11100,1
59ca2d25db3debc71dd7dcc79800f08c,59,49,2,206.5,30,29,05040,2
2907cdcf2dde84b11088c1ab8ca9b427,411,151,5,575.4,258,153,05040,4
a81e267081f0e38e853898f846ba00e7,234,70,6,273,200,34,05040,4
2ababca822be540f7b33e1704fb9cd38,24,19,1,168,24,0,01012,1
49298b0ec911bd4c46a51de49f5d2a18,71,66,2,248.5,71,0,05040,2
41525ffccc8f4d0bbcdf864f054a05a8,17,17,1,119,17,0,10200,1
914ed52a6235aa8ada88fd61f783685b,129,72,3,301,93,36,01012,3
b7592e52faac02307c548a3f11f9ffa4,202,138,4,353.5,149,53,01026,4
723404f934ee011519b0c2136ba497f8,31,20,2,108.5,12,19,09110,1
6de6cccb857468f9a1ba050409e4f5f5,10,10,1,70,0,10,05030,1
4712faa64c1547475181efb6b2aaa04b,357,144,2,1249.5,357,0,14301,4
b0d7320df73b7a6f4a790269364de4fc,75,67,2,262.5,38,37,01013,2
4b5cdf34537fbbfa71ecbe69dbb79617,120,74,2,420,120,0,09091,3
b208658f9f86324fedebf3ea95cf3864,67,43,3,156.33333333333334,67,0,12470,2
0dc47f1c4b6472ffe685db7ae3b162a1,129,95,2,451.5,60,69,02691,3
7b1a4129cab8770821668e6caa5d66c1,26,26,1,182,26,0,04031,1
e7079d419d02dd9735b5fcb0d6c2df34,48,48,1,336,48,0,01012,1
b56a7b607fab9fa7adfed0a10bbea6b0,1,1,1,7,1,0,12500,1
2a7444d0c792612c93e9bd1727244e66,213,148,3,497,213,0,01013,4
b4fda3a7976e1d693e7f4b5ffc438f11,37,32,2,129.5,37,0,11100,1
48965349bcd0e9a841833cb98674f89c,24,24,1,168,24,0,02651,1
833891b995140cb56770e1b7a940edef,106,91,2,371,106,0,01012,3
8c644dd659efdfcf367539fec7ef770a,188,103,3,438.6666666666667,188,0,05040,3
10222aa95dcc51a5bace3ebcd9270594,39,34,2,136.5,18,21,01085,1
0161a124a13a10a36bdfc42004bbe62a,30,26,2,105,30,0,01012,1
0dc9803510d054051862dae3cf75779a,21,21,1,147,21,0,05030,1
cc03c85748d272aa2642b63784d74b42,223,115,3,520.3333333333334,223,0,05040,4
01c268cd65305f00ae691903f30ffe98,37,37,1,259,0,37,05100,1
017ea65830268bd44bf6e5d209e72455,128,87,4,224,128,0,05040,3
e91fb21d24af82dcacb14c3ec4b3127c,365,194,4,638.75,333,32,04020,4
e18016abe5eaeecf7ff05044f21f07d1,45,44,2,157.5,2,43,05030,1
b1153024231706182d60cd9712a5ec2c,29,29,1,203,29,0,12410,1
9674eb325aaaa4f0d96bbeb607dc1eea,130,84,3,303.33333333333337,89,41,01026,3
c9c08591270a93950f3ce8e542cbbe17,226,113,5,316.4,226,0,01026,4
6836e0e9b2f04622693ef23441a068b3,35,35,1,245,35,0,05040,1
fcdb4b8ad8e0b0667386503d1a10b2d6,32,32,1,224,32,0,12610,1
0e434f0d3629c28a12faf520fca4a18c,137,86,3,319.6666666666667,92,45,09130,3
aee3a1553e3c46d23226666607e37fce,15,15,1,105,15,0,09190,1
15121e0b5511aad68e870d733f1e2633,24,18,2,84,24,0,05030,1
76486c383b435ad1d2228732f78d5d53,194,99,2,679,63,131,08090,4
2c7d0bd7c974ad3fc7f5fbca50cbd701,10,10,1,70,10,0,10040,1
c91de09db4199b9b06c0ff7d1375c365,130,98,2,455,130,0,01026,3
487cca323e55b58e5dcb5c27c8ed8426,40,40,1,280,40,0,05040,1
0646f18b21c90060e0d6ce1bf2657270,5,5,1,35,5,0,04020,1
9b5419cb890f7755f30e760ce47f0bae,96,79,2,336,60,36,01085,3
f278b9a566ee8c141763d5488b6fdf5c,23,23,1,161,23,0,11080,1
6ca127d4c50d18e84cf7f8b2dcd5f7c0,304,118,4,532,266,38,01085,4
e8474d1df6723df5704983cf269c9640,225,125,5,315,183,42,04020,4
ad73eae3052a95a38d3facdbd9fd47d5,107,49,2,374.5,35,72,01012,3
bd1b70aca10b57c7936623952c799195,125,75,3,291.6666666666667,125,0,11040,3
39f7cefb8fc47c55ad4e397e761448c6,1,1,1,7,1,0,10281,1
9907e2ef213dc18d47aef7e61442654a,84,53,1,588,84,0,03070,2
21650e7c4cc626f4b4dc1ad7ff89bc86,27,27,1,189,27,0,09130,1
647a0f5f8a991975c83645791ba05b1c,207,130,3,483,165,42,05040,4
b8876b43574fa9486493e1c624ffcda0,202,71,3,471.33333333333337,202,0,05030,3
a136714e6dafb4e220f39c7473b30ec1,465,209,6,542.5,404,61,01026,4
6d5b06d6664c0753b331d2eafffdd26e,34,34,1,238,0,34,01026,1
2b3051e4eb6bc0151bb9c88450b1ffaa,86,72,2,301,86,0,01027,3
bf25b7344baa04a50fe7d67b338099c5,239,108,4,418.25,189,50,01027,4
a9f5faef181ff95c3862c6d7a1a01a92,30,30,1,210,30,0,01027,1
5be17d528c745dd3f823f3ea7afe27df,15,15,1,105,15,0,01016,1
28662cf5a6219a4f72fb9e00eae15751,37,28,2,129.5,37,0,13830,1
e6072f878c47c49868025cc3fa2169d0,70,56,2,245,70,0,02756,2
f1ee02228aef05db62d1473032f76909,49,33,2,171.5,49,0,09130,1
4459433460a6e39ac2558be206fd3005,312,131,4,546,185,127,05040,4
35b566203e9d2edf1f6770de0e3386eb,14,14,1,98,14,0,10101,1
9c4c4bd664ab9c1e5d9ff95ef93866a9,333,161,3,777,162,171,06120,4
af7883d528a79caae8b2469947347199,1,1,1,7,1,0,10261,1
0ee8ea86a7439ee5666d8848798a90f3,10,10,1,70,10,0,08032,1
3dc56112fa5eadc1af7855c7646abf0c,141,68,2,493.5,23,118,01012,3
8898ac57605a116bbcdd20032566219d,356,127,4,623,326,30,01013,4
bbd37b2585a5ff2efba878d90c4a61a8,77,51,2,269.5,77,0,05030,2
b877a4b7ac521b9aa35fd03a7a71c519,88,66,1,616,88,0,01026,3
a5301ab5f87880b25359da5ad9e2c8fa,36,36,1,252,36,0,12590,1
3d632007dcaf8ffec17c1afb702104a0,162,98,2,567,162,0,05100,3
ed739646b5465357279e0ee589d7cfb3,25,25,1,175,25,0,04032,1
e7eb415f2010fba1afa004d593cf48ee,290,131,5,406,166,124,01026,4
74a5f7dffecbcc23a866046aad379087,27,22,2,94.5,27,0,10240,1
ea63b3649f7212ae22b6ca110861e169,15,15,1,105,15,0,09130,1
9378ea0eed0fc6d6e0c1b3c1e9084a69,57,37,1,399,57,0,04060,1
ebf0cc271daf6a7f7f1f9e4d77f36667,35,35,1,245,35,0,05040,1
4c677e07761f32a3ce91a55cc9c0f20e,29,25,2,101.5,29,0,05040,1
db17a7cccc7657066a0eca8d7001c496,59,32,3,137.66666666666669,59,0,05030,1
60f091cde64d1d31aab7bcc8113751c2,40,29,2,140,40,0,11080,1
b777b49ea683edea0151eee5e80546c2,23,23,1,161,23,0,05030,1
a65e1773ad0df6f893b9da3766b7b9b2,24,12,2,84,24,0,03090,1
4c17c747c22264ad03f153955f407aee,20,20,1,140,20,0,10200,1
cd15a3091acc9093f4848e40e21efbd0,127,79,4,222.25,127,0,05040,3
934463bb0e711075793df1b6475e9abf,205,127,4,358.75,205,0,05040,4
623795852521ea97368f87d24e2268a4,48,40,2,168,48,0,09130,1
ea92008616e3d817ad38dbfd6be2042e,24,24,1,168,0,24,02650,1
c323446433cd67a484ad30c844fe87c2,96,52,2,336,63,33,05040,3
e3d1c5abe4b0272ad52800bf0d8728a2,323,159,6,376.83333333333337,311,12,05030,4
c2d31543d7b9cb69e0b8b4a728aceb7c,507,147,3,1183,430,77,01012,4
df91bae826c84fbabb966afc05ebfc2e,63,53,1,441,63,0,13953,2
e6f8392231ed6fae282207b913630ee7,54,38,3,126,54,0,11040,1
1653b57c39742575cc926fde008cc9a5,105,58,1,735,0,105,11140,3
424ce1d79bba666f278859391b58159a,389,166,1,2723,0,389,01012,4
dae05b592eba9eaa15d076fa6bbe1c56,49,49,1,343,49,0,01013,1
dc4041990cc4b77f7c5e4694dd04c551,34,34,1,238,34,0,01201,1
5d728407ccde346d615065f6c8d7a3fd,178,110,2,623,178,0,05100,3
fb4950064ec23df10cbd7f35a0083eff,97,54,3,226.33333333333334,97,0,01026,3
b225d5a0ad7530e52e8ab507e57c81ac,9,9,1,63,9,0,05030,1
efe60011b7ec9b2003692374a5fae34b,7,4,2,24.5,7,0,11040,1
b62a042b0a34875176d8e86b6950310c,342,162,5,478.8,342,0,11040,4
add70ed2a36c68ac56256fe762f9549f,44,42,2,154,44,0,01013,1
9958eec2d08369f63ba2cab678bbf604,216,132,1,1512,216,0,03070,4
af96fea1bc0e2d5693fe4666b93fffb2,132,73,3,308,88,44,05040,3
771ca1f8bd12e7403038fa3dcfee2a1a,14,14,1,98,14,0,04060,1
7660857b0b7a6a20b745e44658902912,409,186,4,715.75,409,0,05100,4
6bd2bfc836ec474b89e82d9b59c776d3,213,74,5,298.2,197,16,01016,4
6b777c8e26ba31ffb7861cb7727e3d63,39,31,3,91,31,8,05030,1
709f4562b4ac192b8597797460b4d581,126,62,5,176.4,126,0,04012,3
5cbdba6673765b991e6499ad664d0580,7,7,1,49,7,0,10080,1
45ba11e58ddaec43812a53afada64244,55,55,1,385,55,0,05040,1
e0ce355c5a57956bf282eb7a38ca2969,133,61,4,232.75,130,3,05041,3
c40f3274aa9706263e11201802867026,72,54,2,252,72,0,13830,2
3c921557a65da592024539d3bdb269d4,81,73,2,283.5,30,51,05041,3
612c41ec195448ea3870b74ab1f63c3b,25,22,2,87.5,25,0,03090,1
ec567770feac6b23d3d229011d5d477e,28,28,1,196,28,0,08100,1
0c11802f096319270c54a55315aa650d,53,39,2,185.5,53,0,08313,1
4dc54c82231d3d7a717be2370f12004c,96,84,3,224,45,51,12590,3
c4dd0caae5d3832024d101fb32b3f4ba,37,35,2,129.5,22,15,10220,1
acae70766318be220dd2b5eb35a3d230,10,10,1,70,10,0,08230,1
6fc0a4157c7cded6bac12cac98daa1a5,134,92,2,469,77,57,09111,3
f4302a47adc2b2e7f62438f8a2b180ee,24,24,1,168,24,0,01026,1
5a81a522b92e4b2d1b9271f748c13536,21,21,1,147,21,0,05030,1
6636553a676f3ec4b7a7ac2e2f3702f9,37,37,1,259,0,37,11100,1
9dfdefa1963553e67e225e3f79ea0461,158,101,4,276.5,144,14,08314,3
dcd551c62cc1b6b0c392e49bac791e97,47,20,2,164.5,47,0,05041,1
89246586483a68852e761c8492e9cafb,25,25,1,175,25,0,01012,1
58849db49d72e5d2a6469ac6be2e4cb1,44,44,1,308,44,0,09130,1
f210150fbd7b100fcd2c278e32f4ba9e,142,76,3,331.33333333333337,142,0,02756,3
f4a08ddee974b9e1da3c0128b1f37451,36,32,1,252,36,0,10200,1
994767fedab86909640f20a9a524b2ff,33,33,1,231,33,0,05100,1
6081c93951c078fcce78ec9f2340cce7,42,42,1,294,42,0,05030,1
1264b29e33a51d110424fa7b7fa26250,34,34,1,238,34,0,01012,1
33a2fad9a325a2dc6bc8ec17e1289f41,85,48,3,198.33333333333334,55,30,08090,2
39af8600e31d5f87f89e4f0e70b67a23,212,128,2,742,164,48,04020,4
bdcb97c547197b259d79ccb2c87831ae,75,43,2,262.5,25,50,01012,2
464b953d10599764a6387afc0e3ea8b3,9,7,1,63,9,0,11080,1
fd7606aab83f60c1bad201727ba22d1c,14,8,2,49,14,0,10080,1
3913988b638ac4a746fddfa03f8cb80f,61,49,2,213.5,20,41,05030,2
fe36b84b0c2f4fe178b3000549f674ea,104,64,2,364,104,0,05041,3
c9458c37eac17370db4064ce34821192,62,41,2,217,27,35,10200,1
83668c43d69665836209b31b65f6f2a9,296,133,3,690.6666666666667,238,58,05040,4
091d6824377cc2b64e85bbbdcb0c6d33,12,12,1,84,0,12,01085,1
7cb24b2592755c5b75f4d2ca53af84d1,103,56,5,144.2,83,20,05040,3
f6e6a9afa3d089da38416f72e9dafee9,19,19,1,133,19,0,01251,1
51cbdbe24d0c729460c3c5b32c1ff997,108,74,2,378,108,0,05040,3
6885f656d150f83fac910dbcad8b093b,115,76,4,201.25,115,0,05040,3
2ca8b1b92713a13a57a5cf575d42c50a,23,23,1,161,23,0,11140,1
1adcb030febced0b133dfb6b968f0ade,92,64,2,322,92,0,10200,3
3ba6a7d81cbcf38dbb5de6a067a6fda2,38,38,1,266,38,0,05040,1
eb9e7e623bbb5f2cd88bafe770630eb0,92,81,2,322,92,0,01026,3
0b8b6e456b88088870a88969a7934772,134,77,2,469,134,0,08100,3
f13b1dcc0a1ed8d851454cd24c0424fc,12,11,2,42,8,4,11140,1
243ea1af2aa44e2c86e04ddcb1b6a1a8,57,48,2,199.5,57,0,12501,1
a4c14ad9295ec7a55a8b2ed0e0c809f3,17,17,1,119,17,0,01012,1
0baf6ac2480ae121a164d0e0f9c497e0,85,74,1,595,85,0,01026,3
fd84792643b0899ff770106e33135f2c,59,37,4,103.25,59,0,05040,2
a04afffcd1499e65af4fecd9d66bfa13,279,132,5,390.59999999999997,279,0,01085,4
93568056bbb91961bb80b878d5bd72d9,135,90,2,472.5,135,0,01027,3
6419b8632e9043c520b34a6a20ea4bdc,47,39,3,109.66666666666667,47,0,11040,1
49c8963354141f836b17778b8d51fa7d,172,103,3,401.33333333333337,172,0,08051,3
49862c8de6e6f9f9f58b5d3b1cbc5007,223,119,4,390.25,193,30,01026,4
a10e608a44ed1ed75952d7db047b2a8d,32,26,1,224,32,0,11100,1
fbb18cb7f51e22c1964079e767180746,13,13,1,91,0,13,11040,1
452a483b4a06988995734855cddb1b58,64,50,2,224,64,0,08100,2
64e86db2844b2d916e49344d79a867bf,150,104,2,525,150,0,09130,3
4b78661bde07b4981a948aa708f9a98b,249,109,3,581,182,67,04020,4
214a1b052c05c7673609821e03cbfc65,83,71,1,581,83,0,10240,3
66181cefa688ecd1674e03d87a9ae445,493,193,2,1725.5,446,47,05100,4
66a3cfc6f1fd1cf4eb9798f482a077cb,12,12,1,84,12,0,04060,1
04c86d688345bd24d628a08e8ea6a260,20,20,1,140,20,0,08010,1
badad3825f0d76e6f68a509003b33d92,21,21,1,147,0,21,05030,1
bfc20cdc7dea8637ded47ec801f106ec,43,31,2,150.5,22,21,12410,1
85277df2a98881c3cee4d0000984b110,14,14,1,98,14,0,01201,1
19e937c1a61b484e367b9769bee1a0b4,160,76,3,373.33333333333337,58,102,05030,3
aad0977945ea91397d35ba5db3ce32e5,42,42,1,294,42,0,05030,1
9b18060afb40cf001406e0ac3fd58916,14,14,1,98,0,14,07123,1
06f9af012cce85b24cf0cd9f57f2dc77,63,22,5,88.2,63,0,11080,2
c488072cf274f2f95df54214ef0f0e43,81,62,2,283.5,81,0,01012,2
557ef1216b56c946c49d1bd59e4d2310,25,25,1,175,25,0,10028,1
24b4791a8c3aa870d0aed7ad3e4b32e2,24,24,1,168,24,0,05030,1
cedf09d147f6ee8389a7011417416af6,142,79,2,497,142,0,05030,3
cb83f64d6f207271838a3a47299819fb,37,37,1,259,37,0,01026,1
8f8e4e18c20337ad35fbb8ee47ca4139,256,123,3,597.3333333333334,177,79,09010,4
ce3c3ffb2c199efbaad68411250603d6,64,39,2,224,32,32,05040,1
933907bc308b3b63fd1ee93b2ad78e9a,2,2,1,14,2,0,12410,1
fa12f4e2808df686cbf4ac924db2e73a,37,37,1,259,37,0,05040,1
dc1a5c3814f9ddbddca2f7afbef18f86,33,33,1,231,33,0,01026,1
d6aa438d340a715a38845a03fa9f2f65,206,114,3,480.6666666666667,206,0,05040,4
16050fd18d2906b911ae7d90e8a0984f,464,128,1,3248,0,464,11100,4
f8ba24a2aa8607ec49e1cdfaee27e464,10,10,1,70,0,10,09090,1
b7752f08195f888644e2eb8104370825,69,59,3,161,69,0,05030,2
7bb03a606f02fee11cd7caecd0776723,272,96,5,380.8,140,132,01013,4
e83df64b52194b2632b752c97e8ed493,150,86,4,262.5,150,0,11100,3
8c2be926ab1876ac408d4c91ce8096b9,125,81,1,875,125,0,10200,3
86b41f7bab3148e579a67e2cbd60404e,22,22,1,154,22,0,03050,1
eec3246dcd87aad0cb3e481b828fdce1,38,37,1,266,38,0,01085,1
e35b2b16629bc00a9967391d2cc08912,23,23,1,161,23,0,05040,1
4b6fd2b7e90d2d720fcb265c58d7d527,36,36,1,252,36,0,05040,1
5387d145b1716af5878b01cbcb6bfaef,107,66,2,374.5,41,66,11080,3
aad99f3d685f54df71f75700e9b3ed20,58,58,1,406,58,0,05040,2
7053db337a6c9b4c7a8ea4eb91a70369,17,17,1,119,0,17,05030,1
dd34946ab48588ffa03a307565735430,64,48,1,448,0,64,05040,2
49072b0f03e64a7eb9fff4c5cb70b3ce,126,79,3,294,126,0,05040,3
9c0d5af2bf96ea10ed0e329672016643,61,49,2,213.5,61,0,10080,1
526bb9ccd34f6d421886d476f9ebfd43,35,35,1,245,0,35,04020,1
98b66dfe751e387501a6513e12325f3c,36,31,2,126,36,0,08051,1
52c0d09ae4fe235ddb952d00c9ad98e5,24,24,1,168,0,24,09130,1
c337c864033733682a8a74e9e27e3cdd,7,7,1,49,0,7,01027,1
85b8d8cb086bd0e8f23d0435636a609c,178,117,2,623,80,98,10200,4
0ad98e372266e28ac262633bb4ded1f2,74,54,2,259,33,41,10200,2
9678503fb4e6c62ce03c9c9d01a8989f,20,16,1,140,20,0,12590,1
5788b7d628a8c36520da295230691c4d,171,83,2,598.5,171,0,12670,3
968b6e6f3dd98b952e13c51bea65ccd4,46,31,3,107.33333333333334,46,0,12590,1
8e70ae0c8083156393c4dbcfb6a02a9f,438,154,6,511,383,55,08452,4
48b3a5b667e263254aa724b9b3b4b0b8,26,26,1,182,26,0,11080,1
e798f9ab087e72240b01c56163649cd9,53,53,1,371,53,0,01026,1
b13bdbfdec09c0e95c7ccbb72af2b7d9,71,40,1,497,71,0,05040,2
44028bee571f9fcfd38c079dd6512dc0,54,34,2,189,28,26,01012,1
ca56d4ae0b3e6977c0f4c9835bebd42d,44,44,1,308,44,0,01013,1
8194ed5476db6d37c09571e28e2f2117,23,23,1,161,23,0,01012,1
008eae973088bfdbfb468ffc37d6582d,135,86,3,315,135,0,01026,3
c9dbf3dd2a1f0b24725e19cccd282474,54,54,1,378,54,0,04020,1
9770840dba79bbd5eda7aa09065d36ec,188,103,2,658,41,147,14351,4
56a90b60b67f7d703cc786518834d23d,49,36,2,171.5,25,24,05100,1
7af2b413e49496268b997910290143a1,50,50,1,350,0,50,05100,1
532ad82a0e6a739da56fd7de0449e63c,274,93,4,479.5,239,35,01013,4
c3884e5a8d2bdc3df0ed70ad8baf8e17,31,31,1,217,31,0,05040,1
cd177acff00ea5447639db99587394fc,24,24,1,168,24,0,01026,1
4eb3ed95610dd2fb7dde25324fe7ecd9,240,114,4,420,240,0,05040,4
eb55e6f9fc5f6fb3654dd6f43bf9375e,15,15,1,105,15,0,10281,1
50e4cd8937960271b345bdb78ff82657,384,161,5,537.6,196,188,05040,4
a2b85d5930112c649ff011930c117674,141,82,3,329,83,58,10080,3
3552b4b121c5562d9ffb2050b731efe8,92,78,1,644,92,0,03050,3
153ec1bffcb9e5ea7ae3b86d15c60ca1,22,22,1,154,22,0,08230,1
266a77c50829be6d6e37ef4bd574d70b,55,29,3,128.33333333333334,55,0,11040,1
fdf899d410df88286a2006e2d20753ce,415,100,2,1452.5,26,389,01026,4
9a9193a1312dc303d82e056a694acfcd,62,46,3,144.66666666666669,62,0,08314,2
1889c854f6f8d2f2662962de88416ca0,38,30,1,266,0,38,01012,1
6c9e033a872aa7e64d52021bcce4290e,15,15,1,105,15,0,08100,1
f1b316cb1fa8cee015c250694ba09305,48,48,2,168,24,24,01012,1
cb9758196a8ef488ec8bd07991adab9f,79,59,2,276.5,34,45,05041,2
6ece0a2a8132ece929bdfe0cbf981a62,354,114,1,2478,354,0,11140,4
f588b2479baaf36920f1803f30e0bfe2,33,33,1,231,33,0,10200,1
4159dd177f754b35e4fa89f093b9b54b,232,93,4,406,232,0,05040,4
78e947208a538348509a251bf3dd9ac4,47,46,2,164.5,47,0,09130,1
a0a30a1345f522bca20961d72147c326,78,35,2,273,78,0,08314,2
f5ed9f934db7d1ef8ec530a03ab8b50f,14,13,2,49,14,0,09070,1
a5000a386daf9fc26294eb80d312ca59,23,23,1,161,23,0,01085,1
cb889e03192164838665643dbe1764c9,79,59,1,553,79,0,03090,2
7a0045efe7f77ff75056b5d1a3c07e70,127,71,2,444.5,127,0,03050,3
2c788b44fb95129311d4ba7272f0b06f,30,30,1,210,30,0,01012,1
ad881cc0743362dfa98d9e0535db39b1,70,70,1,490,70,0,05100,2
2aafaf38b356325e72733cf4dc7d6f6b,65,51,2,227.5,65,0,11100,2
791274effeb2a3e484ded20373ccb126,102,57,2,357,102,0,12650,3
7a9f61302e29ee2baba9c7ec919c2f8d,15,15,1,105,15,0,10200,1
84ce2bbc85eaa852680358237621d19b,124,89,2,434,124,0,01026,3
080db2faa4e462beb101abac495db502,31,31,1,217,31,0,01201,1
459fe81626995a99211013bb52b40b3e,78,72,1,546,78,0,05040,3
9979f8e420ebde27b46b4c5a9759cd7c,42,42,1,294,42,0,10200,1
9c517e5072afce5ec003d07919bed968,30,30,1,210,30,0,09130,1
920caa4b5f8a3cf0cea7329f4244bbe5,1,1,1,7,1,0,11040,1
ffe3457be0c2fb8686873afcff829379,14,5,3,32.66666666666667,9,5,05250,1
b2afda53dcfeee3aad19565014f255b7,27,27,1,189,27,0,01026,1
6a9d4154b036b416165cebc38aba2a68,150,122,3,350,100,50,05040,3
c90354d65e753a2a42863cfd30a8dc9d,263,121,4,460.25,263,0,03050,4
9a9dc485132a8e553914a062fed78dc2,32,32,1,224,32,0,05100,1
3faa592e1a43543ec9f48a94496576af,156,112,3,364,156,0,10200,3
0addd207eeb315121c2bf4199fcd73b7,156,98,3,364,122,34,05100,3
878eaeef400fdac23f95b41d2f8c6fce,26,26,1,182,26,0,02620,1
2cdb0b7adaf356b1a81455fff1428276,30,30,1,210,30,0,05040,1
25ccacfbeaaa392abf99059200f84047,97,56,3,226.33333333333334,97,0,10153,3
6312e6509ee5fcaa1cff777d18708bf0,63,58,1,441,0,63,05040,2
ed2961cbfe07952c89c0af01919c3852,21,21,1,147,0,21,04020,1
67cd8ac524619e3c7bec3e7ecd843e7c,783,280,4,1370.25,783,0,05040,4
9a409bb98461abd0703d75d4c84ccaca,108,67,3,252,108,0,10200,3
35e8959506a51feadf9947d57211c309,33,33,1,231,33,0,05040,1
2a4f48b227d28614ad5c976134dd947b,90,52,2,315,90,0,05040,2
ec3bcd169daebd74d69bc297fcb50fb9,371,116,2,1298.5,371,0,05040,4
ef807c5da2acc1c5c4687f9274a21c51,378,101,4,661.5,302,76,01012,4
bf116e0a1468e0345493cb2d0b5a50bb,184,87,2,644,184,0,05030,3
95ae91c0d41f8b2b5adae8085f7cc6b6,91,62,3,212.33333333333334,67,24,08010,3
98f98be81c596f06cb68a31f3e3eca19,75,60,3,175,42,33,05030,2
ae165dbc8093a66b6c9913801165dc60,33,23,2,115.5,33,0,01012,1
95396625aa458cb5cbad688474274909,266,73,6,310.33333333333337,146,120,01027,4
4a2a44a33c4efe9b85e20990bc9ccd93,182,73,2,637,182,0,11080,3
60f82368ec72579141405f8dfbc68399,47,42,2,164.5,47,0,02690,1
6a92a21ea5dbc7262beb098bd2157241,32,32,1,224,32,0,09351,1
2b6beaa5b7483d6c104ce74b519fb195,107,86,2,374.5,107,0,05040,3
fa9de9192658b27ff858676cd08df993,390,119,4,682.5,316,74,04020,4
ddada3d4cb50dc794c4c6ad616da3cf8,39,39,1,273,39,0,03090,1
becf514d25f78f19309c1820b4e585a4,126,73,3,294,126,0,09010,3
42d58613878b21bc824af4344cb95cde,145,97,3,338.33333333333337,145,0,01013,3
7d81c1d93e1f25339109505efc52b15d,508,194,4,889,437,71,05041,4
e4e4d46175a1a2af7c290277c781e694,281,177,4,491.75,235,46,05040,4
284e89d7c205ad8f88fae9763bf9e6d9,71,63,1,497,0,71,02620,2
0068bed782963cd2778a56520a464311,61,37,4,106.75,45,16,05040,2
c913185502445c31110ba3f3d51fb0fb,115,45,3,268.33333333333337,115,0,09010,3
7e20cd5b0b581114e5dc4a1563eaef9a,184,118,2,644,184,0,01026,4
feff2ee9019d24988a210d13b23ebbdb,25,24,2,87.5,25,0,10200,1
10e9f692eaa07d2337c8864d082a9710,59,44,3,137.66666666666669,37,22,05040,2
6befc73083db0e3bc8cde8e3c97a165f,196,99,4,343,140,56,01026,4
4223684b554e3620cb78600d4e48b8d3,56,40,1,392,0,56,05030,1
ebb731890dcf105ba6250c7af239291b,33,33,1,231,33,0,09130,1
9976f8b7c2e7bf5122fa2e85fa9a5921,87,58,2,304.5,29,58,05100,2
941d6bd6597f24e912ef28d856c3024a,38,33,2,133,20,18,02690,1
ebb03b0f70df07ed604f82f31a06d045,299,103,3,697.6666666666667,299,0,01013,4
7e7b0673e73a8cb8622eea62f0996121,55,46,2,192.5,55,0,10153,1
f655f835886a66be5f243e3b0cb48542,17,17,1,119,17,0,10240,1
35d870fd22166791eee54b3939720c2f,24,17,2,84,24,0,05030,1
3b7375e2e14a7ad2e215ef160f4900c9,28,27,2,98,28,0,05040,1
37b985e9229adcf10b6d4cbb4ff67759,62,47,2,217,24,38,08052,2
685f223dd252f8286d405502a5e52cac,66,66,1,462,0,66,10200,2
8dd7c591804674be87957c1237dd0cc6,137,78,3,319.6666666666667,137,0,10240,3
5d8867808afbf69a6caa3fdd97c5797c,113,71,2,395.5,113,0,04130,3
88a3bca4469f0026876b7402ee489125,100,67,2,350,100,0,01012,3
6c669efb4ae38f18b5ae9756f936c738,83,52,3,193.66666666666669,83,0,11140,2
72033e9948f5bd47fc669ea4c3ce2220,77,59,2,269.5,17,60,08314,2
8bb0afd000b057356eeb410ea5b3b812,141,69,2,493.5,141,0,10200,3
e969612a86cce2e806518c7c65fc8e10,6,3,2,21,3,3,11040,1
4b1d02bdb66d4cb34bd38b016c919042,114,93,3,266,114,0,11100,3
50eef9ed4c094a7d961f8156d0183402,284,87,2,994,76,208,11040,4
0efdcdd5228697c622a2c7f8c58ac31d,60,49,3,140,60,0,01026,2
22bd0a3b11f61d2fef781bebd6010de1,101,68,2,353.5,36,65,04060,3
f71ceb1f6e283e60ee6f2de86bac257b,212,109,6,247.33333333333334,194,18,04020,4
637162f2b202b76e8e61003d711132e9,24,22,2,84,24,0,10028,1
eb1ada513549bb622328380c7c6c52f0,11,11,1,77,0,11,08090,1
e15be4bc1161204e65ac099627971ac6,209,121,2,731.5,209,0,05040,4
ebbcd1bbc639184cda451a7bc2fe2f31,194,82,3,452.6666666666667,75,119,05040,3
b0a944b2ca48737d863c579842fe6b85,51,41,2,178.5,51,0,05030,1
3d4e6eaf2c7aeaef4a2067726c2931d6,35,35,1,245,35,0,01026,1
a709fa18b35a1bc6fc9128848e0580de,1,1,1,7,1,0,09010,1
1da379d5e09bf384516b85c3c5e117be,128,70,3,298.6666666666667,128,0,05030,3
662ebcbd4776bb7ea16da90b80912a0b,337,144,5,471.8,289,48,05040,4
8293ce6baa42b804eeff953509871ce8,28,28,1,196,28,0,01013,1
35108546261f325f716b662022b9b8b4,1,1,1,7,0,1,10200,1
ddbee44b8bf173e1c1869652ca9c21db,95,72,2,332.5,34,61,05040,3
5ced255a737f2222e922072eaabf4fab,54,54,1,378,54,0,01026,1
5787811662d9c5142df31bd30586be0a,3,3,1,21,3,0,12570,1
29b01c5cbd3d332b3c0ccca1f4433d5f,92,51,4,161,70,22,05040,3
383b3606b34d59bd4599f1e5cd4edbf5,156,80,3,364,125,31,05040,3
860d6547e8efdae0d6d5c107288b4737,17,17,1,119,17,0,01026,1
388a2b6fdfb927981369758b46d700ae,400,189,5,560,400,0,05040,4
ca307c9d3ffdc0ce5b9d45cca6d8f256,60,40,2,210,60,0,08100,1
b47fb956633ed5e5f1d7d9a68d436f72,46,38,3,107.33333333333334,46,0,05100,1
235a4e04b0ae69c514318f12402fdb5f,129,84,3,301,93,36,08230,3
fbda6f6f5cbc067ec1872087846db5bd,25,25,1,175,25,0,01012,1
b754220f14bba57fc9a1a340aceab234,62,50,1,434,0,62,05041,2
64d56c6774b8facf8be5a913f3ac10bd,33,33,1,231,33,0,08032,1
acbd9cd1a4a5194fe98d546962ddfdec,49,36,3,114.33333333333334,49,0,05040,1
af9865b9e548920add65cec4249c9f7b,43,31,2,150.5,43,0,09130,1
feaa81b6cf2a285e113fc0d95682ce58,50,40,1,350,0,50,05030,1
d9382aef1b458e52d85813dcffea8bb7,22,22,1,154,22,0,01012,1
509fcdab683bda0a12a7b1212637a337,28,26,2,98,28,0,11080,1
f85a78b158ae6f43afe968ef6569b1df,74,48,1,518,74,0,01028,2
8047d509f276f2c74a43bd5c668cd0cf,4,4,1,28,4,0,10200,1
48d0f66f74507039f68873cd06058bfd,54,51,2,189,54,0,01012,1
04c58a6be6604a9a7a9195d6cd5f6f34,29,29,1,203,29,0,01026,1
6ec4256e854d935619e832121894a553,37,33,1,259,37,0,10200,1
339d3222968f1b34f7ef40429a179efd,283,146,3,660.3333333333334,283,0,05100,4
c8f9894c3dcab2e9439017e245136824,203,89,4,355.25,203,0,05040,4
81c9c8818e6d346b16291764a3b8e2cc,19,19,2,66.5,19,0,04060,1
5cdf25c43b129f7f511b76a384b0e6db,90,90,1,630,90,0,09130,3
93b2139ff4aca4948754903cf6ab9ab0,93,56,3,217,93,0,01026,3
b324cb2d828633e0b1acedd6990955ea,55,51,1,385,55,0,01085,1
cbb5b95a50d4e14c802de4032b6afd4d,9,9,1,63,9,0,01013,1
ae4a8a25c14d94e2ee14c5990de75a8f,39,39,1,273,39,0,01026,1
3585368baa949a3ced522bd553a0d192,29,25,2,101.5,29,0,11040,1
5a17c377c0e72925784b87230cd80c9d,112,70,1,784,112,0,02751,3
45ef910bfec8b4d78c52bec6a79c768a,81,73,2,283.5,81,0,08090,3
1d4d427bea99c16483662fdc2cbd9743,87,60,4,152.25,66,21,05040,3
44e5b2e510b22dad63320d15c20d2035,146,146,1,1022,146,0,02620,4
78572ee4d5d470183a1e144c93a5f3d8,163,108,6,190.16666666666669,140,23,08314,4
ce0a483ff1eda92dc4a14cc60ccea62f,137,107,2,479.5,137,0,01012,3
83327993341e50629c84eb8e3363a276,38,38,1,266,38,0,05040,1
985c00c1dede757baee05b5d614215bf,79,63,2,276.5,79,0,05030,2
cdb1ffbf53edbef6b315be99a30bf2bf,62,58,2,217,62,0,01085,2
3d84a56da7fd3e0decfebaae59ecf723,44,39,2,154,44,0,08010,1
00beec225f1530ca3700029b2eb7cc2f,134,108,2,469,134,0,05040,3
b14207e9a1937ba0a3e4fb83382da490,84,68,1,588,84,0,05100,3
1df17b5770e3c2fd0c33ac27cb787cfa,125,80,2,437.5,125,0,10200,3
9b218503721d42b1c4db38bbf14fdcf1,287,145,4,502.25,246,41,01026,4
06caeb6688807a086aceace59406707b,179,70,4,313.25,179,0,04201,3
c9826c7f815bfd106abb86e387af08a4,26,24,2,91,26,0,01026,1
42d69cc3f99098485fc18c1db1f27df8,48,48,1,336,48,0,01012,1
b3573445ca9c9f25ad77d213a95561c0,118,84,2,413,118,0,05100,3
d6be38eed9f387d3a6ab654dbe3b56ca,29,29,1,203,29,0,09130,1
c3eacb37f220ed39b7864f180ad0cce2,82,61,1,574,82,0,05030,3
b5fcc8319f407bfbc09fa102df6af86f,30,30,1,210,30,0,04060,1
0a6e032e3fde84de428bec454eb61316,26,26,1,182,26,0,05030,1
c9d1cf955d26ee36c607d948171ef6f0,77,70,3,179.66666666666669,47,30,04020,3
17a391a1280ee02eff889b1bc61598e2,117,82,3,273,78,39,05040,3
36110887d7d8e0f46edbb6a0f85fdf41,19,19,1,133,19,0,05030,1
72e103c4b8219006e54fe22b93da210d,119,90,3,277.6666666666667,119,0,11060,3
3fcca640d1d378877a5c1c3e63aa0c24,30,30,1,210,0,30,01027,1
28eee661b51da1d854b8a0075ca40870,21,21,1,147,21,0,09070,1
1e10888b6a68173ee8b12a97128df5ea,49,27,2,171.5,49,0,04060,1
c6f2c31661e8809e41f53a86e4ea33c0,40,38,3,93.33333333333334,40,0,01013,1
46e4a62fd63fa9a48a79f858c150e335,170,83,5,238,170,0,01026,3
ec14bceeb660d4aad41ee75a2f6eefd5,8,8,1,56,8,0,10026,1
a2bd062f4dfc2f24251c3e5d953cd540,7,7,1,49,7,0,05030,1
feee0af215f9b2d9813b5f19c5c1d090,87,63,2,304.5,87,0,04060,2
da87341afa15f6892077027f1b37d349,133,75,3,310.33333333333337,133,0,05040,3
7dd2c0eec22c32caeb11f7ed7a53e7f2,260,83,4,455,226,34,01013,4
5e466bc3a60c4c5e52f7af0b98ebd9f6,110,74,4,192.5,110,0,04080,3
904c7b166f8887c66ab44d10472fe802,63,51,2,220.5,63,0,05100,2
067392e481ed0f592afa3406cdf6ccf6,31,31,1,217,31,0,05030,1
da620e34fd9a83dbf163f5181eb0e022,29,25,2,101.5,29,0,01016,1
b807705ab857c457200e89672db1ac6c,5,2,2,17.5,5,0,11040,1
097c49d8885fb22b426ab53af9399a21,12,12,1,84,12,0,02690,1
7182ac9f11a937ec9b6f9aa195af5ba0,19,19,1,133,19,0,01012,1
6a0442e01e6bea415a094ab4070c3b43,24,24,1,168,24,0,08100,1
8f3715d691b260b42c15f7cf319f86f8,143,80,3,333.6666666666667,143,0,01085,3
88614723bfec101cc3b0d79a1a705178,66,57,2,231,37,29,01085,2
6a08c3c0244d89034209c6d2ccd4f00c,76,52,3,177.33333333333334,76,0,11080,2
4bce1aa3c1e096578b7ce54da797c499,17,17,1,119,17,0,03050,1
a4e169adb5fe49024847109661e25cef,66,53,2,231,30,36,09010,2
faf3093c0f2f360095ca2cfc70ff98bb,52,28,2,182,52,0,05030,1
3ad8d5a85cc83d9c7da56a871bc14ad1,34,34,1,238,34,0,01085,1
0248894ea490eedb7cf1d3cb58e308f8,147,94,2,514.5,147,0,01027,3
87e5e09a38f9b2cd711b2d0e809790ef,141,86,2,493.5,79,62,05040,3
65447fbbf17f416994a08ae71b81a609,57,57,1,399,0,57,09030,2
b552f40129ee48d8a3fe665aa2ad3202,29,22,2,101.5,29,0,05040,1
d673f8383501de658475253f55adc0f5,108,87,2,378,108,0,09030,3
dcab9f48c737d89dbd9859158ee11789,464,131,5,649.6,449,15,01026,4
afede06557e678cfbff51c4d9a09b509,122,83,4,213.5,102,20,04060,3
c8b206360ac91c773c9c7721e54b6b68,233,111,3,543.6666666666667,129,104,09030,4
d487ed3200d8100abb45f7320a366816,21,21,1,147,21,0,10152,1
59c577e2a63f12ff003a31a86e5f24e5,49,49,1,343,49,0,04060,1
9405810714ab46c65df51bf8b8bcaea9,30,30,1,210,30,0,08100,1
0feacfdcc6bf813424f5606a01d5f7dd,44,44,1,308,44,0,05040,1
ecec5eb1804382552790fe89a20a9839,46,45,2,161,46,0,05040,1
71c62fc8adf6cde63bcd28f6f44bffd6,94,57,2,329,94,0,01012,3
f70f5835761b914ebf5b901618de9d7b,46,42,1,322,46,0,11080,1
f043972a05f65f08dcc7c7c7b2a6fe41,36,36,1,252,36,0,03070,1
6ecc759ba62e2602fe61fea0c495dad5,57,48,2,199.5,57,0,03070,1
8888d2d3f790866ad592c0ef2239f5f2,112,89,2,392,112,0,03050,3
3457c84ba98d9b2e5ae3649ab0468094,489,176,5,684.6,80,409,05040,4
dcf9aa06242c871f49ab4108ea87712e,27,27,1,189,27,0,08190,1
159c7800f769e94a4d34a4d20c0518dc,70,57,3,163.33333333333334,52,18,11100,2
29481947cfbb7a1d84ec5cd7356ed5b9,10,10,1,70,10,0,11040,1
6d2f66879355d1f4d1c3450dd8046683,50,45,2,175,50,0,05100,1
846341b34999e48ee421d37a0a2b02bc,35,35,1,245,35,0,09130,1
9f87405f131632c2fc3566b87be8f4ac,52,37,3,121.33333333333334,40,12,04020,1
5a4204aee5ec3859a9d358956eeb43ec,246,103,2,861,214,32,01016,4
b63b1ac4c83a3ff1d722e80d53b2d5b1,4,4,1,28,4,0,10040,1
d00436a435cda317397fdfb0bc458433,4,4,1,28,4,0,11040,1
63f45c4128f8e20b0b34a527242e1f10,1,1,1,7,1,0,05200,1
3bf6d8adcdfdd3b469d5399f140de838,5,4,2,17.5,2,3,11040,1
16675ebbb6670921925a19e11f0569ef,108,72,2,378,108,0,01012,3
c48df71b06ee9f0aac60b3b55f599f52,140,61,4,245,140,0,10080,3
6cfa6908a07be0b64904789a63c3b17e,154,99,3,359.33333333333337,106,48,11100,3
af9191bfc8c15c3b0e034ce1fbb6be5f,419,136,2,1466.5,419,0,10200,4
fc1180523c6ab4a520db17163260feca,90,51,5,126,76,14,08230,3
21307013a0ab2dbe1ba0ca92a4e9c161,26,26,1,182,26,0,01027,1
88c08661555f10dcd73904a2f6d6efe7,19,19,1,133,19,0,04080,1
f3ef7ec9d71e635483c49d5876de8c15,99,75,4,173.25,74,25,10200,3
bccb0499dc76e3c4d1a26effb43f3108,153,79,2,535.5,153,0,10200,3
8166f4d550a2795b73dd0f4926381a94,60,49,3,140,30,30,07122,2
159cfa1c7f60fb4cb3fce932366935c0,85,66,2,297.5,85,0,11100,2
354124189c7e6a3d9e55a34e25fc0bcf,117,89,2,409.5,117,0,08100,3
f8e2732078ceffd31c9beb89b551c201,33,33,1,231,33,0,05040,1
0dad822cce4d36cb7e6b37993d8f8833,316,101,3,737.3333333333334,316,0,11080,4
dca05d27025187853524d1a5fca6cf1c,49,49,1,343,49,0,04060,1
d206a2a6d5d776a6b189e62a971996b4,51,45,2,178.5,30,21,08110,1
09be76ea383c2b164866434d8751ee37,30,24,1,210,30,0,05120,1
7e4ba35b19f31560623022dce0ad1896,20,20,1,140,20,0,01026,1
325820f957af91e3a514ccf2f405e121,116,74,3,270.6666666666667,116,0,05140,3
fbfb18ab114e05dcb78ea8733ea54f87,157,100,2,549.5,101,56,10200,3
adc7f13c65e76732a86fb1350fea7037,53,48,2,185.5,53,0,10200,1
85e05cffe97fb72ff468f74b493fc3e7,130,88,3,303.33333333333337,77,53,01027,3
c0e21db278d5552d5565b02d4e8832b1,130,87,2,455,130,0,08100,3
c16b570d997ac5ad835532e7ba569663,234,95,2,819,23,211,08230,4
3b80b5ebc87702934bd817014bbf182c,13,13,1,91,13,0,11103,1
e20663a5ccd29fe59e26dc48008ff571,54,54,1,378,54,0,01085,1
0d1e24fe229bbd5692063868026aa225,35,35,1,245,35,0,01012,1
0324230efd2c561c6ff93e0cdbe9555a,40,26,3,93.33333333333334,24,16,08313,1
901adca50394e6a2a442303dde61b458,11,11,1,77,11,0,02650,1
c5f281d24e6a63d752779403c262b3e1,89,65,2,311.5,44,45,10200,3
66e915fa6179d61c8e09141dd538ccb3,26,26,1,182,26,0,03050,1
6ace7cb19cc3d26917a7c67c8a11bd2c,422,211,4,738.5,307,115,02650,4
c10ea5526fcd60e51f8da08d3ef8dd4c,67,55,2,234.5,67,0,10240,2
69d16ce8c2060878d53ad01f20021ed0,39,39,1,273,39,0,10200,1
294f8f5906ee4c8ab2fb5f618193e47c,171,117,2,598.5,171,0,01026,3
8ab23e181cb7a5a69036d7eda2753cd7,86,56,2,301,63,23,03090,2
f4f8eb79debb19eadc51251131214ed3,96,71,3,224,96,0,11080,3
6362e001a55ce5da3676b74295ed9886,54,54,2,189,54,0,12570,1
283640bcb1d4723be96e8868b510d034,109,89,2,381.5,109,0,01027,3
7fe74da886eadf4ee2a31e44972c4516,43,43,1,301,43,0,08150,1
5fd96632138c4125b70c9163d53e8ce1,21,21,1,147,21,0,01028,1
187733c69d85d775818837dd6006417f,56,48,2,196,56,0,12500,1
938c7582a9bb98bf33f7ff7f702c14eb,116,63,3,270.6666666666667,37,79,05041,3
d8a747ffee16450007172fd5bb64ce07,145,90,4,253.75,145,0,11080,3
5df3c779b0c0b6c7b4b77142c30c32ce,29,29,1,203,0,29,03070,1
f2684577601ec5c2498eee4527b208d5,38,23,3,88.66666666666667,38,0,09010,1
d9156e3b13ff673455482694c66636cc,1,1,1,7,1,0,11040,1
f5916a498ac2c567e7be97afb6fff8cd,15,9,3,35,15,0,09190,1
4ce2b957e48dea757393f821c55509dd,13,13,1,91,0,13,01026,1
9f796730592b3b64e73561a451affca0,162,101,3,378,101,61,13877,3
37b4a041126e13c79f4c56a61c28ff88,35,27,2,122.5,35,0,05030,1
038182da7cd8c8927e08531bc9ef1daa,58,58,1,406,0,58,09030,2
347d45b71e20d661802fb1ce99a7808f,6,4,3,14,6,0,11040,1
5c10a8058ae12610d71efbdc71cb037f,28,28,1,196,28,0,01012,1
d48bd2a0566b883a7c2addea4a91778e,40,32,2,140,38,2,03070,1
e7b8de9a968f5e8934fcb1895ab364eb,371,142,3,865.6666666666667,371,0,05040,4
c0f7e5e5a5a262cf581ab6be321bdbf0,23,23,1,161,23,0,01027,1
522df79a798e5fceac5de2ad2a0e9e45,45,33,1,315,45,0,09091,1
4aced993dcc528202392fad1f5188632,34,34,1,238,34,0,01027,1
414cf21702cfe113b670f2ba9c953df6,256,115,5,358.4,200,56,05030,4
298356680c8387a220726717167c80e8,39,39,1,273,39,0,10028,1
fa3d4d266346b48ee581fcca7ffcff2a,16,16,1,112,0,16,01012,1
6f28c67ecdb47f860f6e85fc8ef51c1d,5,4,2,17.5,5,0,13930,1
3f0b9b40d32d77163a1b8101e17a34d5,173,100,2,605.5,173,0,03070,3
69ed8b1b2a07a9e77f22da3c45ab346e,575,216,5,805,575,0,01012,4
cc884be995f1b6d580795ce05b25ecb4,24,24,1,168,0,24,05040,1
f884cf8b52b10702cd64182e3ddf9b9e,187,138,4,327.25,187,0,01013,4
c424d890b5f796f01da8859a53e3018a,39,39,1,273,0,39,05040,1
bb31a4fa18dab2848a3fd4f205073d1d,44,44,1,308,44,0,05030,1
dc1bc37b864b990bd7c225a653606639,145,84,3,338.33333333333337,145,0,05100,3
586b1b59c1c2b38f03aaa707c08927fb,131,95,3,305.6666666666667,100,31,10200,3
f2edc1703c9f36791dc08f86de64c6c1,13,13,1,91,13,0,03050,1
ba6416224869f1546470af5f7920c680,17,17,1,119,17,0,03090,1
2034a5f07b06b43096bf35a3b324bb0c,47,47,1,329,47,0,01026,1
cf9ced8d92e4d6e9463f4c3f7a493d2f,44,38,2,154,44,0,08100,1
8f9b11dd1e446fa456959605121886f7,16,16,1,112,16,0,05030,1
6fe521a0ab08ac83f0244478828a112c,106,82,2,371,106,0,05040,3
f92efa047eeccfe5009b9b547b81c88a,48,45,2,168,29,19,10200,1
208e7790f09fcb9bf2521cd78690d373,13,13,1,91,0,13,05030,1
9c706b12b5eb4e365eeeb14763eab75e,47,47,1,329,47,0,04060,1
535888c116929a2e8df076fb49b47c75,213,135,4,372.75,158,55,11140,4
1e3f845b39f6344c89be867e33b5096c,124,94,3,289.33333333333337,124,0,03050,3
b09e527988ee4f1fc288c952a544847d,61,61,1,427,61,0,05040,2
d5f60e3fb8b32c4388052f477b30fa08,379,188,3,884.3333333333334,379,0,01026,4
af9fc80cce6dc41752cf99da4d8b5b2e,35,35,1,245,35,0,05040,1
18810c0f6fe5caed28970ae2a3d296fb,31,31,1,217,0,31,01016,1
111bbce1e4390f99f86daf28f52c69f6,16,15,1,112,16,0,08452,1
f92427b0536cf58341f3d10c7af1e287,106,61,1,742,106,0,05030,3
9663e566c7faeff0c9c2e43c6c811d08,3,3,1,21,3,0,05030,1
1230404dba64e1f4b53e9447fa44d848,55,45,2,192.5,55,0,01026,1
7db364ad5943c0fdc96eed621ae57266,57,40,2,199.5,57,0,05100,1
447625c7b2e23ae3503e3338463a57ae,27,27,1,189,27,0,03050,1
327111c3a6577843a078170f717f9d80,37,37,1,259,37,0,09130,1
fde41681332b2ca79b98a82afbba6a83,187,110,4,327.25,120,67,05100,4
3543f24131f2a93343cd34874713c9d0,134,112,3,312.6666666666667,106,28,11100,3
0e489d0e97ec78c4f5c773178fd73b6a,398,119,5,557.1999999999999,305,93,01026,4
c5ca9fc47f0cb647768f1f65e56349f3,21,21,1,147,21,0,05030,1
a4519d600d56026df48095093ca9ba59,97,61,5,135.79999999999998,71,26,10141,3
0df54b86449fb4c6247f875a3c696330,107,64,2,374.5,48,59,05040,3
d39b80ca996a199e700de1f02ed2bf80,38,38,1,266,0,38,03070,1
a28b5db8d7e05688014664f06c8b8a92,53,53,1,371,53,0,01012,1
cd8a32049c7c83adeaf5422e4f794f1e,90,57,2,315,28,62,04060,3
3aafd6267403150367ec5bddba2f09c9,139,79,3,324.33333333333337,71,68,01012,3
e5007bc36d345f755f7091d4a6651719,86,74,1,602,86,0,05040,3
a75adf8c2b8e3d5dd3467596377d32ab,49,37,1,343,49,0,01026,1
dd13702a6c97cf1ffa4e9a3d0be50d14,51,51,1,357,51,0,03070,1
1dfede1555637432952055643d8b1b6f,28,28,1,196,28,0,09010,1
92cf6964e5b91431ee43c5f4b66f15f2,66,57,2,231,23,43,01012,2
59f5e8bd52d7d74cc60634bbebdea73c,19,19,1,133,19,0,05040,1
024a4545ba2d605b2fa15b24c5610f9e,262,92,3,611.3333333333334,262,0,10220,4
8c0f882a00e9937d6d88a9986dfc1757,134,99,3,312.6666666666667,75,59,11100,3
af109007de3ff047d90a00a9dfcd844f,124,91,2,434,84,40,01026,3
a558fdb02a0c4535b087ef9995a75439,135,87,3,315,135,0,01013,3
bec63a4de8d80759d42bd5961614ef6d,23,23,1,161,23,0,09130,1
287bc941a77e61dae7dee6aa5be123d5,12,12,1,84,12,0,12500,1
c512810486cd598d59b9d9de7d0e734c,48,48,1,336,48,0,01026,1
8a22243c26603e5ee3644125c4de2208,17,13,2,59.5,17,0,11100,1
0a02fc78d75f988b840dba73d72ca302,81,67,2,283.5,81,0,01026,2
26d4fec40bc52d3b29fdf2aa2c584fcf,47,43,2,164.5,47,0,09010,1
f452a9af9bff51091a9fbf8b1238866f,20,20,1,140,20,0,10200,1
a5316840889b9cdc1c3c9d124a4557f7,275,146,4,481.25,275,0,01012,4
993dd83dac4fd1935139774b98d95d4a,199,156,2,696.5,199,0,05040,4
90e5fe905fe98ec553b06d0f12d06b9e,18,18,1,126,18,0,04020,1
8ec8572a3c45957b39e26243d2d29be2,315,65,2,1102.5,315,0,05030,4
3c0e52e4e0c1103c3a27b8584eae77e2,13,9,2,45.5,5,8,11040,1
6744179932bd7f44095a8a3c5abc6d5d,46,40,3,107.33333333333334,25,21,09010,1
5c906ee584943bc3cec218dfb9dd59ca,31,22,2,108.5,31,0,10152,1
21c758def7bacdc5eee48618edab9c8b,54,45,2,189,22,32,10200,1
4b15f88e522a93a73864cef50b55539f,24,24,1,168,24,0,10153,1
e77fa371cd0f694661411480f2be07c2,27,27,1,189,0,27,09110,1
f340d953181f0de7526f3ae04e8cc399,96,59,3,224,96,0,09130,3
af5b640b4303a7513ff4fffef9a35fd3,177,54,6,206.5,125,52,10102,3
bac62a8eb612daa391319845f14c2b5f,40,37,2,140,13,27,08100,1
5128883caad26c2ad025f575129ea139,46,41,3,107.33333333333334,45,1,08100,1
951c2502cda4c2116babfb3fe0a5d3c4,47,47,1,329,47,0,09090,1
e7d0c831ebe3835c0c51825459b8324d,27,27,1,189,27,0,10040,1
c4f138967a9903edf7efa18cd5d8a444,33,33,1,231,0,33,09130,1
2916f00f0a219ae69a677ef276e9a731,28,28,1,196,28,0,03070,1
a80b47a1987842bcc089b1e1b1f61739,38,37,2,133,38,0,09130,1
9f57c31cdbfe1854c144de9e8e88747f,118,79,3,275.33333333333337,71,47,04020,3
c77029a57262655e6bb4afd9ac6582c4,187,150,3,436.33333333333337,150,37,01026,4
224141a4903de111eeb0a72312ec9372,78,46,3,182,78,0,10200,2
794ce40548be1bf7b4091f525e5f4c3a,226,102,4,395.5,226,0,05030,4
4fc32d82ea94d3a6cf70f1e7589a6b95,42,28,4,73.5,42,0,11100,1
e59015be1f0a1b15d267f8d82c4b5279,44,27,3,102.66666666666667,33,11,09090,1
7f1dbe40469cbcb2270a2378990d0f82,38,38,1,266,38,0,09130,1
6f0f33ce0e1e22c12b372a30ad232354,109,85,1,763,0,109,04060,3
b86af8edf32a9fa514c9850218c27c1c,133,109,1,931,133,0,09150,3
fd018e312d50b2c37b51030dd61db3ba,114,90,2,399,62,52,05040,3
d962fb45d3eb983dc8ee582724bacb7d,347,182,2,1214.5,347,0,05040,4
293fc2e0a30265613239d096e88be182,424,157,4,742,424,0,10240,4
d6ae4ae3ddfa5f4d4813016639ddb450,190,106,3,443.33333333333337,190,0,05041,4
da20a87e71c0162838d1849f7fb5e69b,19,19,1,133,19,0,04201,1
9a042e09e4620f55ab3cb809d8757af3,97,97,1,679,97,0,05040,3
bea26dcced0f62a31220dec564bff095,21,21,1,147,0,21,09010,1
354e31d3327b3c96c453e50b5a8eb7e2,509,179,3,1187.6666666666667,186,323,05040,4
4d65464accdd5536c6730c72d01bc3db,444,145,2,1554,444,0,02650,4
0544e1c16c79284019d00c17c1853db7,44,38,1,308,44,0,10080,1
8a31fe6a62a58cff2b64b0f286b219da,258,125,1,1806,0,258,05040,4
db8da18d07f24fb4fe1cd917014a5116,201,113,3,469,201,0,01085,4
f6d9afdb6976c07c6bf6a8c7517de7dc,26,26,1,182,26,0,02690,1
ab7d1427e5881340cba5a506337632b4,84,67,1,588,0,84,05040,3
7a43968f74a29a4bff945ac4fd7d3da0,8,5,2,28,8,0,11040,1
e67748538caa9901fc6f6d0a6edb393d,606,173,5,848.4,574,32,08052,4
c14f1a3744770b5049682372058f2959,1,1,1,7,1,0,10181,1
05cc4574f74bd84d35e8aa6c2e53a296,68,49,1,476,68,0,05040,2
2032b6cd93bbcff4f2596bad761eb3ca,7,7,1,49,7,0,11040,1
39f5984a2d8ccd9162fad2cb37a1426f,340,166,3,793.3333333333334,314,26,10200,4
4e533f087fe30a1538bc57ded001d1c0,440,203,4,770,327,113,01012,4
749187e52cf6ccc053b20825730ce199,337,216,4,589.75,166,171,05040,4
5a3739550f410f468536658172832a1b,76,35,2,266,76,0,08100,2
024c984cd168f9ca1a36b55c814245fc,553,190,4,967.75,200,353,05100,4
012c53f5397021b11b87113d2cded03b,27,27,1,189,27,0,09130,1
c8bcee7b127b87b97e856ece746780d7,940,191,5,1316,872,68,05040,4
d5135664243e94c3460cc0740a53c040,12,12,1,84,0,12,08051,1
bf974d97d8d79f14be82edceb656fa26,52,35,3,121.33333333333334,52,0,11040,1
9f274c15739c8f401b1e5be2b6213700,39,39,1,273,39,0,01012,1
5126ef47e206c7063ede72f212bd3c98,263,162,4,460.25,206,57,05040,4
ce55ecb82a6bb6dce0099d3670c3b5fb,131,87,2,458.5,131,0,05030,3
87a26c64034e1366cbb7a4cd29312929,30,30,1,210,30,0,02650,1
fc61439c6357ab7bb609eb158770ada8,20,20,1,140,20,0,08100,1
6a2c421d0e8e5e63613603253158abff,104,87,4,182,83,21,01012,3
7d0c24a15866e5197a1d7f2d6675c098,96,79,2,336,96,0,01026,3
51f54e5eaefa3584c8f5d5be0b7fd9ee,29,29,1,203,29,0,02690,1
5f5db6557637ae190cc49a98dc953ae3,22,22,1,154,0,22,03050,1
e9b79f24cd95872589b247cb1dd8225a,587,174,5,821.8,587,0,01028,4
09364e36c23c7eab71a6329f2734f6ce,33,33,1,231,33,0,09130,1
c4997262c0b6528d8436a179763bcad5,43,42,2,150.5,43,0,05030,1
fec19dbd3a4bed7b0b0f853ab3dde726,34,33,2,119,34,0,02754,1
db65119bd42fbdecd482242ef4b446cc,70,62,2,245,34,36,05100,2
eb9651e77d04888eb61df821d068abb6,98,59,3,228.66666666666669,98,0,10200,3
d6e849a1802a7e83c505b52153075183,57,48,2,199.5,57,0,05040,1
3496708968f608eb2043a760f6185430,153,75,3,357,153,0,09130,3
01ea4b53adae003d2d7451c65ae5ea9e,166,122,3,387.33333333333337,135,31,01027,3
ec19a1e59fe2e97a12c34430760daaa2,43,32,1,301,43,0,11140,1
2fac0a86d1c3b25164dd4ed46c6e10cf,13,13,1,91,13,0,06120,1
01bb622bd54c8b6b4b643a8336e58f53,608,145,1,4256,0,608,05040,4
783883b61cab4e37a13340b0754a10ff,431,154,4,754.25,311,120,08032,4
14a9284c0b092e20b1ce1cb36b2c0ac9,43,43,1,301,43,0,04020,1
b7e923cb1c5347cf90dc1d56879d22f1,93,66,3,217,56,37,04020,3
61b43bd9f5597db8ec357b0f6dbb23f8,138,83,2,483,138,0,05030,3
69d5ec82908f3ec6464ae7cf9026a42e,14,14,1,98,14,0,02690,1
fa40cb443a8a151b99643aa1f8f61993,427,176,2,1494.5,312,115,01026,4
7a1f240eb1117634479d3e335190202d,50,42,2,175,24,26,08100,1
2656633986052d2143ec6158a802c333,224,82,4,392,200,24,04060,4
95b608e8f5fe5c32358d3ff4062c9333,250,126,3,583.3333333333334,155,95,05040,4
109920bc3b8336deda1d7435ab5a2060,197,73,4,344.75,167,30,01026,3
2fa5ab09b69c3685c3bf951fd2bf6dc4,100,71,2,350,100,0,01085,3
02e44596631077f4a23291842168333a,83,73,1,581,83,0,10200,3
17acfb3064b7c0db927af5ed4de5fb55,29,29,1,203,29,0,01026,1
b91d99b4ac81dad956b489329f9477f1,233,111,4,407.75,193,40,05040,4
b2791e41c9caa85d168da4dafd6f20cd,77,77,1,539,77,0,01026,3
035149572f5bd99a554b7665c64455de,99,55,3,231,99,0,02650,3
d0422dbf9f8ca9dc5f11e10d7ca11fa1,36,33,2,126,36,0,06100,1
1e6556c9f657fa4a3061825a563d1b69,159,74,4,278.25,159,0,04060,3
316ee47ad765743053c959239f693acc,180,109,3,420,66,114,08313,4
7808b5c1b29fd65fa02abb265f2b4330,300,126,2,1050,300,0,05040,4
3bbbe136649bddc6009ca8c13b35d87b,40,40,1,280,40,0,01026,1
4e25dc1d0787ba7f8c3e2e8d48c07c1c,70,51,1,490,70,0,10080,2
588638c63cf069f8941e0b30d7918fb1,48,44,2,168,48,0,01013,1
34f902b60557a649486e472a7b6897af,47,47,1,329,0,47,05040,1
ed138928be1e9a65e4e899dc1cb4aeae,44,44,1,308,44,0,01027,1
50480f7ce26d18e43131b49f3e3c0192,207,113,4,362.25,101,106,03033,4
09c6391a0b45ba7eeb2561f3b420400f,4,4,1,28,4,0,10200,1
52b6525c3e705c416fa42c6aca4dc1d3,21,21,2,73.5,11,10,05030,1
0ad0d72f09eeb29451760ad0b9111a9d,71,43,2,248.5,71,0,08010,2
5c66e16025dd31fcb87b9616fae954a6,78,48,3,182,49,29,11040,2
525c1a3ad4c6a4716b0d32d09a4f3a8d,140,54,4,245,140,0,03030,3
8c058a3aa2a161fa18b29ee9c978dfbf,83,69,2,290.5,44,39,10028,3
25e86aae414aceaf4fd19534b4a3eec5,553,163,2,1935.5,481,72,05030,4
8f0339c59393691007aff24a86522854,82,67,1,574,82,0,10153,3
635e4a62f8528f3cdab247bd4d236f4e,173,122,4,302.75,173,0,05041,4
b440c222ebbadd46ffa86b0a7ed75bf7,228,99,4,399,197,31,04060,4
1904cd5ca55593cd360adc89e41153e1,342,119,6,399,306,36,05041,4
d1c2dee0be6e9ca5f86ddd5741a535f9,23,22,1,161,23,0,01026,1
1fd02cf4a4d8c905966fbcc287eb008a,58,58,1,406,58,0,09010,2
45621aefb1c8d2a562a292475f452e15,50,46,3,116.66666666666667,50,0,01013,1
563f2856ca72a0652dde2a4e277a02f4,58,58,1,406,58,0,03090,2
26f18cdf451c83d51734a15eb3c6c805,110,61,3,256.6666666666667,58,52,11040,3
ddd6a0008fcf4676ab8edce697600913,175,102,5,245,148,27,01026,4
6feb06803af935dc712cdc489176bfeb,61,57,2,213.5,23,38,08100,2
b4d37fe086809f510218c6a4193e2bff,21,21,1,147,21,0,03050,1
f106ae4df57a8a5c1c977fc284169f2a,175,87,3,408.33333333333337,175,0,05040,3
027adbfbcd07250beec7d6733a2200d1,74,68,2,259,74,0,01027,2
ae3c1dfd3a45638a4c1a926ace5ec4bd,69,57,1,483,69,0,05040,2
8dd1b8342600685e6ee48e0f059c2b4a,12,12,1,84,12,0,03070,1
e4c77f346c72c7f5ef8572a0831889c6,16,16,1,112,16,0,08052,1
ac3099758e7b7f8b19c9502920b0518d,112,68,3,261.33333333333337,112,0,06100,3
3a1f441d1f04019fc4597a77ef952ba5,15,15,1,105,15,0,10200,1
0a8abf42f317c50f71fb1b71df12dd92,42,42,1,294,42,0,01085,1
23c67ac30475101ef7a9caa87c80cd65,14,14,1,98,14,0,11080,1
5bcde84c35f74f6351f6ef7bf0c384ed,42,37,2,147,42,0,09130,1
7af04d87b5c452584c71a5221368a509,151,84,3,352.33333333333337,86,65,10200,3
9af3aa6546a8936f10fc01269b57626f,204,125,4,357,204,0,05030,4
230c5d42017b1a9cf584914c4243c4c7,319,89,2,1116.5,319,0,11100,4
86dddc9e9d61606c6f057e1f6d879fba,20,15,2,70,12,8,08135,1
d4bf0974e187a8c338a3484626cc34e1,31,31,1,217,0,31,01012,1
36df02690c11e60182e16e397ebcc31b,19,19,1,133,19,0,11040,1
0775be01fc1d0f849735fe69aeebd05d,227,141,5,317.8,191,36,05040,4
3131c75a583decd7c2bca5daa9d39fba,20,20,1,140,20,0,05160,1
4ac9535e42fee534c6ad20e241014fdf,85,74,2,297.5,28,57,08230,3
efdd0234eb02509e3c6233cc6218276b,310,134,5,434,310,0,05040,4
b63c9ac9099caca0fe162b5be344dc15,79,62,1,553,79,0,05030,2
d02c6e88adad4c08680578856f792af7,212,143,3,494.6666666666667,157,55,01027,4
ff1d9a6f39fe426d8d70f72707f75fec,29,29,1,203,29,0,10200,1
83414b22cf84b4ea3d14ab8215b63e77,55,53,3,128.33333333333334,41,14,12500,2
f438c22cc98af075fd270325b68fb343,94,64,3,219.33333333333334,65,29,01013,3
7c20cd49c25b4427dfdfe5cd591febd6,7,7,1,49,7,0,11140,1
d4675d4ae99d916a1c4f23c0210ddac8,131,72,3,305.6666666666667,98,33,05200,3
3da284e18c74231e426df26ea4f14421,42,29,1,294,42,0,08032,1
fd6e9f5e106133869ea5d89cd79d2ed6,1,1,1,7,1,0,05030,1
26443be9dd04cbaffcd228babba5973e,154,103,2,539,154,0,04060,3
336e7266cee5413e43c30e6cac68e276,13,13,1,91,13,0,05030,1
192807aefae125c748e253989e7375b2,32,18,2,112,21,11,11100,1
b57d4495cf4bb7a6ecf81a6d7fea5edf,18,18,1,126,18,0,05030,1
95dafc533b9adb09c797c22aa2bcacc2,13,13,1,91,13,0,08032,1
84bc2c06716997ad9212b22c9a2de309,331,99,4,579.25,331,0,05040,4
b570e6074b481da497a7f9785a7fa577,15,12,1,105,15,0,09150,1
494fc5b6cbc1d3df9db909e4efa67fa1,240,92,3,560,43,197,10028,4
6efb79cce2c4367a867ad4cdae8cc5c4,26,26,1,182,26,0,01026,1
0c59c0272f044de7c9ae4fd306e95f0d,96,45,2,336,83,13,01085,2
233b26bb054c0e2313df20ca16f4a231,48,36,2,168,48,0,08052,1
d9113e7c411416a42cdd2834763f2c5a,290,175,4,507.5,197,93,05040,4
8bd723d5a85f13b51ce123cc94989d2e,1,1,1,7,1,0,10261,1
e71b20635255d6236275ef4a93e4c06c,30,30,1,210,30,0,01012,1
12cd1e05d0890a23f30d1bd70a1e5751,212,96,3,494.6666666666667,212,0,05040,4
4203058f5c8678fb08ca7b96e68d9e2a,219,108,1,1533,0,219,01012,4
cf3fecf24b118d29ba0a65d62703be71,22,22,1,154,22,0,10200,1
cf1be53ee6574a85649c4e404e8ede9e,29,29,1,203,29,0,09190,1
f6ce783cf7f316bca67a071f920aad57,13,8,1,91,13,0,05030,1
2158d07d29b6d0eadca8a09266b5e14f,178,79,3,415.33333333333337,178,0,04060,3
ee2e42a92d7604796fe92cf44ebb7a2d,23,23,1,161,23,0,01085,1
2604da409cdbc79ae452d93e09dd77b2,174,119,4,304.5,174,0,11100,4
704811936c6ccf51731e98adf223a55c,19,19,1,133,19,0,07131,1
cca0334b6deba270b9e5bd8644dc6bdc,18,18,1,126,18,0,05030,1
0db8387a223e1e4d2e70cbd5462c3a25,74,63,2,259,41,33,05030,2
81602d79a43963410ebb4410971d2e94,119,94,3,277.6666666666667,119,0,05040,3
6d14940878154663095a2b1a558ab65b,58,58,1,406,58,0,05100,2
834aebdf3507e7ccc04e45d18ab5345d,38,31,3,88.66666666666667,38,0,01201,1
c7d5b81b6302e2780d1a94befca56cbf,42,42,1,294,42,0,05040,1
1297a5e3aee8c0a357cf152d72e2a1d7,4,4,1,28,4,0,07144,1
d4782965cab53d5be0a5a2053c6e741f,20,20,1,140,0,20,10200,1
79ec989c03f530b8ea242185931a1709,100,65,3,233.33333333333334,100,0,05040,3
5d0788c8857f00b5c603e4fabac29855,127,100,3,296.33333333333337,127,0,03033,3
e88e94664eb1d66741718fc048aa879c,31,31,1,217,31,0,02650,1
ff686493ee1157663504cc3450e64ec0,35,30,2,122.5,14,21,05040,1
a14085390289b69f192082369ac39b38,38,27,3,88.66666666666667,28,10,01027,1
08eb18d83d09a7f8ca499a9e29807eee,200,112,3,466.6666666666667,200,0,05040,4
ce08e07cf9a0832c36daf1f7b1efa406,38,38,1,266,38,0,05040,1
f0aea554b791b56d49c5b7b4c0b7851e,23,23,1,161,23,0,05040,1
a36b43558da9edb819c1fe3b7fe8b274,89,65,1,623,89,0,10028,3
c400a1f430f4ed09cb0902029d841436,78,65,2,273,78,0,05040,2
79f2491efd669dacb4f334d432fb38ac,277,136,4,484.75,202,75,05040,4
8232f95971b5a619e9b91b506022215a,310,136,3,723.3333333333334,43,267,06120,4
6eda0cbfd66ea2d27b03853ffb9f586a,20,19,2,70,20,0,01201,1
af437ec0984a987cbc1a134d7af432ea,17,16,2,59.5,17,0,04201,1
6f88e63f9953131156f1da497b8ca5f1,19,19,1,133,19,0,02720,1
4db4390f0c22915439a5cd4129bb9306,22,21,2,77,22,0,05030,1
2c1d50cc7affcb6e598cded82d0d8125,94,68,3,219.33333333333334,52,42,01012,3
7f1c5c995f0b07713989c1c48fd269f0,365,144,5,511,296,69,01026,4
0b520ed5820586642fc2d107b913538e,43,43,1,301,43,0,01027,1
9225b9194f868880b59ba28658dc8ed2,220,85,4,385,220,0,05040,4
2a502e99a5bdd3ff6f00b97a78112350,86,51,2,301,29,57,05030,2
f724bdf29cd2c1b47e26fc77042ea97b,23,23,1,161,23,0,05040,1
4f27e92b0d527f999a17bdc8dc0bdc51,33,33,1,231,33,0,09170,1
f4d35c731b6fa264ddbfb018397297ff,14,14,1,98,14,0,08150,1
38a491f5a5d7e8a635e0a18951e52422,161,114,4,281.75,100,61,01026,3
7e5f68ab7b37e9a67e97b25ff48207df,15,15,1,105,15,0,01026,1
33662bb9ecfa0698762bbbddb3e7e87e,123,82,2,430.5,123,0,01013,3
d01dc59eb2c17806f978bfb45dd5aae4,26,25,2,91,26,0,02720,1
2784a59864f61a666e0f79f3b19275b0,10,10,1,70,10,0,03090,1
92e4ffb7d9d70e37068f22185b03aa3c,27,27,1,189,27,0,01012,1
f0949c52ecde99179ba778c33f4ebe94,218,118,4,381.5,218,0,01012,4
1bad37495aa45ebe9623d054e9ce3437,274,119,5,383.59999999999997,274,0,01026,4
be55a1f8c882d9702829f6dd328c47f4,95,84,3,221.66666666666669,70,25,04020,3
bdc8e6fe3a1b1a0ca80ee72e7f2e8412,47,47,1,329,47,0,05040,1
1018eedb262e61571317417c85739fe9,17,15,1,119,17,0,10200,1
0c1fdc8324024e806f66064c66d747dc,21,19,2,73.5,16,5,05030,1
0f8311d836aef89db6277086660ad66b,45,45,1,315,45,0,01026,1
a7874d02bd1c1d3fc85a278d00c08406,19,19,1,133,19,0,01012,1
ce285d6f9c9ec5b3145b97e01d11722c,65,44,1,455,65,0,05040,2
452b58a748699b97da13d248fb1e93ab,23,23,1,161,23,0,08314,1
2f64634f1e5cd8f397d756ef9b113e83,152,96,3,354.6666666666667,152,0,08010,3
a9c88294bfb36978c77161e35b836eb8,39,39,1,273,39,0,03050,1
c5f31eb030f939d962a262faa68d3046,82,75,2,287,82,0,01013,3
017ec97354fc3b5dd5c7381d432d086b,51,48,2,178.5,51,0,01013,1
ee7821a1ff08fe81aa56649ea16d9360,355,102,5,497,197,158,05040,4
f0f2f2d024ef88983f49da0dd1cfb8e6,39,39,1,273,39,0,01013,1
64e5afdf1958e8869cc940be922edafd,29,29,1,203,29,0,11060,1
38343050aa1495ab02a1998ced77d7bc,68,50,1,476,68,0,08100,2
17cac251539d1dd3047431c3c0a5a893,46,46,1,322,46,0,05040,1
662bb43db1f6d5ad2976fa2998fc9583,51,47,2,178.5,16,35,05040,1
09bd86820ecb5b4ee9fe64108262164f,103,62,3,240.33333333333334,82,21,05040,3
f26144dddfe4fdc6fb3b6e2e613981de,49,40,2,171.5,49,0,02690,1
95a291d89e96eacf559a7b04eb685495,15,15,1,105,15,0,01085,1
4223dcfb580d5b890c00903950ff6694,18,18,1,126,18,0,03050,1
9228c8f006db89baa71615ed5cfa25d5,226,168,3,527.3333333333334,226,0,01026,4
f9c2553c6595193ad5e18c3556910abe,61,48,2,213.5,61,0,05040,1
a3d21ebe463b030c43c5663227bf0848,25,18,3,58.333333333333336,21,4,05160,1
d9f6ecde2c12b338214274848f7c90ad,266,132,4,465.5,233,33,05040,4
d06514c2d17d3f2231d8add3141964a6,293,152,2,1025.5,293,0,08010,4
2811a5ccdb02dd29411352de53e82c33,64,52,2,224,64,0,11080,2
d5397f93ad5e12bafa55e1de8d8cf6c9,29,29,1,203,0,29,09010,1
4c9248f8c5dc95aaa97c23872f91cf50,17,17,1,119,17,0,12590,1
29d5f975aa69ee50e80681fe9bb2e379,24,24,1,168,24,0,01026,1
722e892985674f1ed76177913d64832a,72,56,2,252,26,46,11100,2
c3f2d74071ed8f2ed83b4cc226a900cd,60,52,2,210,1,59,05040,2
4cb91367eeb672ba89834eedb0b485e1,20,20,1,140,20,0,04060,1
6c7067f7a37c853dda3a499eb01826b6,7,7,1,49,7,0,07144,1
69a2ed684ded1ecb64cda31563063c35,119,88,2,416.5,119,0,09130,3
62bd056365098c4fbc8ed987877d60a5,170,103,4,297.5,150,20,01012,3
0549ac4517633c394e198c11f596ed6d,59,59,1,413,59,0,08032,2
d389aab6c9e480af3d3c4bb24583ce9f,25,25,1,175,0,25,08230,1
0a64b8437b1b0054ad24671fdb8115d4,99,54,3,231,99,0,04031,3
6a5e2597b90e79e6c969e4ddcaa4d94b,441,92,2,1543.5,441,0,01013,4
2247450a5e73fdc633b33fa81058376d,68,68,1,476,68,0,09150,2
8f434faa639b7958ec6f6292cd737d1d,15,15,1,105,15,0,03033,1
1db7db3cc306f3cee44c3444cd0b2642,254,179,3,592.6666666666667,176,78,11040,4
98337ea7b1196b7a88dc01763cc86f09,39,30,2,136.5,39,0,09010,1
450e32bc274b248443c03d096f132f23,5,5,1,35,0,5,04033,1
df45ac060df4e2914d3978d12bbf0363,30,30,1,210,0,30,10040,1
cfb603fbbc128729dee5975556bc65d5,34,33,2,119,34,0,05040,1
0f9ac57b81646b85c2be2264bf9ae3e9,51,38,2,178.5,51,0,04020,1
b1a108b2e7bb4a5c3c4ecce7bc8819f1,191,87,3,445.6666666666667,191,0,01012,3
7d39a21b288f5f04b7b24100a1e61f6e,74,53,2,259,74,0,02650,2
9eb163578eda8f832b5a1c648b59304d,27,27,1,189,27,0,01026,1
5d24bd42b7d2560ef3299b95dba4a5ff,191,97,4,334.25,123,68,09130,4
856073513f5c65d1f7d0648a62f23411,13,13,1,91,13,0,10200,1
7ed6f2749cb652eeef56195d6784f295,98,71,3,228.66666666666669,98,0,11040,3
708ae025f590297d7b408202bc26905c,68,59,2,238,68,0,05100,2
3af1213df2c174e1381ce7f12784df93,20,20,1,140,20,0,02650,1
d01c7d1f8acc58214646da87aed053ce,373,139,5,522.1999999999999,301,72,05030,4
b0c6a49f3c4f7291a2c6da88d13525ba,11,11,1,77,11,0,05040,1
1d8415a627c0c2dbda90410f4851a84f,6,3,2,21,6,0,05030,1
eeade7d7bd589fefff19c6d3cddc9251,61,61,1,427,61,0,01013,2
25c8f7b2c7e7562c4872d34392d8c48d,24,24,1,168,24,0,08032,1
2b1c7ccc9ab54e5c761d7c18e3a1477d,42,42,1,294,42,0,03090,1
3895c086a7047a41ea86591cca5068b1,57,57,2,199.5,57,0,11100,2
f2e94d412cd0cc1ac83ecf893ef67a9c,122,80,2,427,122,0,10200,3
38cadafdee5edaeb5fdf75962e857eab,44,44,1,308,44,0,05100,1
36ad5d5e15e948739b26fbd7ef119043,10,10,1,70,10,0,11040,1
feb3f2844c40606f0307fd661a0925a4,11,6,2,38.5,11,0,11040,1
fad6b2d4c2347848a543035f7142ee0d,81,60,2,283.5,81,0,05040,2
b7977f18e31153bedf95475e132b8c4c,60,46,2,210,60,0,12570,1
62106814fa4eaac78a87826a468e931d,116,58,4,203,116,0,02650,3
b30b14a61d976e47205a30975d7de583,30,30,1,210,30,0,01012,1
f6739b47ebb5e8d4cc3301ab816e0c86,15,15,1,105,15,0,08032,1
f8f8f6b7b7b170656bff734e3f7516bd,105,69,3,245,65,40,05030,3
1d651e392d993f97876fb0f15de3c558,25,25,1,175,25,0,05040,1
ee02100d7b0ed117a1ad4f1bdf4d0dfd,119,93,2,416.5,52,67,10200,3
8af1561f1fa1988a9510b5b08636490d,105,46,4,183.75,65,40,11140,3
cfd34ff1cc98b1edfdcbd9af3e4146e9,152,89,3,354.6666666666667,94,58,04060,3
c78dcc5aebb7a5c69d5b872b311f44a4,45,43,2,157.5,45,0,08032,1
aa01df561c55d74779c683951411b505,221,110,3,515.6666666666667,221,0,01027,4
0f7a0736669953f920e9e87ce6279487,261,130,2,913.5,217,44,05040,4
8b430e693de7ecfbd773350df17e34ae,6,6,1,42,0,6,10200,1
9066fb27e12935e322c77d976e90edc8,47,38,2,164.5,33,14,01085,1
4a55cbaaf3425fed87d48f87ed51da9e,80,66,2,280,80,0,01026,2
e4016a85ce235590959cc7ec472012b9,43,43,1,301,0,43,01012,1
a5269d9e803bfe057fca7b0a9e47ee46,82,41,2,287,82,0,01027,2
1bbe5d975bec3e2488760ecd7ab77c96,85,57,2,297.5,85,0,08452,2
4246ee8566531cd196e48ac650e0a5d9,28,28,1,196,0,28,05040,1
6e7d047e3e107e6c3197b91759646c5e,19,15,2,66.5,19,0,12570,1
fac171a08a290f13edc82a88131f1288,37,31,2,129.5,19,18,01027,1
b5c6149c49164068796e44e4f994ce99,19,19,1,133,19,0,01026,1
7845eee4ef35ee674e8470324b6596bb,51,50,2,178.5,51,0,01012,1
18605b317502012f1471061deb812f44,51,51,1,357,51,0,05040,1
912fe3bd6d51c53be3879de3c3d2a6bf,1,1,1,7,1,0,11080,1
72abc424e3d2359253d94e9c1fba1fa1,78,22,4,136.5,59,19,09110,2
f395ac2378b2207a973671622f4c34b9,52,50,2,182,52,0,01012,1
44e43690647809694c73285a52e69278,22,22,1,154,22,0,09150,1
11878ae27fe7a7b3d8b850a827126bf2,81,38,3,189,81,0,05041,2
a8db9139dc24604b38be52074413e162,15,15,1,105,15,0,10200,1
8b557bd45d6efd3bd2f2e75047f37cf0,19,19,1,133,19,0,10028,1
ccfb3c3f8c1da4815f1a4861fde15771,24,24,1,168,0,24,05030,1
f591725671ece1755d2b666e06bcc780,134,99,2,469,86,48,01012,3
f7f2d1fd697fafe9bbccbc519e96aadd,13,13,1,91,13,0,08150,1
e765bf839480f476889af9f5199daa0d,38,38,1,266,38,0,01026,1
47ee16595daa23f759275691ce7b88f1,2,1,2,7,2,0,10080,1
409cd114d04c39700055af112a8a7392,369,161,3,861,151,218,05040,4
7c9eb40831c573576d0d04ec6257b400,125,76,2,437.5,96,29,11100,3
7bb08a2a32c2cac1a36c2bf6510c35bf,28,27,2,98,28,0,12570,1
a7150b68fa7e6086e553185435dcbeb7,604,186,4,1057,582,22,01085,4
d5bddfa601b5475e1550b4a2a36c47d6,481,153,4,841.75,425,56,05040,4
167816c2acd7cf225912c320a07b576d,72,57,2,252,72,0,05040,2
2052f981b33e3f679d8ff7986e10dc0f,36,36,1,252,0,36,08052,1
d571adb51b62c78c0da3084f592c672f,81,70,2,283.5,81,0,05040,2
06a3aab723a397d13207faf0a70be51c,49,49,1,343,49,0,05040,1
a9062ce20723219cbed1b02dc42be727,181,93,2,633.5,63,118,04060,3
ce5f84840f18054774e3768033985c75,140,72,4,245,99,41,01027,3
2da5f74085477d821a05039be571efdf,219,109,3,511,115,104,12650,4
da5b8a15e395ae3121fa321c85ce5cc5,31,31,1,217,0,31,05100,1
8babcfe1057b8ebc1a2a159c6c36a79c,157,77,4,274.75,157,0,09130,3
a3fb612059dc34070133af871bd02e78,18,12,1,126,18,0,05030,1
7ea90e36e2e928f1ac0f54465836f40c,185,88,3,431.6666666666667,185,0,05040,3
86cd5213f058d4730391ced80c920f37,170,90,4,297.5,170,0,01013,3
35315bdc8280873db1074a0787b6b6ad,92,65,2,322,39,53,09130,3
9900c18c933066c1413e265ed42671ba,178,98,4,311.5,178,0,05040,3
71b5236bfe523d150db32e879fbdea0b,212,112,4,371,212,0,05040,4
27d1984d0ba069efb0df3531ba77897b,47,38,1,329,0,47,02620,1
a41e09da558a3531501ba3d820d70ba2,81,54,3,189,57,24,01027,2
ba0c4c7b991137edfea8e00737acc07e,49,49,1,343,49,0,09170,1
8d8575f8453305a0319feacf31c03b9e,62,50,2,217,62,0,10028,2
4840109dc1f6bd4f6034915b168abff2,46,32,2,161,46,0,05040,1
ca6430dece0b4f5f72abe2d13d12a34b,216,102,5,302.4,216,0,05040,4
ac7c8fa51b4fc6855b7fbdb946a6582f,27,27,1,189,27,0,01012,1
cd02c9c0388d6306bd73f5899d773249,28,28,1,196,28,0,05041,1
aa68936dfb196bcd2af6efe179f403fc,108,75,3,252,54,54,10200,3
63386ccc7daca65a4a822d99296c1d8e,23,23,1,161,23,0,01026,1
e8fd6e58000f4a90dd55f3fd1be5fec6,190,88,4,332.5,190,0,04201,3
471c944325bd9331ebdb0627886f6797,17,17,1,119,17,0,05030,1
8f52f306b7bc3e79197570d7318a87ba,28,28,1,196,28,0,01012,1
b3282461b971d0e236bcb72f39b992f3,322,136,2,1127,20,302,11100,4
6b0f26fe45893031b2528b6322260b96,276,153,4,483,276,0,10200,4
65f28e9f7ea8842dabd207f3f07aa727,69,47,4,120.75,62,7,01012,2
a8b28f81a577bc9cc98b1cac5e3f9a54,1,1,1,7,1,0,10180,1
acbda8b1351372dba0311f4f89176ddb,156,46,4,273,134,22,05030,3
79272eb57321ebcf805b457f035398c2,436,178,3,1017.3333333333334,333,103,01027,4
338259b5bdee762209f519d4891f7a54,60,43,1,420,60,0,02650,1
86df65a7e1aea972bdcd22c5f6d12a5d,10,10,1,70,0,10,05100,1
954a3611d1a487b1bb51768f38368da3,34,34,1,238,34,0,04080,1
cd4409f03ceda49da33cdd3c1b38f975,10,10,1,70,10,0,11100,1
b83cbd06326491c4c77fcc047cd34b39,102,87,2,357,102,0,05040,3
fc6a53f81cdbb4557a50ee21ad7a5938,41,41,1,287,41,0,05040,1
4c217f568816c0696a9fc9e1685c383d,85,72,2,297.5,30,55,04032,3
38bf621d7858f7b954ab4c54e194ffc7,86,60,3,200.66666666666669,62,24,08051,3
4dbfd3c91ede49679efe818726a9bcfe,53,45,2,185.5,25,28,05030,1
3cc67fdfe221fb495f5f7e17cbbfb16b,74,54,2,259,23,51,05040,2
7ad856860a068a6c487583ccf96c3ddf,7,6,2,24.5,7,0,11040,1
aba1c23cdef0ef56c0df7c3fb2eb3b57,30,26,2,105,30,0,11040,1
54d8c7fde4db1db6594742c84f7c1180,589,190,3,1374.3333333333335,494,95,04060,4
a570bb236fd84886e115721a82cd754a,293,96,4,512.75,270,23,05100,4
3d1c91a7d63ee0d8bffc2a453e37bd64,15,15,1,105,15,0,04020,1
f561282f8aba94440b15b81d06826db4,97,70,3,226.33333333333334,60,37,09010,3
269abf24ceefb68fdc98dab24154aaf8,89,62,3,207.66666666666669,89,0,01012,3
68b771a48c1ccaf7681041fe84acfdf0,96,88,1,672,96,0,03050,3
cb17d645d4e889a6ecea96f6f2a7d14b,159,95,4,278.25,144,15,05030,3
8043e61d66940d506fbfae0b819e33bf,126,89,2,441,88,38,01012,3
a26f47df8d076c805e294ba26372679e,112,78,3,261.33333333333337,112,0,10140,3
64c59e5330bd1a9b5e53002449faa9ed,30,30,1,210,30,0,12500,1
e4a94fa9bb2ee2565d404b30b88bfe5e,2,2,1,14,2,0,03050,1
cc7dd4302ae8afd9d56b9e6f1a92637b,188,101,4,329,94,94,05100,4
fef3b01e6b307cd13843ecfc146275f5,86,57,2,301,86,0,05100,2
189b0bdd10dd3f5cac16f6d6cddc7118,131,65,3,305.6666666666667,131,0,05040,3
1c84ff1c9f3715fe25a7e4ff1f1d9ab1,30,18,3,70,30,0,10080,1
af5ea94736146d2953b10ead312f2f59,117,75,1,819,117,0,10200,3
1901f6a3b8e5fb6b208e7443a7f85fe0,256,96,4,448,256,0,05040,4
dccba2348d72cccc87c7f30073059e69,58,40,2,203,58,0,10028,1
88db977f4a27129b40e884603e328a74,83,45,2,290.5,60,23,01013,2
2756c389a1a0cd1bea43eacaafdb48ab,5,5,1,35,5,0,11181,1
27539867df2640d10aae0890b2920918,18,18,1,126,0,18,11080,1
6265fbc4c86a26440ec82997c33a250b,3,3,1,21,3,0,01013,1
d7410dd79991b3bdbf913ae3f0d4f224,9,9,1,63,9,0,05030,1
93a2a07f196ec50d2fcd45fbb6c3011c,7,7,1,49,7,0,11080,1
417e44429b98868619a3d7b0146be435,59,34,2,206.5,59,0,04200,1
a734a2725207034a7dbf9325cee64392,93,76,1,651,93,0,05030,3
3f2cbd7cc90864dfedd26d89c7a04ae9,300,106,5,420,205,95,05040,4
576a2d07538937a73127609bd8003d7d,98,74,3,228.66666666666669,98,0,04130,3
159b7a798603bf07b5e6b3fdb8ef7116,107,74,3,249.66666666666669,73,34,01026,3
75cae631912d439dbd6c860a1ed1c7e5,80,79,1,560,80,0,04060,3
33ce5812ab95400d07acb7a02b38ebbc,37,31,1,259,37,0,08452,1
7c41af0c6b30ee3e7775e52eda13d73f,247,127,4,432.25,212,35,05030,4
ffd5c6466830f80d6bd9b549fd69a070,13,13,1,91,13,0,01013,1
ecff8a912b87e897b0c7b5a7dfceadd7,263,144,2,920.5,89,174,09030,4
1cf8360fe5b844f76b65ebcbd5e7a5fa,237,92,2,829.5,237,0,05040,4
97533acae053e8e738894e856d24be69,3,3,1,21,0,3,07144,1
c832e33ca8bc1e6454fe4e464049ba1f,38,38,1,266,0,38,08230,1
4aeec1411d5bd2300cb2e13cc249e55b,13,12,2,45.5,13,0,01028,1
96f707e147e2706015f2ab52353731f5,33,31,2,115.5,25,8,11080,1
b8bf41c19c14f2df7d919ae2c816b873,176,84,4,308,150,26,01012,3
5751413c665509014e5fa07ff732dbb8,203,138,2,710.5,95,108,05040,4
a8df44332b4b498f22672c0bf1e0c16b,71,51,2,248.5,71,0,13930,2
c4988404e1d101c7aa4fc324c322032d,122,70,3,284.6666666666667,122,0,10200,3
57b72073b1c9968870c00f27b5794a6f,39,38,2,136.5,39,0,11040,1
8b0579295c070bed69ddab1bc34002a1,302,129,4,528.5,85,217,05040,4
cbb7380c51595942939958be8a472227,172,84,3,401.33333333333337,63,109,05040,3
847323beeb9bbc58b6f5c30bc82c2695,19,19,1,133,0,19,05030,1
e00bd17f240bb6dd67f51205a8bb49e4,55,46,2,192.5,55,0,01012,1
dc3f0c7f1d0008492515fd5433804392,27,27,1,189,27,0,01026,1
773fb6946569a1cce51ee9ad29febb38,24,24,1,168,24,0,12500,1
339909a6bf5aee2a8fb767133b3fa340,105,73,1,735,0,105,05040,3
9dac3a3193915f60b378fbc3969e6843,33,30,2,115.5,33,0,05030,1
a9e46beb7a7a33966b72f995d590d723,70,66,1,490,70,0,05040,2
912b52daec23db6a1e5f6913bffdc1be,20,20,1,140,0,20,13830,1
601a79f7a0cf5c94473e96af541e2db1,3,3,1,21,3,0,11040,1
1f70413e7cb8c6ebf20063d0d9335227,261,113,3,609,96,165,05040,4
55588d37e8ad0ee30c665c06b1566805,61,61,1,427,61,0,08010,2
bf4d6fc0c13ce6e1996f57463dfcc75c,60,53,3,140,36,24,05040,2
6e346bdf6c5b18c351a02541a0e550a4,9,9,1,63,9,0,01026,1
700857138ebf1015f49c953e495be840,31,31,1,217,31,0,10200,1
5b337e2a438642d7e64e44c0f2593c74,51,46,1,357,51,0,01026,1
3a3200c660a923ae4d9c2d99746bd2bc,133,91,2,465.5,95,38,05040,3
1e8777ddb8bd933a5d25aba4354e395b,140,87,4,245,102,38,01026,3
260759d9c7a5ca48b50cf68427252a4c,42,34,1,294,42,0,10200,1
4f39e4fb2a27514ac8fc0b5223b17b62,44,39,2,154,44,0,01026,1
12594ed3e5326661bcc4c13a931e0636,120,91,3,280,120,0,02620,3
ccb30544d33b06f43592ab3856b7c6e6,35,34,1,245,35,0,08052,1
522b3e3a6548b0074b1bec4b41097137,114,85,1,798,114,0,09130,3
2bc9a070dd0610467eec2d6b94d87c94,37,36,2,129.5,37,0,05040,1
77b21414082d15d8ff9884a533975e6a,55,47,1,385,0,55,04060,1
63a6471ca2bcee8aeea2e490bfd83341,55,41,3,128.33333333333334,55,0,01026,1
bc2305515e13dbbf9cb52131f27e84bb,63,51,2,220.5,26,37,05030,2
9c34fd2fa4fad3879edb11706bd58db8,94,69,2,329,94,0,05040,3
45597e75d2c1e48f6c2de306b7526b9c,78,78,1,546,78,0,05040,3
12ee34f3c4bdfbf6e7a467eefa07a694,12,12,1,84,12,0,05030,1
f0c4aafcac3eae64ad86fe6a056379d9,10,10,1,70,10,0,05041,1
af2c49c2fba77451376a3302afcc4c82,420,130,2,1470,420,0,01012,4
f120b392b3a6db7e150cbcd128f3b20e,45,45,1,315,45,0,05040,1
b2f75ca4cb13bee5474ae80f8468c66f,56,43,2,196,56,0,10080,1
f598786d6666024840cd9e5596b3bbcb,38,38,1,266,0,38,12500,1
cd941104c052b2c6be8e687e319b644d,121,80,4,211.75,97,24,05100,3
79bfde531aa27d4ae3b949600095d702,117,62,3,273,117,0,01027,3
de1a806bf2665b3f0ff01cf3d710b72b,4,4,1,28,4,0,05030,1
d453ad1566351dfb53b51dd429e4e9c6,22,22,1,154,22,0,03070,1
263a2eb2a27d2335dd4a3d75ad5e53ae,38,38,1,266,0,38,01026,1
2a5e6a95c27b7a3d3547a1f6a1d653f3,98,76,3,228.66666666666669,98,0,05040,3
0eb099a993f7e6f58c1bfd0ff2544c71,227,108,4,397.25,227,0,05040,4
2ea264a16e71b73e20459d97480e8dea,56,43,1,392,56,0,01027,1
b7fabdfc37d5289488ac77af0c91b887,31,30,2,108.5,31,0,08032,1
11f1d7b01a2f7f5fa3cac23010f49f84,232,138,5,324.8,212,20,01012,4
9bb090f634624276ffe9824fab6fcfe4,27,27,1,189,27,0,03050,1
8984c978bf2e723fe1c2cf9beb204d62,45,35,1,315,0,45,05040,1
bd70638cf235c8499a66909469f65618,118,87,1,826,118,0,05100,3
2ff123cd71ae4ec44cbb25d974f6cecd,30,23,1,210,30,0,05030,1
e39a25341de5f0f6f54e3207996f4d1c,45,31,2,157.5,45,0,02651,1
7b5e2fa8c180750079d61483a45482a5,30,30,1,210,0,30,05100,1
d83c33be701e4bf84216c931ef8cf0bc,72,45,3,168,72,0,11080,2
8c64cf4ac9c2d0b11c24bbbe52910063,212,96,1,1484,0,212,12501,4
2e1bb9162fad5817058f12ad846a7ed1,79,65,2,276.5,30,49,01026,2
27d64737e412a69c59a6d443d2bb24b7,41,41,1,287,41,0,01012,1
f13800a24c25092caea4b31372b5531a,39,39,1,273,39,0,10200,1
8b3adb8975c0f0a15050d6ccb67dabfc,27,27,1,189,27,0,01026,1
2d94ecc9024e0b7ca880cbf64bf4e1ff,40,40,1,280,40,0,03070,1
5c31dd2a3756685066dc0a729a80bcac,91,59,3,212.33333333333334,64,27,01026,3
992d1fa348b7635586c0c5a60aa80f39,106,68,2,371,33,73,05041,3
4fb3efc1c23b74041c2942455d1cd99e,53,43,1,371,0,53,05040,1
d029bf4a6ecdd451644ad0fe0667bb20,345,126,4,603.75,284,61,11040,4
6ac69e84cbfa556cb8a5b8f1c1f923d1,46,46,1,322,46,0,03050,1
85c030b01d346d60bd7e10a8674784a5,13,13,1,91,13,0,11080,1
17770962ff148447c09eea115036ac78,77,68,4,134.75,65,12,02751,3
643af9b4be86dce59f7fbc2dde5f804c,1,1,1,7,1,0,05030,1
96e242fa53474ae7804385103046a91c,40,40,1,280,0,40,01026,1
b65c6a8e1bd557b7e62a940e7acd1b07,308,127,2,1078,38,270,01012,4
276eb187b142f34e2035ecc0d1bba85a,182,113,2,637,57,125,05040,4
9bd6e3017c38a1fec8e8146b9f0007ed,49,26,1,343,49,0,03070,1
c432c125b35fb18a5c769ffbbe4fdeec,309,83,2,1081.5,286,23,10200,4
7db6189f1579f94c98b794301b61a461,345,156,2,1207.5,60,285,04060,4
5fbfa7d66df21b953c9ce3d7d74771bb,68,57,1,476,68,0,05100,2
bfbf856b8539fd393469a3eba8dd1e73,128,76,3,298.6666666666667,128,0,13953,3
184f1beee9f237ecd2ce3ff78cf2ec5a,28,23,2,98,28,0,10200,1
5a9ca90b67a38acd7167c92759b029b2,31,31,1,217,31,0,01026,1
3311d27eccd72e902cdbf0c6c2fd4a2f,125,88,1,875,0,125,08150,3
0b99b0b70e205b61002fd9064188bf51,93,52,2,325.5,35,58,09010,3
930060df66f7c461841dfb96ef856631,162,115,2,567,162,0,04020,3
177116c574b432155c64543091ee74a3,106,95,2,371,31,75,09090,3
6dc710bf6fd1bf2a8611d8d5554c7eda,52,27,4,91,45,7,05030,2
43e471882ce7fca87afb63ec6a8e8f32,10,6,2,35,10,0,05030,1
6f7922293d20a872a4fd5eee8023e206,344,167,2,1204,270,74,05100,4
f2ed515e603feed12fecb7ee9ecc5a8b,18,18,1,126,18,0,11100,1
bba8a03695b98dac3a13fe931ddd59e4,174,78,4,304.5,174,0,05040,3
a2bb73e51fd31ae5d4bf347e7d2e26f3,35,35,1,245,35,0,05100,1
4ba0b45a4fdaee585589fce0772a35b4,26,26,1,182,26,0,01026,1
dfbfae83f69febc970adaee30ed69c46,24,24,1,168,24,0,09030,1
e0fa2f9d9607bb3ac677fa1e055dc059,45,35,2,157.5,45,0,11040,1
d84e72bfd39ed37b2e6fd190608a0905,265,143,4,463.75,201,64,01027,4
8e3803804490be7392ff53b87b90ef99,76,55,1,532,76,0,01027,2
d103654a7de6a3683c83f50c7ee0e390,37,32,2,129.5,37,0,05040,1
19ca3f33d6cec703da5776ac36014012,63,50,2,220.5,63,0,01026,2
5b402c04f495dc013c6d42393d16f6e7,407,125,1,2849,0,407,05100,4
1636b9fe3996927dec2912e814334467,61,48,2,213.5,61,0,04020,1
436659f154322dd97f8a94f635d461c7,12,12,1,84,12,0,01012,1
89144b3c4d190dc9ab2ee0800386a94f,27,20,2,94.5,27,0,05030,1
bc0ab9a81354ef7a004d27ad64d247d2,116,68,2,406,116,0,05100,3
9a6b624c944425ba930e152b1ef15393,21,21,1,147,0,21,05041,1
f66a3a9235fe9adb356bcf0133d26731,14,14,1,98,14,0,01013,1
4e8e1c347095f2b43e4b480181fab6a6,51,40,2,178.5,51,0,11080,1
7a09231f3a8a54f9892fd2246a6f002f,29,29,1,203,29,0,05040,1
8c020552578bc7f80d478952eac1c231,31,31,1,217,31,0,04020,1
c7b95e22a84088457285e1a8e265db19,305,96,1,2135,305,0,05040,4
dc2e0937a62b65647f6be97d3b2b7199,23,23,1,161,0,23,02610,1
7f80980f9ff6da6bf4a8f1302acd145e,37,37,1,259,0,37,01027,1
a5061ef7def21b754170d71bec8782fc,43,43,1,301,43,0,01026,1
bcafa8db4367be86db786b776a5fd531,76,29,3,177.33333333333334,29,47,11040,2
cb5d9322bc37f848bbfe35f427b32c0a,49,48,2,171.5,49,0,01026,1
7052e8fcee42b4ecd51078151679d452,49,38,1,343,49,0,14301,1
6839ec0bb4039e9a2b993a1a65d633cb,92,82,1,644,92,0,05040,3
0a68488891de6700128b457870a392f3,44,44,1,308,44,0,09130,1
ff334b778424f7de5aab15e2941b12fc,52,52,1,364,52,0,01026,1
fcc10aec505c15d6cf7c04e9555ce9d8,116,70,2,406,116,0,05040,3
cee2216738260fe3fb9b125122ab9ffc,146,102,6,170.33333333333334,129,17,01027,3
1443bbab8e3b6ae4f4bcb5784e03a291,583,134,4,1020.25,457,126,01026,4
a39dd8614138669407d81c18ff178e51,139,88,2,486.5,33,106,03070,3
dec74e12bb3248257d11100a660a147f,86,78,1,602,86,0,10040,3
9e2179e5bcfb0dd4863f4de2fce23bad,56,50,2,196,23,33,01026,1
b82ff864da85297f8645daf9eeb27ff0,50,50,1,350,50,0,03070,1
24ecdd045b803c46365633426225e14f,38,32,2,133,38,0,01027,1
d67cef4636e3cc189139a032fa8161e6,30,30,1,210,30,0,05040,1
1b2d62c1ff0c29851f95e25e17aaf141,29,29,1,203,29,0,01201,1
84b09219a3a0d30df012594ecc6de032,83,66,2,290.5,2,81,02650,3
1edb139e27fd247459bb4b9857e5b48f,16,16,1,112,16,0,03050,1
40aa2d5fbe29fde88cae85179b867de9,31,31,1,217,31,0,10240,1
9a7262095c46291fc84b3aea28c73ef9,181,63,3,422.33333333333337,181,0,01012,3
12b856d27f8e08c88b75626831ab84c6,23,23,1,161,0,23,12590,1
49ef5b6a0e42a2673373e32f8e1aa254,35,35,1,245,35,0,03050,1
63d3c963bf6a52e44a82bf408158fbe4,425,113,2,1487.5,425,0,11040,4
39de6d04a4a6e7782515e2b9abd84536,37,23,2,129.5,37,0,05030,1
3dea2585a7b6f25dee5d7acf34395c1b,110,64,2,385,110,0,05040,3
38e5a97b80b85f5702cfbf6e3deaa75d,141,70,2,493.5,141,0,05040,3
62cad39e124bf332c5aba394f12469c6,68,52,2,238,34,34,12670,2
23c6898a0acfacae717899188e1647c5,32,24,4,56,32,0,11040,1
0a00ee47b5ff0ce0b721d5905422cde5,132,68,1,924,132,0,01085,3
50d84f952ae563d95252b7632a2a2cba,531,137,5,743.4,411,120,01026,4
599b90289992046eeee64f24e6147738,12,7,2,42,12,0,04032,1
3d84ed8b9d6bc38b7ce057ba155b8eba,47,47,1,329,47,0,05040,1
cd456b06be10d4e7fef9d68fa75d974d,97,58,2,339.5,97,0,05040,3
b192294f5af9c454063b08931214150c,168,113,4,294,148,20,05040,3
d57c2f29b4fbd42312ed3d5a42cfcf37,319,139,3,744.3333333333334,319,0,10240,4
e90643e61240e4ce176ad072bb1a7557,314,182,2,1099,62,252,05040,4
64b2e3081310bc5ef6b7823c6149a581,41,41,1,287,41,0,01026,1
7cc8419146635969e52560a51e7a56a8,29,29,1,203,29,0,05030,1
366471ea5721a5f653a8a11db1dc1cbc,5,5,1,35,5,0,01085,1
8cf8c9e4a5bc231c1dc13e574bb0364d,24,24,1,168,0,24,08051,1
80ac849815683b1a077a4464e3d40d34,53,53,1,371,53,0,14301,1
4340f55dad48473a4af96e640dc8fa24,47,41,2,164.5,21,26,08150,1
b62c03b7f85497869352b14ba2781331,27,27,1,189,27,0,10040,1
cdfa87c64efcd06682236f35d4118c93,36,30,2,126,36,0,11140,1
7f0ec61cf68ee5ce967b2cf9ed68e56d,34,34,1,238,0,34,01027,1
694a8efeeaf7365ed1f38b76128e56f8,62,62,1,434,0,62,05040,2
f3e58e1fec53cd75201485d21adbba96,304,147,2,1064,304,0,05040,4
71cf62ebae623fa46cfd59c23b0ec563,31,31,1,217,31,0,02650,1
651cd6382f8c74397f63704ef7d2fe05,61,61,1,427,61,0,01012,2
4aec0ae6b321225fa3a2b9148777a201,33,33,1,231,33,0,02691,1
c927394ac55deb559336bdabad87bfbc,266,89,3,620.6666666666667,6,260,01026,4
8c20ccb4177f1ddeb2f92c51e9e329fb,32,32,1,224,32,0,05030,1
525eb7e0a234e44cc1821b307222d532,135,84,3,315,17,118,08051,3
edebd0bd2835d31a91653bc1dc918e39,48,32,2,168,27,21,08031,1
7a9196dacba8cc16e6c9e667cf2fcf86,62,48,3,144.66666666666669,62,0,03070,2
7803597fa2c9dae83639bfca8e59c2c3,308,79,5,431.2,308,0,05030,4
2d1408fb8024ab9de65f9ab820bed95c,148,94,3,345.33333333333337,59,89,03050,3
c718d7a27e4fe914736dd40a9ecd06be,132,88,2,462,94,38,04020,3
65fa591f077bf38ba92933495c940bd7,175,92,3,408.33333333333337,109,66,09030,3
d940de9a54a1e9d13f164a6a30befeb8,30,30,1,210,0,30,01026,1
9ae14b40a6103c22e67251e41ac098db,400,137,3,933.3333333333334,272,128,05040,4
9a3732481bc618b5de249a16f7266b38,20,20,1,140,20,0,05041,1
73d9fb40a551d50a43aa6a2e211465e9,86,53,3,200.66666666666669,52,34,01012,3
4668e57eff3c42b082740bfb1c8b600b,25,25,2,87.5,25,0,01013,1
d15731e52fc9e2820020c03e5a00b7b6,13,13,1,91,13,0,09150,1
0dfa6018b38f5e29d60d2a62988b365f,209,105,6,243.83333333333334,160,49,01026,4
618b826b5fec71be2b9731dba63bd70d,59,52,2,206.5,30,29,01013,2
b13e81050e49b30bf69cda98ac1811dd,334,139,6,389.6666666666667,248,86,01085,4
6faec98fba7a7fd2345f37a3120dc5d4,83,51,2,290.5,83,0,05040,2
46c7e9198926129f4b0174d528627e2e,202,91,5,282.8,157,45,05040,4
455585d57d0110605f6bd836c37c0670,174,99,5,243.6,171,3,10040,4
10698c9e9b35491d0d53337c5ca7f7ad,19,19,1,133,19,0,05040,1
2813b4fd1ddaaae08d2013e1fc88b417,157,88,3,366.33333333333337,157,0,02690,3
14ff67292de9a515b43eadb1e5f1ec2d,23,23,1,161,23,0,08051,1
5b30dee4140f97e54df1a8664955338d,402,152,4,703.5,318,84,06100,4
8c7709944644ec40ba63fe202493fe7e,142,51,3,331.33333333333337,142,0,11040,3
1cb94b82462e7c0086e0809023ed93d9,133,102,3,310.33333333333337,133,0,01027,3
745f4d45265e038dd2878dbdb0df9b22,48,48,1,336,48,0,05100,1
27a60b22b19425f831f0171708e776b9,171,97,4,299.25,150,21,05040,3
c408b24404ba1549fa8a0fef7252ce72,7,7,1,49,7,0,05040,1
861f6e9743bf7396d81e74cda33d3cd5,82,41,3,191.33333333333334,82,0,05040,2
359e17bbd7013ade2b0f6b7b5522b1bb,14,14,1,98,14,0,12590,1
18ca8edf3a13a609f3e14d0bd131dd8d,156,103,2,546,22,134,05030,3
2dede139cab26211bcc9851b53b961ee,32,32,1,224,32,0,03050,1
ff48a19f6408187556bfd944fb1c6edb,91,59,3,212.33333333333334,75,16,10080,3
3db9af8b14f654728f2ae9167bd1c6f4,19,19,1,133,19,0,04060,1
1888c3767c706140db8efd78c094e948,37,28,2,129.5,37,0,10200,1
ff9a22ddbcbd51a525c7191e77ab75bc,75,44,2,262.5,75,0,05040,2
fde4160634005c9db6f751d0d7eae4d2,24,24,1,168,0,24,02650,1
3ac05222fce737b9ab73a5d34d2b40a8,185,77,6,215.83333333333334,167,18,05040,4
5e48044ea5b712ff1f4d6a0d084b5b3b,65,48,1,455,65,0,08052,2
17953fa9a531e8c83593016eb10242a8,316,172,3,737.3333333333334,263,53,05040,4
16aa878575d46570150425ceafc4b7fa,28,28,1,196,28,0,05040,1
42eda58666794d8a4987b26e092dc894,371,135,6,432.83333333333337,353,18,04060,4
7776446d88b9d816d160d574c2d8cd3d,58,46,1,406,0,58,12570,2
8355eb7cef00a4259a2a91c445521614,66,52,2,231,66,0,09010,2
70b0db162bcfdbc35f6584ac13e1f976,691,188,1,4837,0,691,10200,4
3863a71d45a1045f6389ad97d7e521da,108,78,2,378,108,0,05100,3
da0525349f6b1829ea5c2db8432f755f,26,22,2,91,26,0,05030,1
92fe66b81263835810430486aa5c84f4,1,1,1,7,1,0,05030,1
dd599781e219d4880e1bf5536843ef22,34,34,1,238,34,0,03050,1
8f3f51b1527b876efbe3698bf859b58f,1,1,1,7,1,0,09010,1
f77e8f14e5a0222d502a63290f4997fb,96,55,3,224,96,0,01026,3
5717a1c57086152682d0caebc2439ab1,19,9,2,66.5,14,5,11040,1
9ecf7dcd93182e4feb5b2e775354a1ed,217,124,4,379.75,217,0,01085,4
e35d7922cfbc7d7e5c5e6026bf051f3d,11,11,1,77,11,0,05040,1
3d31c98010368c7119cdf462f6a97f0e,468,153,4,819,385,83,04020,4
6e31cd95b87d74b730ec56362cc3d40b,63,51,4,110.25,52,11,05040,2
451584ecd9cad0de44e9987b838acba7,49,45,1,343,49,0,01012,1
d4e70372df41a1e6c783c1c9bbcb435a,186,125,3,434,80,106,05040,4
2147071c4618d648fd18150c64556c1a,284,138,5,397.59999999999997,155,129,09130,4
4d65f34355bcadb128bb6e29b3d39ce4,150,114,3,350,138,12,01027,3
49430d8d1a1f05d105219f4057378936,60,50,2,210,60,0,07141,1
b7cb0c44517c250c6840c70e20c4e919,28,28,1,196,28,0,05040,1
b52ff0b08047f8143a4b05cbdff37d3b,9,9,1,63,9,0,08250,1
88260a8a770dd088925435db0cad2f59,67,54,2,234.5,67,0,04060,2
a46a94f73232d57644d9909c7a2e53d6,22,22,1,154,22,0,01028,1
89e8b2c85b23d2b96c26bfe90d3d2328,400,146,4,700,400,0,01026,4
a69986ff55a7a432a22a3ed8776289b4,85,65,2,297.5,85,0,03033,2
aa1a637417d28bcf8d90af578b37d4d4,64,53,2,224,64,0,10200,2
98927af063654ce862a889136528963f,39,39,1,273,39,0,01026,1
5abc2cbf3a390905db257a436b8be2cd,15,15,1,105,15,0,11100,1
7a10a206dfea7f3fd3872896402bb1b2,281,122,3,655.6666666666667,281,0,01012,4
ab7a07f8d9d60c297e797048c1b8c408,268,162,4,469,268,0,01027,4
cddd9f7f470c8ccf983ba701e0281076,16,16,1,112,16,0,10200,1
a892f62afb198695758914677d53e8ac,50,50,1,350,50,0,01013,1
a460ba40022ed0049e9f16f70d3a1c31,69,53,2,241.5,69,0,05030,2
51fea56e09faaf37f51cc0fd369ade6c,129,62,2,451.5,129,0,05040,3
b573ac2989fdbe199bb84178fd8b8bc4,47,47,1,329,0,47,01026,1
bd5d2f29abc99db7f4a8d1ffa4a85159,80,49,3,186.66666666666669,79,1,05100,2
6e1ab0ca1b1c5086a3393e59cd9408ff,53,53,1,371,53,0,01026,1
36b8dc26e75ab125af755729b633135f,146,101,4,255.5,97,49,01027,3
b33375c44aa1702b49bcea7a159272d8,28,28,1,196,28,0,05040,1
1e0f65e50d3057ea147f182b58ae5e3e,100,50,1,700,100,0,14301,3
ab92bb48583f81544ad428a4e137d3ae,489,222,6,570.5,422,67,01013,4
862144b62ef385cf6439d3ae554939bc,93,68,1,651,93,0,05040,3
cc2791ce1d9a8c05c20d5d21b94926de,25,25,1,175,25,0,09130,1
700bb6500731559c436f6f0d3b01c869,220,136,3,513.3333333333334,149,71,09090,4
9ed3c7cd2ad53c3572cd6f68faa700e1,30,30,1,210,30,0,09130,1
7620effbb6f6d52bfd8b5fff9000c4ca,147,81,1,1029,147,0,01027,3
22d9a88695aca478b039c0dee10fca1f,36,36,1,252,36,0,05040,1
6ac4488ccc30eec14097980152aa8d97,40,40,1,280,40,0,05040,1
36983d6f8be33e900e2ab5310630e4e6,97,70,2,339.5,97,0,05040,3
41f66af04f87dfecf228793e48dfc145,58,53,2,203,58,0,08090,1
38b18150b1d5a7448401ff562d580137,29,29,1,203,29,0,08100,1
09838ad181872ec6d4d3ab2b609b78b6,19,19,1,133,19,0,11100,1
598726ced043883fe536c50a1c4b16f4,88,58,4,154,88,0,01026,3
35cc9dccf2f29e303dc4324b58909e85,64,50,2,224,64,0,10028,2
b812c7b593411e91a215ce3ea2a2e471,55,50,3,128.33333333333334,55,0,01026,2
f7fc4a29b02de772a56b5dd7c2973068,73,60,3,170.33333333333334,73,0,08100,2
a6ad2febcd1d8be5fe097438eb7ac613,24,24,1,168,0,24,09090,1
0c2463a984a88c489b61d0e8b98a7fcf,30,29,2,105,30,0,05040,1
cf440de8d60ff7d7350765fc2553f7bc,255,72,2,892.5,255,0,05040,4
0050903400103984041efdc280d8da21,93,54,2,325.5,93,0,03070,2
38517416882b7b38945c3d7ec4bb4061,228,59,6,266,134,94,08312,4
10a52edf6d46524fc235f8fc909920d2,33,33,1,231,33,0,05040,1
82845832c36d588a6024b10a6f4cd8ef,13,13,1,91,13,0,01014,1
0c177292b00adf6ff60370492f77e3f2,18,18,1,126,18,0,01012,1
d2c1eafb33ae4ff6fc5c37c2f448b6a5,43,35,3,100.33333333333334,43,0,01012,1
5dde0016f5cfed78dae811e289be9dd5,55,43,1,385,55,0,05040,1
960b43c405536c45f015312c8dbcfc9e,146,95,2,511,146,0,10200,3
d4e216293398286ca07cf72d63138886,25,25,1,175,25,0,05040,1
27a2b2c4d69fb1b87d23dbb6ddafcf64,36,36,1,252,36,0,01012,1
29b12a8a668d89288aaa1d037166119e,10,10,1,70,10,0,13930,1
48d1fd56e7f1d0a7b8bde25212090095,26,25,2,91,26,0,01026,1
867fb7d8bfeab67ea8af020613d68ee8,48,41,3,112,32,16,04020,1
0097b3cb2da118aeea2ad9bd2976253c,96,80,3,224,66,30,04060,3
63ce2a9b4e6c5f9d68ef3cfe47ed3f53,131,86,2,458.5,84,47,05100,3
81b41da72b24b40537aa40f0c35093eb,233,126,2,815.5,233,0,01026,4
9ce1bff28908683520c00d812e976194,25,25,1,175,25,0,05040,1
55c6749fd3852c03624f869a7d530f49,46,29,2,161,46,0,09090,1
1b4a58af9b23569927ef36e2462c9001,24,24,1,168,24,0,02754,1
c8d35e05bb8735853335fbbcdb65b5fc,11,11,1,77,11,0,11080,1
1a95bdadafffb7b7b88d865e63ea5835,23,23,1,161,23,0,05040,1
b1aecb35b0394cec0d5fb9af1d73c18f,102,54,3,238,72,30,08452,3
3f71fe617adad2b48ef2b074f9bb7ea2,19,19,1,133,19,0,12590,1
0051bc212b8aa6fda30ecd3f157a08e9,4,4,1,28,4,0,12500,1
4d48451368fc37ce96986ba8a31ad8ce,84,67,3,196,58,26,05030,3
b3f653883f9640235ebd177651830145,343,145,6,400.1666666666667,250,93,05040,4
a86c1cf82047753e1ef627de3645a910,54,37,2,189,54,0,01027,1
b8bda3adcd327b13f75d290b82377ba6,14,14,1,98,14,0,01013,1
e864d340fd0b3c8ccbcbca0f4425f2d0,83,42,3,193.66666666666669,83,0,06120,2
cb592b0117741ce50499d2b0920090c6,31,31,1,217,0,31,01026,1
1a63f120d28a208f04f23ea818cf9b3e,297,90,5,415.8,279,18,05030,4
13a75f0cad6b84eb17bc8d82a6bee04b,115,67,4,201.25,89,26,03070,3
bb9eed830c999061e337edf89d1c6696,45,37,1,315,45,0,05040,1
322db85f1819dd3f0240fa4acb479a58,64,51,3,149.33333333333334,64,0,10220,2
50dd729269785898a02e5ad4e48528fa,98,81,2,343,50,48,05040,3
55bdb1d4e5cc6bc5285e70011675ef8b,106,90,3,247.33333333333334,106,0,01026,3
5160b98b3bba0e424e43c11b1305aa10,57,57,1,399,57,0,04060,2
aacb8c41dda8bfeabda8d6eb8e11552f,196,113,4,343,196,0,03030,4
dda2fc8e8f6a229d2d0b362c8f997e8e,36,34,2,126,36,0,03090,1
f97a50fbaf400bc4c9cc8a7b16cd35ac,42,42,1,294,42,0,05030,1
0370ea0799501688d7f8a3ff82c606be,14,11,2,49,14,0,05030,1
6180f667161c975f4b087ec15b9d4ba7,64,46,3,149.33333333333334,38,26,09111,2
2d2aff534b35540154766cc6311bf37b,64,56,3,149.33333333333334,42,22,01026,2
9fd59f693a845a8e08bf8a4027d282ca,82,59,3,191.33333333333334,82,0,05030,2
54bec214b7e42f45b637b2524f825644,240,88,1,1680,240,0,01085,4
bfe0005f8f9068295e592db6ec4ceac0,107,72,2,374.5,107,0,05040,3
383fc6214f4b9b9f145c59272a2a11b7,98,71,6,114.33333333333334,91,7,01012,3
ec66ea617d9f73608f36cc1a8d42fcfe,47,47,1,329,47,0,04032,1
f2b9c3b2248712d2a6eb06889f545ddb,33,33,1,231,33,0,02650,1
1a1746fce8aad096eecd237facb69b76,67,61,2,234.5,67,0,12670,2
e2e9de870021f669be5ae250232ba4e9,113,72,5,158.2,113,0,08010,3
e8d65fce402fa6c65316496ce21e1a94,68,48,3,158.66666666666669,34,34,05030,2
eb5f57cb687be138c82cb1862622546c,178,22,2,623,178,0,02751,3
2fba63341534b951846b7b14a09de9bc,438,93,3,1022,408,30,01027,4
f9160f17cae812931d16f135881d3121,35,32,2,122.5,35,0,10200,1
48d221c2d2c2cced7474b1b161f3e403,2,2,1,14,2,0,05030,1
d72dcc846e64caba28e883825e36b8ca,28,28,1,196,28,0,08010,1
528be4dadfc6e77bda9273aa6e226151,14,14,1,98,14,0,08120,1
465f66d1be51df34dda4ee70b98651f9,167,103,1,1169,167,0,01026,4
e61f7a5b6ca8289b21b6f0d2919a5c0b,33,22,2,115.5,33,0,10200,1
5ae74f1e3aaf31fce88e6fda1c4b0eb5,30,30,1,210,30,0,09130,1
fb0978024b6cdf6109c4260688fd0231,80,57,2,280,24,56,05100,2
f4a5593d43be61870cad2da2418feec1,69,49,2,241.5,69,0,04020,2
d49c69fbc131c3c2f47da26e79ae93e4,13,13,1,91,13,0,08131,1
6e4b8c0f2bd51f6efdf742854c26317f,67,67,1,469,67,0,10200,2
a20a5394d844574085326e56a142c5f3,368,167,3,858.6666666666667,282,86,05040,4
80540d61679c14c87adb8db838718066,156,74,3,364,156,0,01026,3
8d91451ada37957a3bc08084908c4ffd,78,47,3,182,59,19,05030,2
3e5c8116adeb9e1e3e2817b11eaf538d,351,157,3,819,308,43,04201,4
b72ef42755fa63e13544d55f724f958b,4,4,1,28,4,0,04060,1
45c01249bfe1da26e12b08215c9824cc,26,26,1,182,26,0,02650,1
5183e6d45af16c67683dc40e3743a2a2,75,58,3,175,38,37,11100,2
db395e49d09721adc3ca28c5c416133f,17,17,1,119,17,0,08150,1
1fdfe916eb4fed12aa8398c76b7fef8b,25,25,1,175,25,0,01026,1
21984cfe37cd5cca769537a59c41f577,46,43,2,161,14,32,04020,1
e72d5da4af0445f6f34b2573bb06902c,177,87,2,619.5,177,0,05030,3
2cc3d4b46d01a1ab4e659d5ce2f2650e,258,115,5,361.2,242,16,01012,4
607cc8534a57029628c8c5d1b9e3dc03,176,67,4,308,144,32,01026,3
7a4e7e97c2c0643f6b8a210ac12a4afd,21,21,1,147,21,0,08010,1
6f0477e7e1b30d2f779908f7db6f4f05,119,68,1,833,119,0,01012,3
233d43ca62a7e2074a87f71d11335eec,99,82,2,346.5,99,0,01026,3
29130ec69df7193a5f489554b3a2e99a,56,51,1,392,56,0,10080,1
5a5515fb1d8ae9a6ef1a54febb4d08ef,93,78,2,325.5,93,0,05040,3
e3e24fb9c93502faff72d2538e676806,4,4,1,28,4,0,12500,1
dca87f97fbb5db67b12882d76efd9888,73,50,3,170.33333333333334,73,0,05040,2
8af6705bd0c0ae25d13ccdaedf432e67,37,37,1,259,37,0,07131,1
a523fe3b2b6de8f8a8701a515e08a6ed,69,56,2,241.5,69,0,11060,2
87dd8fdd2d76272496252d5eca309160,95,70,1,665,0,95,01026,3
b2aef8450c6d735ba34b59999f6bc4cf,563,185,3,1313.6666666666667,563,0,03050,4
e2027372cd84402e267c21eaec895a13,59,51,2,206.5,59,0,08230,1
746339786b13d141204185cfb3e69779,113,73,3,263.6666666666667,113,0,01201,3
ad5b184c6c8e0601314c2dacd78eec64,171,99,6,199.5,157,14,05100,4
76eea0dc7d0f6b4e34f58d140063b9ff,33,33,1,231,33,0,05100,1
6c14dd6736085c6a09a4ded94add8fa9,27,27,1,189,27,0,05100,1
463cd4fa4c0f96a2a1db96e59130a2b4,77,65,4,134.75,70,7,08132,3
f8cdea591fa986a34e9b4dab99733f4a,65,45,3,151.66666666666669,65,0,11100,2
2a5d07ffcd8a573dd5f33f9c127ce84e,31,27,2,108.5,31,0,12591,1
0e108bcb471eb1dfe0640590450d3928,64,45,2,224,64,0,09010,1
b6b11fcbe842e3418cffac339d53ec26,115,78,3,268.33333333333337,49,66,01026,3
461adcde0de72c59afaf68521abc4585,210,109,2,735,210,0,05040,4
21b502d3f60faba798d1aa9c7c66afb1,101,78,1,707,101,0,05040,3
728cd6e9d217c5203354dea0854c97ae,45,41,2,157.5,45,0,13690,1
60ac1f41183f7c4208e99d673b87624c,12,10,2,42,5,7,01012,1
acf4e0f74dca4617937577cea55792a9,122,80,3,284.6666666666667,93,29,05030,3
1980cd3a7c7c86a2564e96bf3cb3c30f,153,69,4,267.75,153,0,05030,3
779775f3c59948af4267565068dd21f6,23,23,1,161,23,0,01201,1
b63969b635e30d89f534afd4071c1f8e,534,144,3,1246,268,266,05040,4
c9825dd2828d3e89541a9ce01fcbcd70,58,58,1,406,58,0,05040,2
4d36073bbb0cd2c4e4cbaa399616467b,125,75,3,291.6666666666667,64,61,01013,3
f5a6448b18d88b277ccfff3343363190,75,58,1,525,75,0,11060,2
e8a08505c99a8608845fb273e6fd9f6b,46,46,1,322,46,0,04032,1
5e9a0824b8dabaa8049116f3626c81f2,262,90,5,366.8,227,35,01026,4
591b71cb50dbd2b3034139f3852209b4,280,157,3,653.3333333333334,280,0,10200,4
61f88aa5d1f2f56420388f47b9c315a8,86,86,1,602,86,0,02610,3
661f6e3b85d47bcf6f1b00c175a03822,63,43,3,147,63,0,05100,2
31297846be255b8dbbb004675ed4162e,173,115,5,242.2,128,45,01026,4
d4919ccda2510421ea4a91f7aaa5c713,157,63,5,219.79999999999998,157,0,05040,3
270c9712092ce557e1fd29f1fd55020e,311,114,4,544.25,282,29,01026,4
4c857b94ef9f3ad4bd005afb88fb2136,86,49,3,200.66666666666669,86,0,05040,2
59ea5fbd8e9eba25fbcc656168dfbf91,51,42,2,178.5,51,0,05040,1
0566dbf84a0141eea849c9db9e6d5f8c,23,23,1,161,23,0,09130,1
4693e9704811ddd680e30dbcfffbc638,140,95,3,326.6666666666667,99,41,05100,3
150e3ae0574f6dd011fd2c056ce17531,56,46,2,196,56,0,01012,1
483bb34fa22b5a5fde2954ccaf36f2f5,201,93,4,351.75,201,0,05100,4
fd48c7f3b912aaaa1a0a06ecd882235e,459,129,4,803.25,459,0,01085,4
58e5b435ece988d957f99e5320a8560f,57,57,1,399,57,0,01085,2
1654d0328b2fe2dc4482d71ff9717f39,35,33,2,122.5,13,22,11080,1
ddd913c83f50aa5364c293dc9e414b60,254,91,5,355.59999999999997,226,28,05040,4
a98049f673f1b380465f8ff7bf87372d,71,49,3,165.66666666666669,47,24,09130,2
bf98ad123cb4b86382069602c9abf1b8,4,4,1,28,4,0,01026,1
91de3f963c3f6fd5e4fedeee1b0571c7,20,17,2,70,20,0,08052,1
950f57462c358b8853c9fd6fd54a884c,528,230,2,1848,528,0,05040,4
3606ce6be89a1fba5ca9facee4751058,234,78,3,546,234,0,05030,4
0fe648e0eb378dd56450929a4b6ca62d,59,59,1,413,59,0,02756,2
ac09b7508a25bdb6b0ceca0eb731fd02,179,92,2,626.5,146,33,05040,3
9774ae9249225a23b986d1f23b4e0acb,140,98,4,245,140,0,11040,3
9c5c9e0aa264b9dd719ccae895853607,13,13,1,91,13,0,10153,1
000c75b30bb0b237ec817d203e88a54f,44,38,1,308,44,0,08314,1
e1b47a2d4ecbc97d4a3901c532ca98e2,545,209,3,1271.6666666666667,545,0,05100,4
0c42f9cf3eb43c42cec1215c80c72807,76,53,3,177.33333333333334,76,0,11060,2
6b6ac30a27c3623686ee6219e2328892,66,50,2,231,66,0,01027,2
ea9f62b740b35751c0b1f73241a2ee96,58,37,3,135.33333333333334,58,0,05040,1
a6257c843a9ea9a6ae8ea2498cd63bfe,22,22,1,154,22,0,04060,1
e03021a653d2a1b09dbc8cfc73731601,20,20,1,140,0,20,02691,1
48b3a7c23648d822597a7c2126af50e4,102,83,3,238,102,0,10200,3
e2cc92386aadcfb64a9cce632248a701,38,33,2,133,38,0,05040,1
9eca66a29d54e50e2c304b31e05f1e41,87,67,2,304.5,87,0,10153,3
acaa578821c8db622a6d2e16c7c2ee99,61,35,3,142.33333333333334,61,0,11080,2
2af7863ac5b36ec0821cea8447e5995f,25,25,1,175,25,0,12500,1
6ac3ab28d46ab7e6793c711074dc895a,23,15,2,80.5,23,0,08230,1
a65f911d74a4a05f4a6ac61986250429,46,46,1,322,46,0,01027,1
2d98b8548183859072a6ab589643fa34,50,45,1,350,50,0,01026,1
3574cfe60e2c3cabc53cdadec8216563,198,73,6,231,134,64,08314,4
9844fed2ea158d2cdf36801fb545bf56,22,22,1,154,0,22,05040,1
f7d91bf7a86e97aa83a5911edc5e9f4f,32,27,1,224,32,0,01012,1
ba6e36eef80c7406f8da8f57de5b6c83,109,77,1,763,109,0,10028,3
27b9277a9dc8c3e559ec0e952760a2ac,116,92,3,270.6666666666667,64,52,01027,3
5cc2c073b634b6f1a91c96bdb751ae25,155,96,2,542.5,155,0,01013,3
08add61a4af668093ea4087af2335230,69,57,2,241.5,69,0,10140,2
da0944e139ea94554b1231cd974f43ef,46,46,1,322,46,0,05030,1
c702723079538986d09b3af7daa59021,45,37,2,157.5,29,16,01012,1
a226f1cdc5a5445686cc7fe79d5b139c,28,28,1,196,28,0,05030,1
bae65b973427a10981d8ab14443ca84a,297,97,5,415.8,225,72,05030,4
b2206b62fe6c74e3731e161ad1d33663,52,52,1,364,52,0,01026,1
9f159fb09fbea82384d9504e2a1aee03,143,87,4,250.25,102,41,05040,3
c7bf1ee45860f99189e8b928001b79db,146,97,3,340.6666666666667,146,0,11140,3
d4c85d252e35331627aaeebf4ae80e70,62,53,2,217,62,0,05040,2
e0da0645fa137b1586d41ac2e89e69d5,31,31,1,217,31,0,01201,1
62d12c83b126831138170dcb0b58db9b,83,70,3,193.66666666666669,57,26,01012,3
b7f719da2dc61baf862ff8a7a9d9794c,47,47,1,329,0,47,05041,1
72b86b03a2203e38a9bfbb83b48a0a36,80,57,2,280,80,0,08150,2
108d1503dd411fda78968d82a95cbdcc,14,14,1,98,14,0,08232,1
c96d355baa64fc7149925f0b9894e440,47,47,1,329,47,0,05040,1
5884f1e5b50352ed294e5713bcea51f3,60,44,1,420,60,0,10220,1
687223692cb56689ac379e55c0931420,146,95,2,511,109,37,04060,3
8dfa60df3d3da3c0ead654bbe3b1970e,14,14,1,98,14,0,09130,1
5f811d7e944a9b7f47b2ee9396a08911,67,67,1,469,67,0,09130,2
38f8851e1895825082983c6266a96a59,116,72,2,406,116,0,11140,3
32815db142c27e3b6a4a59bf751330c6,29,25,1,203,29,0,11080,1
9a0d344d32d8db19730118411a022a90,4,4,1,28,4,0,08210,1
f7b8badb428578be5f711514eb862539,27,27,1,189,27,0,02650,1
94bc31fc3a510e17aa90b1f5e9239dbe,11,11,1,77,11,0,04201,1
f9d8718788838d1415b4c46051aef0a1,60,59,2,210,60,0,08100,2
89cb202a4cf91fc67139ced8a3aa785f,350,179,4,612.5,271,79,03033,4
5a2d830ce618ecda587c2e985a4f653e,9,9,1,63,9,0,01026,1
dea835e8ba4eff43eb6423876490f22c,42,42,1,294,42,0,01012,1
f67b2100ef3b746202eb8fc55e27df61,167,90,5,233.79999999999998,167,0,01085,3
f752b44a3844650d8def0d27074d8851,22,22,1,154,22,0,03050,1
29ae5cafb4de483458360c7a55464b42,70,68,2,245,2,68,10200,2
a28f0e7f45933824e6cace7a040b16d1,110,63,3,256.6666666666667,110,0,09010,3
b479d663b142e67a94a9122d599bba6c,22,19,2,77,22,0,01027,1
e0d1da2c29a32d396ee56b6851a3772a,23,23,1,161,23,0,11100,1
d29c28dbef8807eff5517ac37ffed3a9,49,38,2,171.5,49,0,05030,1
dcf49f66fec11473096b06e8a493dbe7,48,48,1,336,48,0,05040,1
0ce491e3a290f29db6b3f598997afbc4,97,58,2,339.5,97,0,09110,3
26ec78279d1f1aacadeeacd441375c25,82,62,2,287,82,0,12470,2
774f4994327d32693300f0a54b678b4e,141,96,3,329,76,65,01026,3
b3e94b6cd90ad9fb8be9f6fe3c0e1f99,92,67,2,322,92,0,05040,3
40966db7b3e4f6fa2edbeb96e58e5f6f,279,176,4,488.25,232,47,05040,4
8a9684c2702ec1fdc4ba0082e38fe190,43,32,3,100.33333333333334,43,0,02720,1
65dc92d82601f73217d25f369da35e38,8,8,1,56,0,8,12570,1
d47bd190da658b35e58abba2aacaeb2b,62,51,2,217,30,32,05040,2
d3de5de16a27ff1e3fc0aa647e977a87,38,33,2,133,38,0,04200,1
040fda55d974d7121a7b3bb52e8209c2,45,41,2,157.5,45,0,11040,1
af655cd8904e9e83b8bd66cc07a7b2d7,95,66,2,332.5,95,0,01026,3
9b44fff20642ef92c9d10ca041788831,49,30,2,171.5,49,0,05030,1
e1ee191e5a71bbceb2305f1cdde8c729,73,50,4,127.75,55,18,01085,3
0bc19e736e607cdc3dd5b43cdb000376,18,18,1,126,18,0,03050,1
8b48dddad430509313d9878a59f633c7,90,43,3,210,90,0,05040,2
1e6f9b4ff76cd0e88249b53e3a191789,213,111,4,372.75,213,0,05040,4
62a79fd5f3c953843d4f044b909d0c06,140,76,3,326.6666666666667,140,0,10240,3
881ed194e91e2b13cff51c6386a3fb93,32,32,1,224,0,32,01013,1
ae2f9327a8d222dc2cbbb6c036152172,289,104,4,505.75,258,31,05040,4
35f8735f130b9ec3ac4d0e467b29aded,95,87,2,332.5,95,0,03090,3
0690b86d4b892e331e8a856a6a2af0f3,147,100,2,514.5,67,80,01026,3
51d1655fa7a255733ced010117ce574e,28,26,1,196,0,28,02690,1
6ec43f0b491461d28eedf05454f01f38,137,84,3,319.6666666666667,137,0,05040,3
73e84e3cacc81e4ddb6d710b68a4298d,37,24,3,86.33333333333334,37,0,05030,1
7ce46c2fb06e1b3e847eb210d2603cfb,5,5,1,35,5,0,01012,1
862a7f5102a61a2dc9e8217b906fc218,171,127,6,199.5,153,18,08090,4
47d6bf0915c42e086d85019525da736c,138,109,3,322,138,0,05040,3
3b64db611d283700b09692973dfb8bbb,265,98,2,927.5,265,0,01026,4
66cbfaddf9d9bbcf282afb99b644f012,273,132,3,637,273,0,05040,4
081c9733abca795367b01081b71439b4,22,22,1,154,22,0,08032,1
db4d7efdca0de676772bf6788e998f21,25,23,2,87.5,25,0,05120,1
cec4b1b585d88c99b4e4cc6e7782a894,11,11,1,77,11,0,05030,1
71e236c2ab0073a8e6d2dea2b9601f9a,130,103,2,455,130,0,03090,3
b4dc1ece554f4aaf4635a093a98924cf,1,1,1,7,1,0,10220,1
15d90d539cb3b3d86efadc82cde131d8,28,28,1,196,28,0,01027,1
ea02a384e1e73e856bcc0c2b1a1de6c5,139,102,1,973,139,0,01027,3
30db3e4bad20e7eb367c932a718acf72,50,41,1,350,50,0,01016,1
8d7eb63635ebb71fd2fba44a191552c0,36,23,5,50.4,36,0,12710,2
7fbffc22589b60275597ca5f9b87c6ab,43,32,2,150.5,43,0,03090,1
bd9a971ac990a4d145b9bc2067325ef9,43,43,1,301,43,0,05040,1
2f29a1ff5d5e86b2bf6d3e36e8e4c4cf,23,23,1,161,23,0,09090,1
2ac3f950972e7d3991970fd92de86773,48,38,2,168,21,27,11080,1
32712f619c69b254918235f708190310,16,16,1,112,16,0,05030,1
67a34eebae1a93b318f8cf2297180098,62,36,2,217,62,0,08230,1
fe0ace677f413a86c68679f544dd5c73,25,25,2,87.5,15,10,05030,1
f2becb9f929ca51e98638a565059f373,28,28,1,196,28,0,05040,1
3cad63908dc9846fece74a539d3ab3fe,150,95,3,350,97,53,01026,3
e5b2817d305f4a9e831814d0dbfebbb6,38,38,1,266,38,0,05040,1
19edf384e408d2457dc785f9d1263680,209,66,4,365.75,209,0,05040,3
bd22f737c406cff7c55085c9b9407982,32,32,1,224,32,0,05040,1
437c8496308e7271bf160f5dc1d71d67,33,33,1,231,33,0,13830,1
d8fbd9d34f1f5793193c3e8db7ff72f5,9,9,1,63,9,0,10080,1
087a148cb78aaf2e443fe54c1210a313,30,30,1,210,30,0,03050,1
dd4db0a32254511b7c49cd4f37b800d3,76,56,2,266,76,0,01026,2
b2fad5e6426e5eb421e177b76b57cfeb,11,11,1,77,11,0,03070,1
7b37cfe55caceebfc25139921609ba61,100,52,3,233.33333333333334,100,0,10200,3
af57d4644ffe5a1f680c5a24d74e16e9,45,38,1,315,45,0,08100,1
96892469220bf0ea610b2158e710b07f,146,84,2,511,146,0,06100,3
044c2a479cc4ec56f319d18216bd15d1,151,86,2,528.5,84,67,05040,3
c11a795d1c1cf682a7128ef0c6255244,6,6,1,42,6,0,09110,1
f052f2b8e8dab09e3957f48371d4c118,148,94,5,207.2,82,66,05040,3
fca665372fa3695bfedeef1b990182df,175,130,3,408.33333333333337,175,0,05100,4
2d55c05af14a1751985934be0d828302,32,32,1,224,0,32,01026,1
a1a1f9f439d1470ae64006306790d26b,43,43,1,301,43,0,01026,1
58b47c5f33eeb1617ce6a05f3bccff1a,76,47,2,266,76,0,02620,2
c0daf623ccde9b809e47523ffb5df1bd,143,79,2,500.5,143,0,09130,3
66cc4b1b36e4e48d3fc02f7c86c76c26,43,43,1,301,43,0,01012,1
46052856c865e253349ed1e0b361353b,65,65,1,455,65,0,05040,2
483d7bfd990ba11b433a7f77cbae7e4a,82,74,2,287,82,0,09130,3
9ea2db65b9086b2376a7822f9ac5c73f,107,82,2,374.5,107,0,01027,3
9f957361fffd0f8c52e4759ea39568d2,59,48,2,206.5,59,0,02650,1
600ffc9e9c420be15fa0eab1c8970055,75,60,2,262.5,75,0,06100,2
9752e4fbaec4af91f484f9348e050656,17,17,1,119,0,17,05040,1
9591782aaa28fd01dacb239aecbf6c25,38,28,2,133,18,20,11040,1
7380c7fc7741a41f33a83f558f724137,43,40,2,150.5,18,25,01012,1
b2f58f6d245e79c2a2bb3af441cdb28e,55,42,1,385,55,0,08452,1
ff452248dc798ccdf48e07ea4fe74da4,30,30,1,210,30,0,01026,1
d2724f9fe09f73924dd30d097fc9409c,92,92,1,644,92,0,03090,3
5ce842e465a02fa8e698f82fd3484c4a,34,14,4,59.5,27,7,09010,1
1553238677099cc75373a97d78e8c7a4,57,51,2,199.5,57,0,11080,1
62e741139fbb73f74121c69d8c21b3f7,1,1,1,7,1,0,11180,1
f50e256b251cb9f6d022db2ec79e63ce,309,149,6,360.5,252,57,04032,4
891f30f804e235765add3ff0f61d4dd0,172,107,2,602,172,0,02620,3
3a5ac4ef813b4548b041b9ab2726d9c9,1,1,1,7,1,0,09252,1
f7a2503a987345a36b441f161d9a510e,20,20,1,140,20,0,05030,1
49bf969da9b75a7b04c291fd41194ad0,46,41,2,161,46,0,09130,1
f0e935bf2cd548ef1bd09a6b27b1d362,34,34,1,238,34,0,01026,1
abb07bb86a84e2f5b13d6a35ed2ed8cd,57,57,1,399,57,0,03070,2
22decac7f054a028c94f8d5a9b1da7e6,17,17,1,119,17,0,05040,1
66770e821fbc7798222afb3d7d95f736,77,65,1,539,77,0,08032,2
9647b822d51d019e3fbff67e4141048e,321,108,4,561.75,321,0,04060,4
ed19442cfd910efd5d9232d3608f0f03,32,32,1,224,32,0,05040,1
003fa3344cb647a6af3ab9c765e86ad0,118,55,4,206.5,118,0,14301,3
372760197aaab41b45c15df91316ae0c,11,11,1,77,0,11,13830,1
48fcab0ba1af45cfe9f86aa2cf3b5c62,96,55,3,224,78,18,05040,3
f395ea251e4b3891a1e883bc7ad20eb5,76,62,1,532,0,76,01012,3
0f216c6b998a9ac0a8b2dfa8fc8a35b4,47,47,1,329,0,47,01026,1
20658df31b9b728b8309c0e4c3eb4116,100,81,3,233.33333333333334,100,0,08230,3
2fa09d174109bb3e5392547bcf02dbab,71,56,2,248.5,71,0,05040,2
6b32237ab90f24e238309cd2befdc7ba,160,84,2,560,1,159,01012,3
8a1424d52ccf2017cb46d23fc20f00fc,17,13,2,59.5,17,0,09090,1
ba6a0aacaee4e526a5e6f153ad6e0e6e,116,53,4,203,103,13,12470,3
a4045d27909d53a7c3d411f60626ef3f,9,4,3,21,9,0,11040,1
ecb7bc32db0a0a7ae3a9f10a82ae52ef,35,35,1,245,0,35,01201,1
2049f53d5540055111dbe7b7d371ea54,106,68,4,185.5,96,10,10200,3
a0f30dd81fffd0ff057fae085e665ee1,335,176,4,586.25,262,73,05040,4
ccbfaa49f92a475fa061fc160f052658,145,80,3,338.33333333333337,113,32,05030,3
434f8400b70e3e0527e9013f33270f22,1,1,1,7,1,0,11040,1
ede63438c16c37cfe0c3082c895fd563,80,54,2,280,80,0,10200,2
dfe6718d9480b44bdc98f11667ce7f40,159,115,2,556.5,69,90,05040,3
8c7b13eadd02c32246bd44c005a2e827,61,57,3,142.33333333333334,58,3,01026,2
c3320771117281bf9eb20f4c003f7ee8,14,14,1,98,14,0,05030,1
755414371adaa5c0abea5bfa94454d25,105,71,3,245,105,0,14301,3
61a0f8b4039169bd7b0636bda2e2d0fe,84,69,2,294,84,0,08231,3
927007647da2400c423d2e8e22e693fa,385,169,4,673.75,385,0,01026,4
491f1b6f8e41dcf80d6e4d56a4ce2bd7,22,22,1,154,0,22,08090,1
07cf157c854de2f7df347ce71647b5f4,147,77,4,257.25,147,0,08452,3
37232d560522d8d7ef4a66788ff0c2d7,275,129,4,481.25,275,0,01085,4
e3f4dfe04ebe3d4431c04f6f3fb3137d,203,99,6,236.83333333333334,176,27,06100,4
43977489c75518747e615ffc26ef0d78,8,8,1,56,8,0,03090,1
00478fca5f47d1445f01045dab55c537,57,57,1,399,57,0,10220,2
cd7040086e67108023ee58e0003829ad,20,20,1,140,20,0,01201,1
ec29b4a31bd29c365496e6c71fb34216,47,47,1,329,0,47,05040,1
7ca5b9733312c573b4d1e455d0913c26,353,175,3,823.6666666666667,179,174,01026,4
91f108523192609981670f928ba48876,136,74,3,317.33333333333337,136,0,05040,3
0c9d3bbe158715568a9a0511fa476866,276,151,4,483,192,84,08090,4
9132e5ebccc52ff4541240ecc7af2907,55,55,1,385,55,0,09130,1
286364fe506ac4382ffb2953a45865e2,32,32,1,224,32,0,01026,1
4d7f5b62adddae9f4dc3718563ffa1d0,147,107,1,1029,0,147,11100,4
dd7756550376bb2a9a1edc58abff5739,26,22,1,182,26,0,01085,1
4a3f06cb966bd970323bd6527ac51a83,23,23,1,161,23,0,01026,1
78a02006309d5cc8d150d144fd714b01,22,22,1,154,0,22,01013,1
aa4685642e16931dad012ea32ffeaf66,31,31,1,217,31,0,02690,1
d1e5ac5ba7badf4b41bb88b7e590e91a,69,43,2,241.5,45,24,11100,2
2e3cb8dba06fa4d0ae336446679ba265,70,57,2,245,70,0,01027,2
b8a9f7e01389b4836ec79176e052efab,85,66,3,198.33333333333334,61,24,01026,3
ba6d1df0d785bfa5a436daa3f96bce47,104,79,2,364,104,0,01026,3
98f37eee6b4bf4bc2f35074ec1f42339,60,52,2,210,17,43,01027,2
a573fa3347d4269c8d8c60f86756dcb8,35,35,1,245,35,0,01012,1
ab3c9b28f99d87fd195aca2958c9c131,57,52,1,399,57,0,05040,1
a3cba0fbc05bcc5e06faa920221e29fd,61,51,2,213.5,61,0,01026,2
2293ba9d1e764c2add0e70344cd408bb,48,48,1,336,0,48,09090,1
1a3c7d5689d1fbf6f32eabb7585c9369,51,34,2,178.5,51,0,03090,1
34512764965867d99f5c9e4aee3714fd,74,62,2,259,74,0,01013,2
96c1cb5a604130a8197692991d5c8a82,285,109,4,498.75,257,28,05040,4
f6c8ba39e7f0b253586995df6c84ea44,265,128,3,618.3333333333334,265,0,08052,4
ea09c24d90745279b11dda2773feb448,133,32,4,232.75,133,0,12670,3
3616878de43f89f788acfe56579d87e7,47,47,1,329,47,0,05040,1
f731ebae22226940340cf63f815d9a7a,29,29,1,203,29,0,12710,1
7eb0f2ef58a98c4f909ea23ba2eabebd,134,89,3,312.6666666666667,134,0,04080,3
93841ac2c4ac3a43a03f17e17c0555f0,21,21,1,147,21,0,01013,1
0d0e42b5c26806b03ec01ef83719987b,12,12,1,84,12,0,05041,1
bca28d4578cd49e3d692741b9f6f5027,292,112,4,511,292,0,01012,4
9160b3dbc12e4b78e4112803e66ba291,31,31,1,217,31,0,10200,1
2673ae0433ef34653cd37c67ee3ad68b,84,70,2,294,84,0,01201,3
0ac0ff487d02359378481623c672acf1,169,95,3,394.33333333333337,52,117,05040,3
8e8af815014bd4d49201701331fb26d7,59,59,1,413,0,59,01026,2
2e7aa4517fd4dea580c9f39fa07a2270,5,5,1,35,5,0,12470,1
33b0fc8fb8d9527ed8518a809d97f8d1,10,10,2,35,10,0,10040,1
1e8ecac45fe560ac855a48e28b627da2,41,41,1,287,41,0,01027,1
ad0fabd1fbb311a3096c92c116354696,38,38,1,266,38,0,08032,1
a7ebb4a12c5cddbb602f0690598add33,45,30,1,315,45,0,05040,1
4f2a0cd5014af84e01557198d9cee5e9,133,95,3,310.33333333333337,96,37,01026,3
c38119b9913319d16a3337ce4fac6a5c,230,112,3,536.6666666666667,198,32,10240,4
d45d3a9ce7561b284719da36a4803a04,19,15,2,66.5,19,0,11040,1
e2c35846c4a554e542cb58849f5fb8ee,41,30,2,143.5,20,21,05041,1
3d9c687eb3ac973e02a88575f86b4ae6,10,10,1,70,10,0,09010,1
3f9c42ec7a7228322d40d1915369834a,113,75,4,197.75,113,0,05030,3
ac16660349c0c1380c2d9afc4fb9e150,35,35,1,245,35,0,05040,1
4a7241fe2844e6d3c391e3e0a026e6d9,177,78,4,309.75,149,28,10200,3
ab9de26bb079e448fc631bd69d912a0b,227,89,2,794.5,227,0,05040,4
fe764aa30740e1d16bf091079bd0b142,47,27,2,164.5,21,26,09150,1
a92cb1896a8a261a3c7b53edb30d6977,71,40,2,248.5,40,31,05040,2
4e3f38fc1fbda6ff608652dd9fc3fdf2,85,67,3,198.33333333333334,85,0,09090,3
c2f0ed34f5cfe9f7d0e6b441c14e432e,60,33,3,140,47,13,11040,1
8f836dc41590241a421237f7582cfd0a,15,15,1,105,15,0,09130,1
d5a42cf2afa7bf806702f01233514fb8,6,6,1,42,6,0,12500,1
07fed77c1deaf600c6cf008a1e0f4f19,250,124,4,437.5,160,90,05040,4
30ec56bbde2ce5254434cb47da2a45ee,21,21,1,147,21,0,08150,1
6e3f275325abf0a5de89e3667f14e069,39,31,2,136.5,13,26,05100,1
5c327a2168a8f0765e65daba5bbd5f6b,20,20,1,140,20,0,01027,1
54f97521e52d0701edf1ddbc41e5334f,143,103,5,200.2,143,0,11080,3
572d87ac4518f117176fedc54c713764,25,25,1,175,25,0,09030,1
0a252c0a5997e8dfa315306ff9611edb,26,26,1,182,26,0,05030,1
86403f34bedb9ed69930cffd99a246f1,47,33,3,109.66666666666667,20,27,11040,1
7f05741a7649baab9d0a46570a998c7d,64,56,1,448,64,0,01026,2
9169274e459f8fac5c8dafd57fb8ceef,74,50,2,259,74,0,11080,2
8260b0b3ef5d832f495683c7fa721a5d,369,125,3,861,342,27,01085,4
141a1e2524ca6851f2db29265eef6904,73,47,1,511,73,0,05100,2
15582c4fa783b69f9b71f3e19a042fcb,171,58,2,598.5,78,93,11140,3
b9411518701c49862254101d9d37ec61,35,35,1,245,0,35,10200,1
8ee99b6d0cd0d19f095145a1e8a9592b,236,152,5,330.4,208,28,05040,4
6176eddee959756d08c98ffd03e0fd3b,5,1,3,11.666666666666668,4,1,11140,1
811d1cc7473fa00791db0ceff8b65c42,31,13,4,54.25,31,0,12501,1
4d3677e7c640847ed4553026dc13ccb1,163,99,3,380.33333333333337,118,45,01026,3
7865656be899e4bc806e289474ec3b0c,331,127,3,772.3333333333334,228,103,05040,4
4ec791f6397e7a658d7d4affec08fdd9,103,64,2,360.5,103,0,05040,3
75368d0ff448ee3eeaa1d4085c1f3b84,84,52,2,294,84,0,01201,2
0c4983f4a15006ddaf86cdba9be607b4,82,63,1,574,82,0,05040,3
a84cf8cfbc2b7c00176e3dd999f29d2d,26,26,1,182,0,26,01027,1
114ad2e58e6c0f58d18c3535e751c6ac,170,117,4,297.5,130,40,04201,4
82c5f5d8735ca4f9b47d977959487c47,84,56,2,294,84,0,05041,2
7470f2cf5eaab07f70f2a9d69cf2c4d6,40,40,1,280,40,0,10101,1
55c122e78c097df65e799cc9f5f3c8ba,149,97,4,260.75,129,20,05040,3
c8e380891e7987cca1871bd23fe70f09,39,39,1,273,0,39,01012,1
86d275088bf476a8f14fb45c4b7244d7,47,47,1,329,47,0,10200,1
a6752436fd7a5a409d3773edfb7e3c5b,23,23,1,161,0,23,04201,1
9ea052ee6fc219352680273da7e45801,23,23,1,161,0,23,02690,1
5a3ecd34b8ad48a986e75fb9e90293ed,55,49,2,192.5,55,0,01012,1
b9a91a95be08403aad98b1a745c25ebf,28,28,1,196,28,0,09090,1
97faf0b03115ede0290543adedaae1db,75,75,1,525,75,0,10040,3
acb871b5fe4cc31318c6f44c1201eed4,91,64,2,318.5,30,61,01012,3
2685f0a66e1d10b8b87e97bdbde0ed11,13,13,1,91,0,13,02620,1
200b52a445318b315c0a75c0de3c37b2,70,60,2,245,34,36,05100,2
22e995e8f96d12aa9c63ec7a779d478c,164,91,3,382.6666666666667,120,44,05040,3
7326f6a592ebb1b23f56a652ec671e6d,272,100,4,476,272,0,01027,4
2235b9fcd2b8651f14f55a39cbe0fb11,192,95,3,448,192,0,04060,3
5de5716bd5d5483628cbea10afa79b80,178,74,3,415.33333333333337,34,144,01012,3
df7b4156fe8931b7acaab709a72fdd11,46,35,2,161,46,0,03090,1
7df45d36c3d4abfa707173609bcd746c,130,91,2,455,130,0,01026,3
cbafffa002c2eebdde251d41bef791f2,5,5,1,35,5,0,07143,1
26ede3c66d08cbf0bdd1012aa4c5ac29,32,28,2,112,32,0,03090,1
a28ea300841ccde115e5eefdc0091ada,124,79,3,289.33333333333337,59,65,01201,3
fe0344d9be8573a402c6045bdee8fe8d,21,21,1,147,21,0,01012,1
9d2a3c773084e788d6dbec40c4038cd6,151,103,1,1057,0,151,11100,4
df5c7eb7729d8bf39c1d09e4bceba39e,54,45,2,189,54,0,03090,1
f59d4b1d1464e9e1b20c330ac7514e6c,85,74,4,148.75,85,0,12501,3
c0e407679be825c62a4de5c74f3dcc63,37,31,1,259,37,0,01026,1
325b2f46be9811624196505adbcf61ad,72,72,1,504,72,0,05100,2
956706385af4c93c365fd8a3bb00c3f3,74,54,3,172.66666666666669,41,33,09010,2
8557682475cdb6b7ee8e2f6b55e641e8,375,129,3,875,375,0,10240,4
2fa15daaae15f440d0fb2afc94312efc,25,25,1,175,25,0,11080,1
0c9dfeb49db36bf47371d72adc30ffa1,33,33,1,231,33,0,03050,1
42e4872a39a935ca3bf5f154398e13af,33,25,1,231,33,0,13490,1
5ffa04ddc43c9ab974118caae24dd2ae,77,63,2,269.5,77,0,10200,2
9ac454973df4d430f6fd66852bb3bb18,29,29,1,203,29,0,03070,1
f8fa0aa737d17eee58e4af9983835592,203,132,2,710.5,137,66,01027,4
87c714fd96fd8ee68a80432f31f86061,224,113,6,261.33333333333337,183,41,01026,4
01d87e6d090f4d8e3b8fc3662e0e69a3,13,13,1,91,13,0,01012,1
400a632374784424bb153f5613493e6f,203,92,2,710.5,203,0,05040,4
bcd9c0326361c99e7d7550175ecfd6de,46,34,3,107.33333333333334,39,7,12500,1
787ec11c336183a52e5426d511488a3e,161,94,3,375.6666666666667,161,0,08150,3
c5414bf46fa0056babd9a6d441548534,1,1,1,7,1,0,11140,1
31fbec26867f54c2233035b391258548,27,27,1,189,27,0,01027,1
ca3093787a47f0be998c1e4c1e251584,12,12,1,84,12,0,01201,1
95db27811895e750f6e542bd1789136c,38,31,2,133,24,14,01201,1
a0c3c8b8777636c87c5350436667097a,70,47,3,163.33333333333334,70,0,01027,2
acf7c85b96437d2ecf31b77e4a882253,160,69,4,280,120,40,05040,3
2913108b564f5e1ad72b2501337d80ca,32,32,1,224,32,0,01012,1
aa30b2152baa18dca5a7601ffa431112,141,103,4,246.75,141,0,05040,3
d4602d063321d919b50c88733028182f,118,76,3,275.33333333333337,72,46,05030,3
bc79640c152fb12d4fa5420dc4597fbd,35,35,1,245,35,0,01027,1
8c857cb551c3750d9b2e7b673b192e44,94,79,3,219.33333333333334,94,0,01026,3
cf00dd22dd86302e41002938488256f2,123,90,3,287,75,48,05040,3
f393f8410ee62baefc316f2ac63b1eeb,33,28,1,231,0,33,03050,1
3e44ab12be0b239a20cf16727f159d5e,188,119,3,438.6666666666667,188,0,06100,4
a89fa59381fb2a9c2b0067946d894fd6,105,69,3,245,74,31,01016,3
34e95c124399e6716c8c9f77a4a1e1c0,28,26,2,98,28,0,01201,1
07b68675de96aba6fb2968bd591322a1,30,30,1,210,30,0,02750,1
3e50a2575aa0405ac70ea781014ef733,30,30,1,210,30,0,02751,1
96a58150911d00ae94954308266ab57e,13,13,1,91,13,0,12410,1
bb25edefc7b1c82c9dc7b51c7c6bbc2f,30,25,2,105,30,0,05040,1
9a31a2be21fe066a563c4533c0e22789,59,59,1,413,59,0,03070,2
5e75ec09928a6aa4049492bc0cf05116,111,76,1,777,111,0,03070,3
4cb8fa8f961bbf01e0f336bc946f1d98,197,111,3,459.6666666666667,197,0,05040,4
2a68c459c3ccd90bd29927140e31b5e5,302,106,5,422.8,275,27,01012,4
1d05257d7c63b0733a7515622f3d2712,31,31,1,217,31,0,08052,1
6fd6d59562e018dcf440d63875c4b6b1,26,26,1,182,0,26,01027,1
66acf4c3ffef7f7981098255df4bd1b9,38,38,1,266,38,0,02691,1
0bd16aac79cde589048db4873cffc788,34,33,2,119,34,0,09351,1
4d2a1f9803ac41e38c884a04e0a8179b,11,11,1,77,11,0,01012,1
aae4944aebad760ccddddf4c0e28cc79,132,109,2,462,132,0,09130,3
16694098efa2ccb70ff7725cbd07153f,29,29,1,203,0,29,01026,1
263bc3e6165892f057b904a7bb796ec1,9,9,1,63,9,0,01012,1
2164a290395fdcf535506d98c372d3fb,35,31,2,122.5,35,0,01012,1
f32b9c03eef7f8a976eb4ad9c7bd3f5c,3,3,1,21,3,0,12530,1
2e975ddcce1e5155f23d5b06cf34f1d0,68,57,3,158.66666666666669,68,0,04020,2
8599e3d1cd9ca41c601e69217579a474,243,133,4,425.25,177,66,05040,4
c9c26f293cae836b9c4f0486d6b68cda,44,38,1,308,44,0,11100,1
52f0f1b2dce6b3c02e25808d4b70a294,64,64,1,448,0,64,04060,2
1848b9b97e76ce5a4b97ccb51da8e931,179,107,5,250.6,163,16,05040,4
fab17d6148adf3670e29df9e959a6f8d,109,87,2,381.5,109,0,01016,3
3cc5975c2ff35095f298c2472c7d8aee,21,21,1,147,0,21,05030,1
9dc7749bee518b98e7d2003f44beda80,13,13,1,91,13,0,10141,1
1663644cc0468245aebebf076aaa8237,166,68,4,290.5,166,0,05040,3
4a017daec32a2f8adfc25b658829b32a,145,100,2,507.5,145,0,10200,3
1912d28da3d368e0bd6b1f0a36ac22c6,7,7,1,49,7,0,01027,1
49b5dcf5e56f5065caff6ea013e9f520,26,26,1,182,26,0,12500,1
5742ab623b5fe13f022589287d756b47,226,105,4,395.5,190,36,11080,4
aaddc23f200dbe08a4c9b8fb5291a9dc,163,80,3,380.33333333333337,102,61,02650,3
190caa95ac8e66ae8bea1c184f575e38,18,18,1,126,18,0,05030,1
b4bf9c02d6411afedf1d8649815ebe8f,33,33,1,231,33,0,11140,1
9647a3ba28eb73f96c2a96bec665d1a0,77,48,3,179.66666666666669,29,48,10200,2
59a117628ca42af205a2b8765ba0e922,29,29,1,203,29,0,05030,1
f0efb472d22f1023acb7f5ebce11b41b,87,46,5,121.8,73,14,05040,3
a75a561277ed7cadaa4ee81bcaf3ec63,27,24,2,94.5,27,0,04032,1
54f4a4f921751a5b2fbab32a4c60ef15,32,32,1,224,32,0,11100,1
f6f390a2146c51cb4902a2b12b249553,326,185,4,570.5,295,31,10200,4
bb7cc91d50c3d93716df196bb2ac92b7,23,23,1,161,23,0,05030,1
52e7e16e1d7681deebba1c3b3d58c1d2,111,65,2,388.5,111,0,01012,3
c885bda036d55ec8d43861bdcce2481d,78,78,1,546,0,78,09030,3
11a4c8f3388f5338dc5b213c86ed7632,29,29,1,203,29,0,08100,1
b7cda39d5142988b9fe2ddda65e698d6,45,45,1,315,45,0,05041,1
7b9f8c246b54a7ae961ac1ea7b6b7a26,28,28,2,98,28,0,04201,1
7a15cc8832b558b4776c03d5853f3472,29,29,1,203,29,0,08010,1
611a288a2b52eb25bed641cd8d1565ce,16,16,1,112,16,0,05100,1
24e6637947ccddf60170d5e8449e8415,55,37,2,192.5,55,0,11080,1
6eea3240187359ba07fee537ea80165d,17,17,1,119,17,0,12501,1
2200d99170e597ff94e37ed7320e7f85,30,27,2,105,20,10,10040,1
68571fcf1a4622230bfa86d7124a20ef,75,54,2,262.5,75,0,05040,2
3a634fa6a97fe14e122fcb5d5953389b,198,108,3,462,198,0,05040,4
51518bb6e59b4dadd6d2edd57e8f616e,15,6,2,52.5,15,0,11040,1
6014bfd0e89780b0ac30c24238406932,21,21,1,147,21,0,02690,1
fdcb55430594b93c81e56c2147a904eb,216,114,3,504,216,0,05030,4
5e915a49c7495e9bab61e9e99ec46054,72,58,2,252,72,0,01013,2
53866eecb873e34af1fc06f4a544d31f,49,46,2,171.5,20,29,05100,1
c402afec692b4007fa703cd42a8288c5,145,83,4,253.75,145,0,05030,3
cede0fbaff2aa3d83b05833c023eaca9,59,48,2,206.5,59,0,05040,1
9b36e90c76cf836d62d1d7cb7d315298,53,53,1,371,53,0,05030,1
6f97df2fd441222d97bf1c6691b26005,43,35,2,150.5,43,0,05040,1
414b6dd9769c97d90c12b0d1748ff905,36,36,1,252,0,36,05040,1
ca65cdd44da8d9d3a68360c9326d1a70,36,36,1,252,36,0,08230,1
b08465ae6341926576595975355ea68e,23,23,1,161,23,0,01026,1
390718d80cb9303f6d6adbecd3c0559d,51,44,3,119,51,0,05041,1
173c2d712740b238d2130cc1960c3236,34,34,1,238,34,0,09130,1
6ee5e8ce2a7890e6f36150626e0ff01b,14,14,1,98,14,0,01026,1
e45ef2a3bc669a0183041b4f94d70f44,193,94,3,450.33333333333337,193,0,12470,3
15956b476dc8707e97ef4b28c5a8f81b,68,45,2,238,68,0,02691,2
63ad47d011dcb37966dfb08feae8c0f7,21,21,1,147,21,0,01026,1
4c92be976a0d19607254714d0eb32094,134,93,2,469,134,0,01027,3
5d3a63232c2292b7856e8012e6b7c54f,115,66,3,268.33333333333337,115,0,02650,3
78edb7ad4a3a2bcdb2a5e215c217083c,168,91,4,294,127,41,05040,3
2e71007040d707548abad6c1ff4c4b93,21,21,1,147,21,0,11100,1
721dbf6df2b15c7671e7267247f29e68,247,59,5,345.8,153,94,09111,4
d1977d8d1f914ddeb30af506d470144d,63,63,1,441,63,0,05040,2
a0e02e825bd846206cfe0a799a0bc039,49,49,1,343,49,0,09130,1
498fc3c22739346db91dbd27f9755614,4,4,1,28,4,0,05030,1
0805d12a505915ceb52461df756e8801,63,63,1,441,0,63,09150,2
9bd3208f89cc9a0b2982046ae395563f,99,21,6,115.5,84,15,02721,3
8f7620e2b0e803f88063a4a965a5aaa5,8,7,2,28,8,0,11100,1
c92b5b0f454297803cce9ada1501c3f8,87,70,2,304.5,87,0,10240,3
89a67827e9f71f0c59ba46d0d58b7297,98,73,3,228.66666666666669,98,0,01012,3
f84069e91696ce503f368b7c7c233a51,290,159,5,406,243,47,02620,4
caf537590b70e9ec5d71b5a710118d71,88,64,3,205.33333333333334,59,29,05030,3
ed0c5547d667d5543315c7f1589aefe2,76,69,2,266,21,55,11100,2
6402585621785562d5c2c8fb46665a2a,99,80,2,346.5,99,0,12610,3
c74505ccaee477c90d9ca85326375504,35,35,1,245,35,0,08052,1
b07eabb61b750f2cc343f1c526ac1dea,37,30,1,259,37,0,01026,1
3ce3645a3ac6b46dae0e9c33a2e20bed,101,75,2,353.5,58,43,09030,3
78c2526f85f666e8d67faf52e1e05c48,92,64,3,214.66666666666669,58,34,10200,3
604d7d92ea8cfa66d31d2385cb783610,84,57,3,196,84,0,01026,2
fd972068539892155668307167dbf2bd,52,41,2,182,28,24,01026,1
23c6c8b557a7bf2b9a107db716646d7c,51,51,1,357,51,0,01016,1
42acaca897254c19d48f9f30ebcd7e9c,16,13,1,112,16,0,12710,1
bddced1731f7ff81595191d94e4c4427,85,85,1,595,85,0,01026,3
351bbd0939a2cd954aa702a8250149c3,72,56,2,252,50,22,05040,2
6cae9a1f52a3ff5edc8cb22cc84a5ba7,14,14,1,98,14,0,05040,1
572ce14dd68b0cf8531896c60672b6af,31,31,1,217,31,0,01026,1
e2bcdf5e7691b6539e6fd1ee293ad506,81,55,2,283.5,81,0,05030,2
cce3b1b01e1a98c6f0a9beb9fcccaa91,17,13,2,59.5,17,0,11040,1
59e5791f3e3f8840e77cb5efe4537ab8,65,65,1,455,65,0,01026,2
22959cfcfe7c296f389f7835e4a67739,25,23,2,87.5,25,0,04032,1
e8c6bfc227cf254b13f41e287638169e,32,32,1,224,32,0,11080,1
ae4db00c5ed4ec4c2889ae9d39fb6519,163,95,4,285.25,163,0,10200,3
f71e647211248c122dace416659c08ef,43,39,2,150.5,43,0,01026,1
f7ea6c872fe77f6c9a1f2095dc42fcd0,24,24,1,168,24,0,08313,1
ba69a49ecf05e4895b5f2d1339d14530,39,34,2,136.5,39,0,05030,1
22418317d957dbfd863437371da73257,141,94,2,493.5,141,0,01012,3
e4610106d142750459563ecd5f700941,54,54,1,378,0,54,08010,2
b379aa0c7ac70eada4c80a6524aaa00c,35,35,1,245,35,0,05040,1
b7ee8540e356d2f3702cb4d1b447039e,18,18,1,126,18,0,09130,1
fd5e539c29431a75ea8ae554b49810a8,64,34,3,149.33333333333334,64,0,09130,2
c263fa7f6bdce8d67f0293fd87236954,73,53,2,255.5,16,57,05030,2
fabf34850a88191f4589da12c0cdb552,1,1,1,7,1,0,05030,1
761d23ead74b470a13485a8ac84e5f92,46,32,1,322,46,0,06100,1
bf7a50906e284507c1e2e8654b462c77,11,11,1,77,11,0,10200,1
b15686cd4ef206e2ea1efce4a25842fd,28,24,2,98,28,0,03033,1
5aedf95a2e9ab62d1e3d5b9679c9a17f,21,21,2,73.5,21,0,12570,1
8151c6fb002aafcdfa4a5c97105aab5f,60,60,1,420,60,0,05040,2
71004d369bf8a60239c6aac643f4d721,98,75,1,686,98,0,09010,3
4dc73d93e1d91abfc909a8001bf0eb56,27,27,1,189,27,0,01026,1
08dd98922f23f4e49dfe49fae6663bdd,14,14,1,98,0,14,01085,1
19a76ac8fd161f09799561875e3feefc,179,85,3,417.6666666666667,179,0,05040,3
5bf51cd9700a0e104e69c537860773ea,199,116,3,464.33333333333337,199,0,05041,4
269cb00bb9b91f5dc7d3f967dc66b379,84,46,1,588,84,0,12500,2
455b157621b3e7ab97a8d865fa7cd9ce,213,96,4,372.75,213,0,01012,4
10466b9b6a1b0491ba7ad9e99d61c4bd,12,12,1,84,12,0,05030,1
04298ddb1dcf4225fbbe92e0882c2ac0,57,42,2,199.5,57,0,05030,1
0d3bd1b1808203a6d4eeb35312d7482a,71,62,2,248.5,71,0,02620,2
f345106047a44cf5295d14a624885867,47,47,1,329,47,0,01026,1
9db50209043e87d8611b7cac2de04251,125,72,4,218.75,125,0,01026,3
2e13aa79d6aaf0b5e964ae202af2f0e1,19,19,1,133,19,0,09130,1
c44378d7dca3c94fbc83f0e43abc2f28,37,37,1,259,37,0,01028,1
a2e63c9504baa213ad700db0bb217874,19,19,1,133,19,0,01013,1
ea0bf9068094ca44e2a07b157004b571,208,100,3,485.33333333333337,208,0,10200,4
6e0bd9e92e01a796c4b8a112f8c83eb2,58,58,1,406,58,0,04060,2
36f5e3039f67f0601aa30666b8c1bc4d,43,37,4,75.25,43,0,05030,2
2e856a6bdc722834a6ae3e395c164776,29,29,1,203,29,0,01013,1
34cc384959df5360db9ad9296deab349,26,26,1,182,26,0,01026,1
fea6fa367a46f25ce0a0fc0a4a7302cc,26,26,1,182,26,0,11100,1
8bf55c014326c36422a3ed7df4d02625,10,10,1,70,10,0,01012,1
2ab22a72dccce5beeecdd1b10131ab56,20,20,1,140,20,0,01201,1
917045e7cecf2c99c283858c01c9191d,269,159,3,627.6666666666667,97,172,01012,4
365cc7652be047f675e329747029c58f,154,89,4,269.5,90,64,01026,3
c374aafc057327796af92772180285fc,60,52,1,420,60,0,01012,2
d777caf3db5f330652c122d50bd410da,213,118,2,745.5,213,0,01026,4
5794a4609b65cc21f4ee283da3e52e10,184,109,3,429.33333333333337,109,75,05040,4
dbbe539e2ed610d95917a716a26e2856,442,118,3,1031.3333333333335,400,42,01027,4
e6bb5f8e58de75bf3cc637ef3cc7cbb3,128,120,2,448,128,0,08052,3
66751ab918e955a5b7db6716f6f638a9,175,85,6,204.16666666666669,152,23,01026,4
71bfd39312b923d5662c5b9fa0e75ee2,68,58,3,158.66666666666669,68,0,05030,2
2f3f82b644fcc0aaf83ce00cf9634e9f,196,117,3,457.33333333333337,112,84,01026,4
22539da87ea5260d8864b247ff5ed9f2,75,59,2,262.5,75,0,02650,2
d1709c7ee8ee95a280309df56fec9804,54,42,3,126,54,0,10240,1
de3b9ad0bc4b17c4247b696101abd5f1,95,64,3,221.66666666666669,95,0,11140,3
9ce87257d7b342cc2095738fd9e14e1f,116,88,2,406,47,69,11040,3
924241775b7c2dc1089e6f10a582aa25,32,22,3,74.66666666666667,32,0,11040,1
fc8d5e31c51b6049b28e0143e72c7d8d,71,71,1,497,71,0,08010,2
444da343e608a8dd73bd31515f4b448e,37,37,1,259,37,0,02690,1
fcf045e95f78fbdf05f1badea142b832,36,30,2,126,36,0,11100,1
ae93c2dc97b7388c7191d6798e4cfda9,363,114,1,2541,363,0,01085,4
33ae44b7c81ef3cc71bf57140ded3659,44,44,1,308,44,0,01013,1
c635c1e9146ebe568f6dd4b544d31198,46,36,3,107.33333333333334,36,10,08052,1
b02d3a1f44dbd1b11b5c1ff136917fa6,95,69,2,332.5,95,0,05100,3
01a7a60c5c41646abf905002b5743494,36,36,1,252,0,36,09090,1
a93aeac5c01d8c8c9a513ad9283daebe,71,61,2,248.5,71,0,05040,2
b2a778f8de690f486168ef04a6c10a51,22,22,1,154,22,0,08150,1
23f281912f94b148745a01743836bc26,25,25,1,175,0,25,04060,1
c656df0f76ea594e510d7197779de709,247,88,5,345.8,203,44,05040,4
3f9de70f889b429f3f5c5b33951727f1,10,10,1,70,10,0,09030,1
3ef70ee02521f6c612c2b2fb7547b5e9,99,62,2,346.5,99,0,01012,3
9779d3322d96c3eef39af855d72191e6,82,60,2,287,82,0,09090,2
a80f483c3ccf51b37040cbc54ae2bb3e,76,49,2,266,51,25,02690,2
4be0a23ae46aaf3428deb6d2f1d61d94,41,41,1,287,41,0,05040,1
5db986763a4f9c9edf79c2731e508b2f,263,146,5,368.2,223,40,04060,4
7d4aaf49822b7afbed2d3d9d0020b297,124,75,3,289.33333333333337,96,28,01013,3
88b384013da215f4a705e0b77795f70f,131,90,3,305.6666666666667,63,68,01026,3
c289b6ed42fba8494d9047096ec9bdb7,80,61,4,140,37,43,09170,3
9cf5c15112b82713e8e8a72f1c6c420f,108,74,4,189,57,51,08010,3
3398e8557a108f13d73572f7d8533b6f,38,31,2,133,38,0,01013,1
6f2e987f790d787eec70842a3737016b,45,39,2,157.5,45,0,05030,1
96799eb709aa833d0ce3aa5ec27754a2,53,40,1,371,53,0,05040,1
c9c1faff5edbe88797c4c9bcfd7d57d4,23,23,1,161,23,0,08100,1
5dcaa3dc662ba14c109b7df1dc0935d0,164,120,2,574,164,0,10200,3
df9dfdf9d0c901cce80249d5f4039ad3,182,108,2,637,182,0,03090,3
38200a4ddbf765c02ad42ac7eb948962,159,68,1,1113,159,0,10080,3
38c84ce5b5c45dcae95102c385f49cee,22,16,2,77,22,0,10153,1
a69af15bad35786262b236d594711fd0,112,90,2,392,112,0,05040,3
586d88bec59a2ef38dad62c99e3e26f4,94,66,2,329,94,0,04080,3
1657bc1333136689653bf8c3a1f4dd6b,45,26,2,157.5,45,0,10200,1
9572803249fd667ae0c7e9b356b5956b,98,57,3,228.66666666666669,98,0,05030,3
bf0014c2a1d061c32de55cb19830cc33,148,87,2,518,148,0,01026,3
c0c064b464e0772582d45c1023804293,21,21,1,147,21,0,01012,1
9acb5892f233827eaaca3ab7a403de11,104,56,3,242.66666666666669,104,0,06100,3
e1b076127c364a6e92712a8f0d8985bc,48,47,2,168,48,0,03050,1
44df4717632214fec4b1d7d217eca189,178,91,3,415.33333333333337,133,45,01027,3
3025598aad451ec241c9ce3caeab6a3e,495,201,3,1155,495,0,01027,4
8e5f444e2980573e0319d67cc9d6cee5,271,98,3,632.3333333333334,271,0,05040,4
a19e471591a41e7855bc3f57699b45eb,129,93,2,451.5,129,0,05040,3
75bfb8031136e554df3d93b88b0b7cc4,27,27,1,189,27,0,05030,1
72e21d11bb13964a005b1a56c2c0086d,30,30,1,210,30,0,01026,1
0c0359b97aad64938db5456a4f4519c8,40,34,3,93.33333333333334,39,1,05030,1
a7945126bfe672d09283d963ec686ca7,9,9,1,63,0,9,01012,1
727b7a9f1d526fb1247d09352001014b,49,32,1,343,49,0,08150,1
fbc2daa723fae81165d6bbb9799d169b,31,30,1,217,31,0,05040,1
e6130bd013a9af864fad186940d6840b,22,22,1,154,22,0,05030,1
ea17ac4665c57fce41c4cc41ce4a1d46,66,45,2,231,10,56,01026,2
00ae694d81a199a390cd0c6954abb070,77,57,1,539,77,0,05040,2
f459790e689ecec7b74131d825363c8e,110,60,2,385,110,0,08314,3
44668132973adbb540bfa374e006d2c9,193,139,2,675.5,61,132,05100,4
68edc1f70dddc3a28b244ff744f4bf9e,47,47,1,329,47,0,05040,1
f0159c4519f7e8e641c432ffc53fcd7f,45,44,2,157.5,45,0,05041,1
391aab2552d75ba5c8ce8054b1707008,215,93,4,376.25,197,18,05100,4
5b55a3c163dbfda59441e3bad0df29c3,14,14,1,98,14,0,01013,1
30acaf164892ea904bee1bdc8cfba6b8,88,64,3,205.33333333333334,67,21,11040,3
b4eee5431282167b2c690ca5048226f8,33,33,1,231,33,0,08010,1
fe52311b246f88407a1142d891ad77ae,432,144,5,604.8,339,93,05040,4
9b8b000eab4b8835d44921d2cf317a2e,14,14,1,98,0,14,12500,1
7452f71a67c9a0ba3fcb9d1d1f484a7b,57,41,2,199.5,57,0,08150,1
f89fc432aaa4d53be403956bf6ceb15e,146,64,5,204.4,146,0,10153,3
792642b24cc9404612924c42ec4e09fe,64,57,2,224,64,0,01027,2
7b2bf838de372e5f727cf624cba5bda7,101,56,2,353.5,101,0,13820,3
893e3200cd6975ee9ccb36a90219ab87,1,1,1,7,1,0,09010,1
952228e7c2c130569a2ba843ba0b7379,37,37,1,259,0,37,05040,1
a2deacfcf880097f81081faade7061b4,100,73,1,700,100,0,04080,3
46d71677785f7eea02bb65ef7d7641a8,28,23,1,196,28,0,08010,1
58c3b20cd41529a04b789c8661eb46bf,209,124,4,365.75,209,0,01012,4
7e2e2b89761451882ea108087701fa66,130,74,2,455,31,99,10200,3
8b3fbbeeb8db87dfb12e48c0631b5540,19,19,1,133,19,0,01026,1
12668f0df8352e8226063531c165c095,131,84,4,229.25,131,0,09070,3
adab9d91d2e8fef6ea57f7bbf19dc36d,74,50,3,172.66666666666669,74,0,09130,2
0deea0d089327f55c5fb5ce689cea9a0,6,6,1,42,6,0,11040,1
474b03d774586968c146218233102c40,39,33,1,273,0,39,04032,1
03683d79d8f7c11fcabe1be80d9aa4e0,14,14,1,98,14,0,11040,1
a786f31515170728f212144956611324,75,75,1,525,75,0,13490,3
424bdfe5ed51ec0779f5e27017ecd6d2,127,58,3,296.33333333333337,78,49,05030,3
62f5dda62c765a50d69ffd3a66d44754,52,37,1,364,0,52,05040,1
4f5692ad6bc37a4f726efcbdca30b2fc,49,44,2,171.5,49,0,05030,1
5c0feb5680101bda4edf192cabd6f4a5,37,37,1,259,37,0,09090,1
53c6aaec60af7a94503f511e9693d45b,53,53,1,371,53,0,10240,1
4ab32152657687462aa1913c4a4ae803,76,57,2,266,36,40,01026,2
3ae025f418de44dec323bb9c0f7829fd,58,48,2,203,58,0,01026,1
3229c1744bc9ad6f735fb8fd73617a6a,35,35,1,245,35,0,08312,1
89221c60fb10cb12ae41a88cf5aa97ca,24,23,2,84,24,0,12500,1
d230f626b4307b11721123619a169fa8,78,59,2,273,78,0,01026,2
ad5f14ec7495c07345b9feaebc024f8f,52,42,2,182,24,28,01013,1
1e7d7ad4468e5efb4789c0487b96963e,53,53,1,371,53,0,01027,1
62cbaaa8f8aa9680bf8c8db836a84cdd,24,24,1,168,24,0,12470,1
cae88edc246482f2c11ee487ddaf3f6f,13,10,2,45.5,4,9,11040,1
e3b35f0c5704ed30e57bcb6046aabe30,40,39,2,140,40,0,04060,1
2fa6930205680b34e76bf2a4cebf9ab1,301,108,3,702.3333333333334,271,30,01085,4
acb07ec6a2abe4f3514c9b7ba6aba45a,50,50,1,350,50,0,12590,1
6fef907e41fb2809bdb8a33298b2b4bc,49,49,1,343,49,0,05040,1
3aefe653e887874ce1ae09278b676032,85,74,2,297.5,85,0,05040,3
7209b92f45df7b4bbdb06c764e4e8d73,211,99,2,738.5,40,171,10200,4
b0206ab9f6b8bf7bb93f1149c35320ae,64,52,2,224,64,0,01201,2
c8109f4dbb773f781ac8e58595184b19,137,122,3,319.6666666666667,74,63,09130,3
82851cf2582524a17355413d209b5fc3,1,1,1,7,1,0,11040,1
a676b8b9958b0b1a264cf7905b55669d,127,63,4,222.25,92,35,01027,3
739141782ae812b816137195d047f4cd,472,193,2,1652,139,333,04020,4
9e1d2538d5ad82413cca1cfa1f3229f2,75,66,2,262.5,75,0,01026,2
4a197a3ceb63b02342717376e435b7e2,105,58,3,245,105,0,05040,3
10ddf7e0e5a8a6857a45e20dea54e8f9,186,108,4,325.5,186,0,01026,4
476f3c52056f2fdb21e26cadcb9aa5fc,318,117,1,2226,0,318,05030,4
207913c74de23d3dbe1e7f41f2d76327,45,41,2,157.5,45,0,09030,1
da502a78cb8aa79d3d8a522040a334e1,99,79,3,231,99,0,05030,3
241de19166f4ae4767e829a545019731,22,22,1,154,0,22,01026,1
9988262654d14cbe554053d2b435b55f,33,33,1,231,33,0,05041,1
302cc03a7ba0f72427f49cf88f94743f,1,1,1,7,1,0,09010,1
da1823551edbe7052d99c494ffb1ea35,12,9,2,42,12,0,13820,1
d74bbfb463e31dfd3feefff9e88abf90,55,43,2,192.5,30,25,01012,1
2771026c165fa8f6f11b7981fd190dbe,8,7,2,28,8,0,12410,1
ffd30e040aab8678fdc1aba49c111245,36,36,1,252,36,0,01012,1
4c810ba14a8418efa5745965907b71ef,90,53,3,210,90,0,09130,3
e2990074287f06ad47a4cdf4dc0c47d9,30,30,1,210,30,0,01026,1
d30695f5d96e15fe0fbd8d61180cbee0,8,8,1,56,8,0,11100,1
71ef75fb666ea1697f23cf5d854eaf8e,82,32,2,287,82,0,11080,2
dddae0ed9a0bdbffff848bd51b91a61e,152,111,4,266,152,0,10200,3
980c7c521dd50cf15536bba8f2ec317b,30,30,1,210,30,0,03050,1
a504b414d141076620abeb62c83ddbb5,117,82,2,409.5,117,0,01027,3
97ad81cf1bc4f45d186f398d425a397d,14,8,2,49,14,0,05030,1
6caa44dd04a62a9f6c1eddc0953d30de,137,75,5,191.79999999999998,102,35,05040,3
997530473da37bab73ba0f01fe9a2da9,10,9,2,35,10,0,12591,1
f2cddfe1bc1c5753843d47bbdb6b6162,123,104,2,430.5,36,87,11100,3
26434ddb150bda98979471da51a35dc7,49,34,2,171.5,49,0,05030,1
310689c8f89b1771539b3ed851771f9d,120,46,3,280,120,0,05040,3
e19f661995737d538582cd43269c5d82,35,35,1,245,0,35,01012,1
a504a71ab10daa34eb8cb67800bf20e7,133,41,1,931,133,0,05040,3
b06302a57c2f21f1d0f627678e824e25,17,17,1,119,17,0,05100,1
83e7cb6c54a70c107490475cd0ad18b4,324,100,3,756,277,47,11140,4
a000d698468683471a728e1b19ed0973,7,7,1,49,0,7,01201,1
f0ba02e69e3f18551ed656c708aa7b62,411,166,5,575.4,384,27,10200,4
b0a383abf66348b3804a06cf14273ee3,31,25,2,108.5,31,0,01012,1
e987427fb7fc2a12b83f581eca45f6c9,31,31,1,217,31,0,08150,1
c4a8f335ca0b3c53ae7ffcd388e2269a,140,87,3,326.6666666666667,140,0,01027,3
7108781949c65ba0542cdb41d89582ee,61,52,3,142.33333333333334,37,24,01085,2
e16eb79dbfad124d1a077afb9824ef98,100,63,2,350,62,38,05100,3
7840ab5f68f5fb7b621a41670d698eda,322,71,3,751.3333333333334,266,56,01012,4
1973cbeb7e3364f2b7f991c933a70ff2,58,29,6,67.66666666666667,39,19,05030,3
bc7b599ff180aa9e5732e1912286d494,74,55,2,259,74,0,05040,2
bbfed32587ebeeb3c5e93405f7e65fed,12,12,1,84,12,0,03070,1
29fc8d4244a5e23f3c314f450ce721ec,37,37,1,259,0,37,01026,1
8268394a9bd0fa6c812d3784dbdd7425,234,95,2,819,206,28,01012,4
cbb985f154a95269f2f0c77a6420dfb4,2,2,1,14,2,0,05030,1
290fa5ed5763dd80d9694adfe7cb4fb5,91,64,1,637,91,0,05030,3
23fc58cde8850c4c8c2669dc2e9439c6,111,62,3,259,31,80,09130,3
6338a292cf9314f0babc6d9ccd2420ec,167,109,2,584.5,167,0,05040,3
a1d9a746657001f174adc7cd4a596ae9,90,68,3,210,90,0,05040,3
cc36541f830ddc4b827c5891dd42ce77,86,65,1,602,86,0,01085,3
02295ec5cb4a68b8351136337e527331,20,20,1,140,20,0,12710,1
a0fdcd030aa6e27f49ee5561712b8bce,11,11,1,77,11,0,10200,1
8e51b0727a3fcaf182db975221cfcbec,66,43,2,231,31,35,01012,2
e0836935370b412b23af0e58ca05412f,473,148,6,551.8333333333334,335,138,05040,4
9358f364bc2a5430223d1a112044d795,50,33,2,175,50,0,11100,1
a063defddc9eda192e9fb8ff05ed844b,31,31,1,217,31,0,05040,1
b8531b87b27718929da64a6e05124bdd,61,46,2,213.5,61,0,03050,1
29921705d638cad48f1236fda77ca108,38,29,2,133,38,0,05030,1
cb50926192b572721cdb5c7701bb0d0f,50,50,1,350,50,0,08010,1
684be1ef1e6984637cf616c904070f18,111,87,2,388.5,57,54,08052,3
8d2d37071a6ea06e54cedd29d8079509,19,19,1,133,19,0,01012,1
c9148b82e20bca65dfd1e5af803cfaf5,29,29,1,203,29,0,06100,1
783665cfed5d6ebd76981443bcc3741f,25,25,1,175,25,0,08010,1
7453ed579558b0e40338e58e3ea656f3,23,23,1,161,23,0,05030,1
187293693260ac5fc62def4152d1461a,25,25,1,175,0,25,01027,1
8ea66a594b884e92161c20a44fc99192,98,64,2,343,98,0,11140,3
231cfe4a3b903d6611653fbfd56f1442,27,27,1,189,27,0,05040,1
762a90b0f44c13add50c2ea6b1880a2f,34,34,1,238,34,0,05040,1
8814497184c7eec1fb9f8fa7d0862549,62,62,1,434,62,0,09150,2
9669b70d7da6d6bac70cef491071ef02,120,84,3,280,120,0,05100,3
beee983590e2b33b74fcd0b248bedda1,368,151,3,858.6666666666667,368,0,05040,4
b511b01e621c4d554966c3809959ace0,144,74,2,504,29,115,05040,3
e7abb89a7b08c7f4f2516b3b58ba866c,17,13,2,59.5,17,0,05030,1
b0a8d963924dfd0de5701f20606beaf9,23,23,1,161,0,23,09110,1
1d33ef844b958dca4f96d33b7b574451,57,50,3,133,57,0,05040,2
ecb71b7000c4f596779f462206ba0c86,57,57,1,399,57,0,03050,2
5b4b2e2ee41c0100d01a42d4b08b1d02,44,41,1,308,44,0,01013,1
dd9eef9ad481fb93b02849bfc6cfd4d0,34,33,2,119,34,0,05040,1
7529a538aaa3b61c3a8108a8f774321e,19,19,1,133,19,0,05030,1
fa7c69963fdc711d0274bd5ee7e50452,25,24,2,87.5,25,0,01012,1
b86e4a393890d03653a0169784688050,64,48,3,149.33333333333334,46,18,05040,2
57b4c8f61a774cbd441c4a37ea05c288,357,133,4,624.75,314,43,10240,4
634e93b4083fe710128907d10e165c76,87,70,2,304.5,27,60,01027,3
f2937588c777a7a61fd04ac8eb6be2b7,225,133,4,393.75,81,144,10200,4
6e84d278262f4098f15a19e199cbf7c7,130,82,3,303.33333333333337,64,66,05040,3
64718f023922249910927253c798ffb7,272,120,6,317.33333333333337,133,139,01016,4
54ea0f97f488750d1edd59908dd41d86,39,30,2,136.5,39,0,09070,1
3696e6e3f8a5d8cdb0af125e688fa9a6,18,18,1,126,18,0,01013,1
b5791d1596ea3fbd3dace570644d1751,22,22,1,154,22,0,01026,1
f81e98fc92ee977f2ba6dec5888e39ae,183,91,3,427,156,27,10028,3
613847b5821465416d4bb7e713e402fd,15,15,1,105,15,0,11080,1
16a8aa82abbd347170e737f27cb53c0b,15,15,1,105,15,0,11100,1
b44bca197bfab13ab5cf0d19d1141367,33,33,1,231,33,0,09030,1
a2d1d48a14cf3a556452837b1c5ece13,25,25,1,175,0,25,05100,1
3398dccf9759e2b722036548265e48f9,24,24,1,168,24,0,08010,1
d9795080f2ba152c07853d3c509c1ce5,183,92,4,320.25,153,30,05040,3
dedf620b1af8e4e8934b8e3dbe4e32e8,215,84,4,376.25,196,19,05040,4
4e6d186722d2dfe2e703d90f09ab407a,114,65,2,399,114,0,05040,3
de40ea1676397585790454ac66ce36c4,174,123,2,609,174,0,05100,4
89b8c0e40a8add069408041ccc5612cd,15,15,1,105,15,0,09090,1
f99675ee7cd1245e678206f549c4f88d,74,49,1,518,74,0,11040,2
33dc8b1f4a07ea1a540d113c825479be,12,12,1,84,12,0,05040,1
26879d7bbdb837ddc19f3f58383a0a04,49,43,2,171.5,49,0,05040,1
ed331630841f97fca733379a6370fcdf,4,3,2,14,4,0,12670,1
5bf5e18521d8439ef9609eddf0b420af,22,22,1,154,22,0,05030,1
09ebbd6b98e6d6d80fbb3afb26fca384,26,26,1,182,26,0,01027,1
8b945e3b7a37d24000f1a077ca387ed5,4,4,1,28,4,0,11100,1
d1ab0702ecf60a4738ee6a18b6ee7bfe,5,5,1,35,5,0,09150,1
347657d83d02babae915b3c19fcd2115,94,77,2,329,94,0,01027,3
538b25f8291f6163243f10a2da2402ef,75,70,2,262.5,75,0,09130,2
f6b2fe1a77d46523aa8082de108a85d6,150,123,2,525,62,88,01026,3
86f5524458b4aae654a6637552ba1de2,96,83,2,336,96,0,09130,3
e9b468062eeee23dbc2c51bb325103f3,48,24,3,112,48,0,01012,1
f7597d30c8acd758aca4d45764fecbf6,33,28,2,115.5,33,0,03090,1
c31dc0b5a9e2ff961e6726309888c106,17,17,1,119,17,0,09010,1
2bbb5b02e6a1c27f0ffd654df3c3b081,178,113,5,249.2,156,22,06100,4
64a744255eb5363db5478746398f3553,24,24,1,168,24,0,01027,1
cd9842e5e1b4d30586ebaf6a46a43200,28,28,1,196,28,0,05040,1
6fa39c4207b158c5354af1f18202d7be,58,58,2,203,58,0,09150,2
ce75426d5f58bb5a8251ed0947e96ea6,140,81,1,980,0,140,05030,3
334c42a31ab4c41fc4a4b57859c56351,37,37,1,259,0,37,01012,1
e856ac4fcbb25bb6ded330a8c398b3ed,13,13,1,91,13,0,12500,1
0b69eaf0e7645a6741025dedaaf3307c,320,131,5,448,236,84,05040,4
a67b6dae088b0049c31052ab98a0f665,406,161,5,568.4,310,96,01026,4
b8deb5f81b49d23358797495ac2e3963,67,54,1,469,67,0,05040,2
c5559941fd0f7d9097199802cff09933,88,52,1,616,88,0,04060,3
a248054ce481a2c5e07cafdfe08566b2,28,28,1,196,28,0,03090,1
f57886cd95bd6d9e6af39cabb4df93c7,52,46,3,121.33333333333334,52,0,08100,2
3bab7e9da9bda79cf8995047a24e6d0f,421,159,4,736.75,312,109,01026,4
168b404780afb821132d5a99957a5e29,28,28,1,196,28,0,01201,1
735bab3c8d37ca5c4aa2622238dc8bdc,8,8,1,56,8,0,01201,1
bfdca975dffa01611e8048b22a3b2b93,185,112,5,259,143,42,05030,4
2ab5ef90f5f42b98e0dddd38c6d9cf72,58,37,2,203,58,0,05030,1
ac08f7a9bb103939a62fbc1336834501,48,48,1,336,0,48,09090,1
93fb1d72ce43e850568891b20a3bf9a1,126,88,1,882,126,0,01026,3
554e2cf65dc8e99ed1ad4929757ec0fe,20,20,1,140,20,0,01026,1
6b93274ddb343b79b9c7c28eb1640afd,112,93,1,784,112,0,05040,3
9d6b6225463ddd3baf388baeed9a9035,25,25,1,175,25,0,12410,1
031be2fc3bc75453ec31a79e370cd170,78,49,3,182,52,26,05030,2
0dc2650b485bc325b8367a27556c3a99,83,64,2,290.5,41,42,01012,2
faf5778336ecee095258d877d3515897,12,12,1,84,12,0,09130,1
520ad6c3171cbdca447c83bb68706de9,46,41,2,161,46,0,02690,1
a3a08e4af2d45bcc8771045e2a8f751d,44,23,2,154,44,0,11040,1
2fa3d24f8bacc4dc627a5e21fa21e644,223,63,5,312.2,209,14,04060,4
d674b4275a2545ed4a007f77e59fe2d9,12,12,1,84,12,0,05041,1
88892d0010f46348f903ff99f382c4c1,24,24,1,168,24,0,13930,1
1c75ce8e9b8d94ecc0db2cd2089db76d,2,2,1,14,2,0,04200,1
cd12018272e380da6a18d9180672d12c,69,58,2,241.5,69,0,01026,2
eefbb9b293bc9a9f2f5c5e1a97507142,14,14,1,98,14,0,10240,1
11348091d48ce37329122f61f27b0f63,29,29,1,203,29,0,05100,1
7a050640114606286b0a1b079de83123,1,1,1,7,1,0,04020,1
e1d58650d40a750848dc8223358e8c00,26,26,1,182,26,0,05040,1
136c0149c4a9e7997e24c1881d581309,22,22,1,154,0,22,01012,1
74a481bb49fab15900e0656b2638f2cd,26,26,1,182,26,0,01026,1
ca97eb55e7e2e6741afb1e5f599a7adf,183,98,3,427,183,0,09090,3
afb3fe36601893284515bcbb3cd98b69,27,27,1,189,27,0,09130,1
9885cecafdb7e4c14f0e41f041a40579,29,29,1,203,29,0,08010,1
33b1c995610fa0ffd80ea6f259699d97,1,1,1,7,1,0,11040,1
6484ebf751f588d767d16a0ba68fa296,128,92,2,448,75,53,05040,3
50dc48b3a4ecfec54e0d75c007762d9b,28,28,1,196,28,0,08230,1
d71ddfd16affca305cb197e795b16566,157,88,4,274.75,157,0,01026,3
d8026fd4ec9d9ce3a020d44487fdb0b0,111,61,3,259,75,36,10153,3
b373ed57431dbfd3f6e6a405ebe5829e,47,47,1,329,47,0,08150,1
b1b87b47e5b075732868e43f8bf89f75,35,35,1,245,35,0,01012,1
3f5112ccfe2b6399f866e83a6463161c,78,63,3,182,41,37,05040,3
0b8999758073ce69fae84b1107309868,19,19,1,133,19,0,05030,1
e37d29277172a0100af4a5431f3562b0,376,122,3,877.3333333333334,376,0,05040,4
8c86b3d96aa70b00754aaf83e1958f71,81,81,1,567,81,0,05100,3
c8a7ef024a2f28fd97ee944b92a277fe,210,85,4,367.5,167,43,05040,4
d85ceefcf666f2b27e3e1e1252e5a1ac,92,73,2,322,33,59,01085,3
412bbde38056851428ebc95e7636d9c0,243,98,3,567,207,36,01013,4
2323e777e9a6269c3a8522b11ad2186b,181,83,6,211.16666666666669,172,9,14301,4
45053f73a93584fa8d96da68b6ee5667,235,102,6,274.1666666666667,205,30,10240,4
204d5893293495ed5d424573e8c97cf7,46,41,2,161,46,0,10200,1
49ce1a3d2675b9decb779d6a3a23e318,29,29,1,203,29,0,01012,1
fcace2187559fbc0a427fb5d851637a4,48,48,1,336,48,0,01012,1
d58818975c5b619b28e34f29496a4709,71,54,2,248.5,71,0,05040,2
1da075437f7cb61371f393d1045e8f10,136,102,1,952,136,0,05040,3
3f6294d8eb4be313509bfa3cbcaaa015,20,20,1,140,20,0,05040,1
fe112c7b293b8113d65887651178d921,36,23,3,84,36,0,05030,1
46264d56f0ab3afc7e5efc5a7be8ce7f,16,14,2,56,11,5,05030,1
324a22e87ad5ea70de09be3c0ae9caa9,22,22,1,154,22,0,05030,1
e6985816cc0e35c4250522386b88e4cc,9,4,2,31.5,9,0,11040,1
e35bb26db63bdc29e275246c3cd570b3,46,46,1,322,0,46,05100,1
7666da22717eefef98afbddcc21df218,11,11,1,77,11,0,13490,1
fad3a0288b09ca78644012ca4c528a2b,34,34,1,238,34,0,01027,1
febe1f1d30222fc12827880a8e291659,32,32,1,224,0,32,04020,1
aebf86efc2cffa5926c682f28aac2300,233,144,4,407.75,233,0,05040,4
88d63aac40ab8712d2206eb5427b6414,25,25,1,175,25,0,04130,1
18b93b778e63898c4c209151198f1a84,32,32,1,224,32,0,01027,1
f66478299fe401d6e2449b5f930580d3,8,8,1,56,0,8,03050,1
b409b6c37b26da80e5b49f67df188796,67,67,1,469,67,0,02751,2
44131d00e683772e4b0fed7eebfb026c,27,19,2,94.5,13,14,01027,1
6c52e3ee146aa697dc1f413b72e55887,184,134,1,1288,0,184,04060,4
59a0946b3e8e7b5a3c91e6864e98bba3,35,35,1,245,0,35,05040,1
31d5bdaddb2f2423014030acf98fe4e2,139,70,2,486.5,139,0,10080,3
3551759f17b5e21788003678f14acb37,64,64,1,448,64,0,01027,2
e81b048a3e5ad604f4a6d7aec64232e1,18,18,1,126,18,0,03070,1
bd09029234d5649a39b127949e70a5dd,66,49,2,231,54,12,05040,2
a796c2e6b8ed7b793c9584e814163f90,60,53,3,140,49,11,11040,2
8c6ab1762c4cd1e80bc05205bb42a09c,7,7,1,49,7,0,01012,1
d2a58d52e36b822688bdbeac274e771c,25,25,1,175,25,0,01201,1
7b81de5dff11aa1cfbb24c71cf77ac67,333,209,2,1165.5,333,0,01027,4
0ec1d606c6d5f6d228cbfae116c760ef,37,37,1,259,37,0,01026,1
a67d01cfd25d18a4784c410e3e488d63,353,198,6,411.83333333333337,335,18,05100,4
e79ede845e17c77a334b32cf5f7c0b65,52,45,2,182,52,0,03050,1
b85fc7c15de3d43471adbd7f31185042,77,53,2,269.5,41,36,05040,2
c4d80113c149f400f6bdaaa15f0fb95a,55,50,2,192.5,55,0,11100,1
2879b7320d027ef084396166a79a8685,62,55,2,217,28,34,01013,2
8cadb4fc951141033247f08ec5c86751,98,54,2,343,98,0,05040,3
c437fa23bb9408fbbfd113e2f143e7b5,36,29,1,252,36,0,01027,1
9fd7c5b8e4b804db71a92092d73ca6af,39,30,2,136.5,39,0,04201,1
b12c51777263ea78d13e6f0f6718caee,47,32,2,164.5,22,25,11080,1
150a272cdfcdd48d695170df635233a2,100,47,1,700,100,0,01026,3
0101b91e4ffe0d48edf5e7135c16af44,65,54,2,227.5,65,0,05100,2
131dac459b3ba9e6eaaf8f406f5e5333,35,33,2,122.5,35,0,01027,1
0ce93cc9a2242b9a8571b4733fc8ed9b,110,71,3,256.6666666666667,110,0,09351,3
aa1f237a590411e1c1ab1718d69ce052,103,72,2,360.5,103,0,05040,3
aa7862ea264c84649f5b78c120a2aaf8,175,80,2,612.5,175,0,11100,3
5268017c31efb88b831d950eedd87e4a,67,60,2,234.5,67,0,01013,2
956a8311f83f72e519041f1a04ea4284,138,84,2,483,138,0,08250,3
52d8afd18540e16f0021c45b43dad4a0,20,20,1,140,20,0,12570,1
3d358f6e65630614db6a0d8c9909b27f,254,129,3,592.6666666666667,254,0,05040,4
b67536ad9eeb64a6e6a1a55b362f367e,99,78,2,346.5,99,0,10200,3
4979b6dacc37a7aa92e2d21335d9e776,25,25,1,175,25,0,08032,1
aaca5af161c363633178bba751878fb5,235,101,5,329,212,23,05040,4
415015385d89434f31b9bd9a4100defd,22,22,1,154,22,0,01013,1
5c774198a246d77ee00611305fd59f01,25,25,1,175,25,0,08100,1
e63bb52c7423290ce909ecd3b51b4847,23,23,1,161,23,0,09130,1
337566e23851fbccafa4b188e005f55f,62,35,2,217,62,0,02690,1
52f674ba0029436b2f49b552917a2638,127,92,4,222.25,80,47,11080,3
ffe88fd9f1d1a1713ffb8715b5d9c693,25,20,2,87.5,25,0,10200,1
ebefc78ea67d26f8213864ced0efe065,29,29,1,203,0,29,05041,1
f345e5a9ae4cccef224aeeba9fcc1818,76,65,1,532,76,0,05040,2
8d9c889aaa07cd4aad105da927e479a0,140,73,3,326.6666666666667,91,49,10200,3
7dbd0d7a603cc98cee767d5a6aabc983,189,66,3,441,157,32,05040,3
4d3c42b9e5f9989d6c957e5a70a284c9,46,34,2,161,46,0,04130,1
2bd4ca8a638c3f117c48edec54f89205,82,58,4,143.5,82,0,05040,3
6942dd78b01d2eed9901213f0bb1270c,121,91,3,282.33333333333337,95,26,12650,3
c5cdac06741a10d22db5553408a80c74,17,17,1,119,17,0,09010,1
abfa5c7fe3f3e5aa74974087e99503a8,46,39,2,161,46,0,05030,1
69979e8853c5f78661d2ea24fcb05c4e,153,112,3,357,72,81,11100,3
6fc24d4606b83924d576b3d2da18428c,29,29,1,203,0,29,05030,1
55b8a5e8996f4b2268494db64845f6ee,83,73,2,290.5,83,0,02751,3
ac6ed3032f49727e28a7cc93bc250b52,31,31,1,217,31,0,05040,1
4c43c1836bbab078c83631e782aba520,12,12,1,84,0,12,03050,1
8e9afee2aba51d1f3161a9735d83f034,17,17,1,119,17,0,08010,1
ff353eb4e6f751b2783eb2f7b76d6fe0,254,115,3,592.6666666666667,254,0,01013,4
cb3e6fbcf377f4f4f51a2b512b6c6b4f,104,81,3,242.66666666666669,104,0,03090,3
d3bd367d8d9d86e160acc3ea33d74576,7,7,1,49,7,0,05030,1
2693b690f4ffcd12cb1d4f94606590b1,106,80,2,371,106,0,10200,3
4f80223c2d3b3cf31b3422220fc14636,8,8,1,56,0,8,02620,1
9834b4c8b3d67cc5218b230a5183e3ef,56,34,3,130.66666666666669,42,14,05100,1
3249a2276c873bcc13dcce4cbe536f00,100,52,3,233.33333333333334,65,35,08314,3
3bb2f287992c534662ef252e2c9c9541,22,22,1,154,22,0,05040,1
76a8166c073e472075dace1fd4b86562,81,64,1,567,81,0,05040,3
99338f3ec24a785e71f866c32e079d3d,52,26,3,121.33333333333334,36,16,09130,1
66f07bd7832ed357612277761404667b,47,40,2,164.5,47,0,01026,1
488e154528e6476c1a928f5ae9428f17,4,4,1,28,4,0,11040,1
3fee7e1d4d6827ece3fc172ddb8b340b,267,126,5,373.8,267,0,05040,4
c72f03eff9751bf94d0b38c26f47c294,85,64,3,198.33333333333334,85,0,11040,3
0b8bc5f3b04516f1698fb7ab4e267e6e,35,22,3,81.66666666666667,35,0,09190,1
f015c7da81c248eb78c447d5e0ece627,284,112,4,497,284,0,01026,4
b3358baef4c308afe5617da141808134,50,46,2,175,19,31,12410,1
fdf5067327e911ff34d9b6ebb794ab17,78,61,1,546,78,0,01012,2
d80711a257f85d3d1400572676b76601,125,80,3,291.6666666666667,94,31,10220,3
28b4f39a2e99f6830d999e7e587197dc,9,9,1,63,9,0,09111,1
4918a9ce7c3802b7437c842d0acb953a,71,49,2,248.5,71,0,05040,2
87bf36af81b5ea7414548bf572661724,4,2,1,28,4,0,11040,1
a7d9979dab2b73c3ec7e963fbb41f1f9,171,74,4,299.25,171,0,10028,3
17e93957a71f2dc16440906b171b9b5d,238,101,1,1666,238,0,01012,4
fb7b0bf0a5dbcfbcecf29885176b3146,123,82,3,287,123,0,10200,3
638b343eb0e7a4b3617eb93209ad4138,27,27,1,189,27,0,01012,1
b03b28254c5383af8d4563d8e0b16a60,58,52,1,406,0,58,05030,2
9febd0cc8e98ed24b475a470a5706e87,36,36,1,252,36,0,01026,1
6a3a59472c4546edccc3ca43226ac8b6,71,53,2,248.5,71,0,08230,2
f7cdaf036cbf5c3a61e55402054ac05d,145,94,4,253.75,145,0,08090,3
b9c8d94c8887c9a3c4b8cc304d190608,215,129,4,376.25,215,0,01026,4
4c387db109f2064822a678c468abb1a1,11,11,1,77,11,0,13930,1
448c8709b58f4c1dbb30e5afe6b7d211,31,31,1,217,31,0,05041,1
8766698df2c0359830e1f26022a5b1af,36,36,1,252,36,0,10200,1
e7ab4e7d3885a086db941c5ae2d0074b,33,33,1,231,0,33,01027,1
a0104858a4f7740cb1db8ed963031368,51,41,2,178.5,51,0,05030,1
708d252a1c2b39e17e2e8c808ccbbe42,65,65,1,455,65,0,03050,2
59340e9c16d39bae6c371c2a07ae9a13,24,24,1,168,24,0,12590,1
eb7001163f1d259e437d5e5409ab386f,241,92,4,421.75,110,131,05040,4
1a2df2117e9422f754ad8c72e440868d,35,35,1,245,35,0,05040,1
458dda4222b6e974f23d1804254b09b4,98,68,2,343,28,70,13953,3
6d12ca3a0e8b1678fc7409b6c466a4ad,40,21,4,70,24,16,03050,1
6c00c5b7d963f1d331261bb69fb89619,88,32,4,154,72,16,05030,2
e61a7e7680e4e9cfb3b1f3ae265415f3,63,42,2,220.5,63,0,10080,1
8fa1581e1c621d4d30f478d4445744a6,97,77,1,679,97,0,04020,3
17a91b98e10a2a69505b9b2166d04b73,56,43,1,392,56,0,11140,1
497d81a213266a7248bd612ed1ce7aaa,54,33,4,94.5,54,0,05030,2
f85baf99bbad96a3eb2d70e507ac8b9d,108,63,3,252,108,0,01027,3
4e7fb14e327ca391508ca858b32e6810,64,31,3,149.33333333333334,64,0,05040,1
bc2e38c5bcd94f019241b0f7628d7c40,28,28,1,196,28,0,01013,1
0af6269cee127ed0088da8bda2990de5,49,49,1,343,49,0,12710,1
447cf781c1b90282f40f4a89b4f9c58e,99,80,1,693,99,0,12501,3
983a8863dd331d9420c87ecd35117282,13,13,1,91,13,0,05040,1
8a59575bd7bb0ccc90d28d501db79213,70,53,2,245,70,0,11040,2
1d64f848ea23cb750f2e1e52d1cafa3d,50,50,1,350,50,0,09030,1
73ee3cdc9101a351ec0ed8d11da7aaec,153,85,4,267.75,153,0,09010,3
d986beacb5581c654c69b5892b5564f9,61,61,1,427,61,0,13830,2
1852ee0d14944f8296b91191ac23ca15,21,21,1,147,21,0,08150,1
3725e0f0834b04df653d154e0a4323c5,51,51,1,357,51,0,04032,1
761012cf0b3d2bfff16780fbae4b6a6c,20,19,2,70,20,0,05040,1
b860319adb25328b6b030aac70b72e1a,2,2,1,14,2,0,13930,1
edb7ba1396ba8ff53c1b87d67cac6aa7,37,37,1,259,37,0,01028,1
c59df98b9413bc21d4b6f20e7e59cebf,29,29,1,203,29,0,10153,1
87a527a6c8242a833f009fb9f2d308ca,153,80,4,267.75,125,28,10200,3
06e3f18760a5e8961e648789fa277cce,123,92,2,430.5,123,0,01085,3
c54969dc3dd3d12da9f211066c367bd4,197,131,3,459.6666666666667,197,0,05040,4
c2297cb88bcbbae156c5091b94471f1e,20,20,1,140,20,0,05030,1
f7024724c44fda8a41c4d95f5d6ebc5e,46,41,3,107.33333333333334,46,0,05040,1
fe8dde5189e093db024b60a47585fae3,24,24,1,168,0,24,09010,1
2db1a24fe152f2056f4ef50ecf33971f,511,170,5,715.4,108,403,01085,4
aeaff0e1e7764c737cf4d4d008a13a3c,30,17,2,105,23,7,05030,1
318b6ae4ab78f74059c90dc5fc397528,27,27,1,189,27,0,11100,1
5d003b111cef39c071943977513a4cc0,16,16,1,112,0,16,08313,1
b8474d04e811dfde0745691106144229,184,100,3,429.33333333333337,184,0,05040,3
9d7b5d9e27c38bf5e489fdf7abe7bc99,168,102,2,588,168,0,05030,3
d91b5b3613d2ce2c37b266c00e57be82,26,26,1,182,26,0,01026,1
46e8a88c29fe54159779829830bfc77a,198,127,3,462,129,69,09130,4
9352e2bc2dd0fee81326b6a1c073d76f,16,16,1,112,16,0,08312,1
19e864a5bc86ad6dca7e2a87b5d48bd0,37,35,2,129.5,37,0,03070,1
7d7d8f64e82b9544d85791520189b01e,47,35,3,109.66666666666667,47,0,05030,1
9fdf99a98086323e1aeeb33aab269a64,29,29,1,203,29,0,09131,1
869d50d1e5a806919360b81971c84915,56,39,3,130.66666666666669,56,0,10200,1
6001002cd618230a7057d356f87a0895,1,1,1,7,1,0,11040,1
244dae08ba76202c25a0cd62193ab25b,38,38,1,266,38,0,05030,1
41fdc5d0186f9190c954d5712e2394b8,87,34,4,152.25,87,0,05040,2
4b1ff1431ef3260d1d18a7a697c81aaa,132,99,2,462,132,0,09110,3
a154cd7df6fdf4b64f6d804253ba5930,102,69,4,178.5,102,0,05030,3
5be329689f2eddac2c717431708d1b47,234,114,4,409.5,179,55,05040,4
001f016e041f01d40fc8fea87466648e,21,16,1,147,0,21,11040,1
e8f7c3863f7fc16d46f6247ad4c80e13,52,46,2,182,52,0,05030,1
95ee855c28b046482df9128ddc5db4fe,139,82,3,324.33333333333337,139,0,05040,3
ad187c04b0efecd9821e7e3feba97f78,15,15,1,105,15,0,05030,1
b063f65b8b20ec93ed49a626cc3f9a26,204,135,5,285.59999999999997,163,41,05030,4
7289052cf7b37850249c1faac8452506,472,126,2,1652,472,0,04020,4
c28774fabef02ec88b29083e0db230dd,57,53,2,199.5,57,0,02690,1
07f482e00a4599db8968ccbc704d989e,17,17,1,119,17,0,01012,1
63460fe08fc6baccfcbf9a7b8f112840,491,260,4,859.25,430,61,10240,4
00348337ef9c4396c312d06f7cadfbd6,22,22,1,154,22,0,01012,1
8148f988606e4d54c9ce6173e48048de,200,72,6,233.33333333333334,178,22,05040,4
dac2cdd645730e1347c74d73e5a688e4,27,27,1,189,27,0,01026,1
e39085cd841b515b50c9a247b1a7283a,87,87,1,609,87,0,08010,3
559a00249816b63409db556bc33b592b,5,4,2,17.5,5,0,11040,1
a58720bdd3b811d8ad7be4c868992060,191,130,2,668.5,191,0,04060,4
6553b1d2305b1fd06a29c75c7eb092d0,77,52,3,179.66666666666669,77,0,10200,2
c8f0291abedf2c68168d1862dddeb463,100,49,3,233.33333333333334,53,47,12670,3
f52128660974abf7df8fb1bd012bdf29,60,60,2,210,42,18,10200,2
27c25bdc272f616efb94bfc00ea851ce,13,13,1,91,13,0,01026,1
571ea50a005526f4cad0f0a613954a37,72,72,2,252,72,0,08052,2
b29a7af455ecc9b95a8984d3d954226e,126,64,5,176.4,110,16,01013,3
f52d05c7c011643bf4d67e7a8d92b002,39,34,1,273,39,0,01012,1
29359cea12b43905ffecdef11e5b484e,19,18,2,66.5,19,0,05030,1
47d3bea8e765cbcaee2393e57b9d9e81,26,21,1,182,26,0,05030,1
14c02bfdd62729d8ab4dbb42a823964e,52,45,2,182,52,0,01012,1
b0f27b1c787134c6b7d791ac38cc402a,187,94,4,327.25,187,0,01012,3
8322ff7c2c14e3393979bc134ee71a18,12,7,3,28,12,0,05030,1
490c3ded534a94b503fcf6ccb4b0c4fb,31,31,1,217,31,0,06120,1
519ae923fce66c02bf4bd7d10bbfa5d2,42,37,2,147,21,21,08313,1
815003e70771ae492d79a10dd9d59a93,30,30,1,210,30,0,08452,1
eb6c4a17841c8abb28d56c1358c56a25,99,62,3,231,50,49,11040,3
34694abd0a1c42ab1337de82a3bf5daf,52,23,3,121.33333333333334,52,0,14302,1
b3c00160927756183d8fce92a8404266,18,18,1,126,18,0,09090,1
e4bc9724280ac42d715a86ce056cbc06,102,73,4,178.5,102,0,11040,3
83c9c1d749a522f83f9f3a44e8a231bc,189,132,1,1323,0,189,01085,4
37f40ac100c9dd477cf9628d57605338,18,18,1,126,0,18,10080,1
d91e1c553bdbf5c7e0a48fa1ce05bb6a,75,61,2,262.5,75,0,01013,2
e19f97a1c50b01021a213a4e58f540fd,439,131,5,614.6,414,25,05040,4
38a240880a068a5526c638df9b92e217,233,108,3,543.6666666666667,233,0,05040,4
b69a22fdb4d80f071d37f8f3489efa87,42,42,1,294,0,42,04080,1
95d815b728d35c872956f2ffc197d8fc,88,69,3,205.33333333333334,88,0,05100,3
0fe87e1b74d3aac2b2d287d7330477f1,290,161,6,338.33333333333337,258,32,11103,4
e9c0d78ece0829b1b288b31e7c531d24,83,52,3,193.66666666666669,67,16,01026,2
bd92b22cb36d39f2983b64dd40c4c424,88,74,3,205.33333333333334,64,24,01026,3
39781030c6a07fd220782e463e19d3ca,31,31,1,217,31,0,02751,1
eb3d2bc53c11d25f6f07b570aaf2111b,131,61,5,183.4,131,0,05030,3
b488147d1e7aa1f5b9ea3d93b08434ca,18,18,1,126,18,0,01013,1
0b380807de01bb020d3d50fbe3ff1d7e,30,30,1,210,0,30,01026,1
1495bf5de8717a9876c84488ce166281,174,97,3,406,174,0,05040,3
b7e6234a02acd7c5759e95df08ee95d2,39,31,2,136.5,39,0,08051,1
269e2637c067e41213852c68dc54a3f4,36,26,2,126,36,0,05040,1
793fd816e8f308a122ed41255a3077ff,52,52,1,364,52,0,01012,1
9806f9e3510952f63a4440e0cd02fcce,11,11,1,77,11,0,08150,1
7fe84f3c92fb65637a30efbf241261ef,24,24,1,168,24,0,04200,1
6a21ce35ade8e5d281f4b82626b7507b,109,74,2,381.5,76,33,05030,3
0c83a0355c0ef6a750eb1cd9e23e201f,104,79,2,364,64,40,04020,3
3f367c2e3586c54efd2d68a028794abf,299,78,4,523.25,299,0,01013,4
5449fae8d709b213d8c0e90a8976090b,80,68,2,280,80,0,01026,2
188b29ed12222c20609423ebff2830fc,131,67,2,458.5,131,0,03050,3
158f39b80f0f0a505fa0ae046d5d7e51,60,50,2,210,60,0,12610,1
069984726679800dba47cbbb0d60408a,23,23,1,161,23,0,08100,1
871ec03f6ce1058d821e40fd0c1599a0,5,4,2,17.5,4,1,05030,1
f18e670f2ca637467e86c5b0273e73f8,29,29,1,203,29,0,05040,1
6f8dcef769466bb731222d47fd4ffcfe,22,22,1,154,22,0,03070,1
072323f03974a341281e093e15e6e8b9,185,109,3,431.6666666666667,138,47,05040,4
e2ce54d1b8120d2706fd670b05ba2a28,21,20,1,147,21,0,10200,1
fed624a5acacacb453a2002b35f7d606,296,161,3,690.6666666666667,296,0,05040,4
4707e3ee262f787c8074583c887381f6,91,77,1,637,0,91,02650,3
8d86ef3ffaf9fadfb76eeb575fa261a2,72,70,2,252,72,0,05040,2
cba66d6d372d4de2884792ca3abb956e,7,7,1,49,7,0,04060,1
16aadcc4369e4a64c619ab5bf24589cd,35,35,1,245,35,0,01013,1
770c7499cb63df6257c0337ca01a86cc,17,17,1,119,17,0,03050,1
5d4fb54638bfe75336cebefe0f0a2e8e,23,23,1,161,23,0,02620,1
0a4194f17b4d779b950a1b5343f72118,2,1,2,7,2,0,11040,1
149477bc28d200b4b80254ef8af634e4,54,45,2,189,54,0,05040,1
e1dabaf11edca5ac904a0be8fad0e3f0,43,43,1,301,43,0,05040,1
2b6e1d609760b94f5e33e223c22d5163,167,81,3,389.6666666666667,167,0,05040,3
5fa844c4c85a49e97067d02b45e52b7c,26,26,1,182,26,0,05040,1
36f8c3c087f3d5d72428e152bcd5f6c1,445,168,5,623,445,0,04020,4
fec86a4b90245ca4893d7eb1b22fe250,20,20,1,140,20,0,05030,1
179f0a4d780e9a8b639042eb27c7c256,104,84,1,728,104,0,01026,3
9fabdc04605c332f3ff5ef0035bda0a4,24,24,1,168,24,0,09350,1
8d25bbf90b9ea62f6334b5eee2471265,118,76,3,275.33333333333337,57,61,03090,3
2ffa5084fd6d6ea9c55667a402feb51e,31,28,2,108.5,1,30,01012,1
f952f74da2ec0d6eef4e92a5f575a1b9,76,51,2,266,76,0,10240,2
087a1d94c6429313180e7f06636bd4e4,181,73,5,253.4,181,0,05040,3
3a3d03c7ac2782ed16cc7e2bb39e1bf1,28,28,1,196,28,0,10040,1
893a0d8ae4ef36ab206a0d0d4fffcd0c,99,39,4,173.25,59,40,01013,3
9ef152d415572ad33a3ebf8361e3b1cd,127,86,4,222.25,59,68,05040,3
4f82e30cee95f2d49d13531f4556f5a0,233,121,5,326.2,185,48,01026,4
d85b8536a4b188504860d4356efef482,29,29,1,203,0,29,01085,1
818d7d4bf689512e7d4568cfdbda6e37,23,13,3,53.66666666666667,19,4,11080,1
5c17b745a04baaf8f5ec99ff99804561,147,112,2,514.5,47,100,01026,3
ebea6bda6d7bec4780c3542d09b7a354,72,58,2,252,34,38,10200,2
e168b8c17bfff7040f157e7c5b5107f5,39,36,2,136.5,16,23,04020,1
cf6c2365970751b6ccdb467dcebd053f,62,53,2,217,62,0,09130,2
f757db780f9f82bcd75f146138bfbe09,122,106,2,427,50,72,03090,3
d56fda3d8a2abf7a16b901940d7bf4a5,531,131,3,1239,439,92,05040,4
73c4cd1840a8d61c18a60180d6f12846,13,6,3,30.333333333333336,13,0,11040,1
a19708642e45ce08c7e093bdf0b641c2,45,39,2,157.5,45,0,12500,1
98ade4af1433fb2357aae2a956ab1274,39,21,4,68.25,30,9,11100,1
f7b7607273752ea8fc866c85728bfcca,142,60,3,331.33333333333337,122,20,11140,3
f6e038b72620d1475f7605e0c55d62ba,134,55,2,469,134,0,05100,3
f2cf1ad3d1ceb70da9165ebf91ded8a9,94,72,2,329,94,0,08052,3
f0665e14f41b2579510ade889abca6fb,104,67,3,242.66666666666669,104,0,04032,3
c1615886172533e525a6c481f4f246d8,36,36,1,252,36,0,01012,1
36bfe2cd72e7a687d8fed27f039956a5,392,140,4,686,112,280,06100,4
acc7da6a888441618063bf866278a73c,19,19,1,133,0,19,13953,1
2ff7726b37521da7c3373fb8374ade7a,51,51,1,357,0,51,01012,1
c3fcb99d4002df86666a0b814750c866,23,23,1,161,23,0,01013,1
15eaba10e6eb7c00737f94e935ed9fc3,102,77,2,357,102,0,10200,3
0b1a887cf57ca6c522e2ad2ece267f56,103,80,2,360.5,20,83,05040,3
976d4833f959a80d53adc792826a3f48,84,61,2,294,84,0,05040,2
d507a6b3c8c11a71ed52540528b2a7d5,109,68,1,763,109,0,09110,3
736ab81e393c999aa5bd035951395512,47,47,1,329,0,47,09170,1
d7c07e8cd3963e1ed36ee0aac3fc0d2a,283,121,5,396.2,223,60,05040,4
4f0c2388ab9b35c4864d9fd0d7887a59,428,227,6,499.33333333333337,401,27,04020,4
8e5bf75830c3962d344c97db683c139e,31,28,2,108.5,31,0,08051,1
15a66c4fd6a7280d6bcaecdc7b666d52,152,111,2,532,152,0,05040,3
b26b58eb93e2108714b8e01857fe43a7,24,24,1,168,24,0,01012,1
42df07b951ae5017dbd5771b91572268,6,6,1,42,0,6,03050,1
af9e9b5479326158a6521cda3a78fd3a,40,31,2,140,40,0,05030,1
16fb9aab533ee13cd9db305bcc14a223,30,29,2,105,30,0,01027,1
eaaede19da18df7b02f6025a693bdfb2,245,137,3,571.6666666666667,137,108,01026,4
c84d4ba185a1470b062bd1187c3355a6,85,60,3,198.33333333333334,71,14,05040,3
48303250fb839e4b451093f8bab216fc,53,46,3,123.66666666666667,53,0,05100,2
6060955574f7ffbf65c93984304d79cf,106,71,4,185.5,87,19,05041,3
541bfe2adfa42a28d6dc75eb14420c64,21,16,1,147,21,0,05041,1
df4802f32973d94f1ae830cd40172ebe,29,29,1,203,29,0,08100,1
5f2c89d91969dbe9c6f8329356f5497f,509,147,2,1781.5,334,175,10200,4
6993b6f761f514ecb851c1afd435270b,44,44,1,308,44,0,13830,1
9f87a6e4375d29f975f0abc60f1191b7,109,94,2,381.5,109,0,01026,3
a593b2b1d8d4eb9cf19fc524bbcf6a5c,117,84,4,204.75,117,0,05030,3
ef60730a89d83ddef4f006de0ef627c9,29,29,1,203,29,0,11100,1
83bfa06681252f0caa1fe10fb628e2f4,156,102,3,364,67,89,14301,3
5b1fe04e910b5756c8d608852e939a77,26,26,1,182,0,26,02751,1
722c42da4698c48167dece9e686f81be,1,1,1,7,1,0,11080,1
ce27a73862b3813a5d4aa539ebf9beaa,38,38,1,266,38,0,04201,1
0719adc6d2028e2072154210b8163cd2,61,40,2,213.5,61,0,11040,1
b05534eed923dfb1a95808852e2c1387,36,36,1,252,0,36,05040,1
1aa6cf4d0f5dc5fee6bef6b295b28f6d,37,37,1,259,37,0,08100,1
9d6a7a805a26cbbdbce865e8c79bf426,13,13,1,91,13,0,10200,1
1967768fbb0c11f20bf63e4b06fdb6ff,22,22,1,154,22,0,04020,1
aa802e25c6833e819ad32588f1d77096,26,26,1,182,0,26,05040,1
9c3e0a5da1cf456b1095741b308893d6,18,16,2,63,18,0,05030,1
dc4a83b889f5c5691287925696acf20a,110,58,3,256.6666666666667,94,16,05030,3
1aef58e34e2e622903c035bdcccf3f66,78,63,1,546,78,0,11040,2
55aa69cf6da5fde86407e3f29c1c8fe5,4,4,1,28,4,0,04012,1
917b06c7028df72252f0f24bfd74cd7a,83,61,1,581,83,0,08010,3
1dfde9761e619443a48a65cc011ff582,237,97,4,414.75,237,0,04032,4
3b9fb188e48b8708e431931acf22b0ae,23,23,1,161,23,0,01027,1
5ed6c6e9ebce520ce7af5619d5e3e163,58,57,2,203,58,0,05040,2
c5a568de98e7a737dd91dc38e4f010cc,104,47,3,242.66666666666669,104,0,05040,3
ad55f1c1af33d7a14f552c73aad8f001,84,75,1,588,84,0,03050,3
37721450c36797eb6981c1f713238830,180,69,3,420,112,68,02620,3
054e0e7fe55057e9d6ad733cc57c9418,46,46,1,322,46,0,09030,1
28502a8f99a358ef3b9060a9f046dbd1,50,47,2,175,50,0,08031,1
fda628594afff9cc123e14686b1c4b3a,64,55,2,224,64,0,01026,2
ec01d0c7b9e64f1e476507009f984291,31,25,1,217,31,0,09111,1
08ffdf649c43c5da05fadf561d80da5c,99,66,3,231,61,38,05030,3
0bb5e7e2c702fb60c154c75ef0d1131d,23,23,1,161,23,0,01028,1
1b15d83306a6b23122c561f3712fc0a0,13,11,2,45.5,13,0,08452,1
6dad84cd3995a3ddccfdcb3c69961bf4,26,26,1,182,26,0,08032,1
e8a933210040e01eec3875a5e8a14f84,52,45,3,121.33333333333334,52,0,05040,2
0d36eeb3ceac2ba11c4779c435d4fdd3,161,95,2,563.5,161,0,03050,3
70de6ff157efd1b97fc730a090ba7697,36,23,3,84,36,0,11080,1
27127888129004019f5707dd989ee180,63,41,4,110.25,63,0,01012,2
2c31eb23db5cbaec1cf2a2cd3f54567d,118,55,2,413,118,0,01026,3
c17341e85e0e1dc85ace3e15b0d5fc30,26,24,2,91,26,0,05040,1
b6fffc86d32cb0987bed8967c47ffad3,322,129,3,751.3333333333334,283,39,04020,4
1b13e666254e6f7ca47809fcc539e06d,152,81,2,532,152,0,04032,3
ab66ded40682743688aca27afd1008db,104,85,2,364,27,77,06120,3
6803681c7510c5b027a2a127b40c6b78,77,59,2,269.5,37,40,01012,2
6c884e8cf757d0e5c8a3a064510a01ef,30,30,1,210,30,0,10200,1
1fb2a0684507d0d0f757d23fa349e2b3,95,55,5,133,67,28,01012,3
561610d0f31af58a7d47dafa05254233,29,28,2,101.5,29,0,03090,1
9b8dee84b2f9aa4669de9d2545f5617f,17,17,1,119,0,17,11080,1
40c795894943c9ebe30d461a788ae05d,112,93,1,784,112,0,05040,3
c5b0c60a296e0937201bf7887b493ef1,25,23,2,87.5,11,14,12570,1
2e40b1c13353e196711025f298f53042,7,7,1,49,7,0,13930,1
5248bc49ea865c10bcebbd6aff166836,22,22,1,154,22,0,10200,1
95296cdc259f5bd76eed69043f5c9dfa,109,60,3,254.33333333333334,85,24,01085,3
175dc1e218367c0d6ee60eebbeee73e4,143,87,4,250.25,110,33,05030,3
57ff35deb1c2e7438b5bb956fb3c94bd,46,46,1,322,46,0,12570,1
ad52c57b6b206a104fc3f3a59f3f06a5,26,26,1,182,26,0,01012,1
067e3fc055c89e519b147589268c1872,51,51,1,357,51,0,01012,1
b91aadc9975beb62d383a2826657f2c2,110,73,3,256.6666666666667,110,0,01027,3
51d153f7b68d682307424e04eeb3f236,113,91,2,395.5,22,91,11100,3
6b16eb618ffb203d230cb6cad5e4fb0d,114,63,3,266,83,31,11040,3
c70e735201415e2453bb9b2dd9e239f5,14,14,1,98,14,0,06100,1
f35f4df72b1b99dbd161704cd1e0b2f1,74,74,1,518,74,0,01027,3
a92264d3a2b824ca81b393d27f3875d0,82,51,4,143.5,66,16,11100,3
0635f4baf606053cadac2678d97cba95,492,255,4,861,393,99,01012,4
19b68d1d773c60c9f17a74e8201afa3f,21,19,1,147,21,0,10200,1
4d65de87e7d9b9a6e7687ad317f6f455,154,119,2,539,72,82,04060,3
54d4df9a9c187f7a7540ac48f7ad88df,112,70,3,261.33333333333337,112,0,01012,3
e1dfe0c437a13d21bd714bd4acf8d75e,23,23,1,161,23,0,01013,1
35633451f98d02b5e70b3282cc2ab1c5,181,98,4,316.75,137,44,01012,3
848d30744988673a34f662d3841425a1,41,34,2,143.5,41,0,05040,1
ddaa5767ba17d85ca961de001caf7e67,29,27,2,101.5,29,0,01085,1
d085de0ce1981867f320d72f2784c8d9,46,39,2,161,46,0,09010,1
a67258cd42896910978e900bccd96a97,138,103,1,966,138,0,08390,3
4529b853968851e894cc6df286fc54aa,25,25,1,175,25,0,01013,1
c188b69c07a6c3fbd89af244ef0b4d1e,230,159,3,536.6666666666667,230,0,05030,4
9c3a552e0d69bd5ab7c32e71de7c4bd7,269,127,4,470.75,183,86,05030,4
27d6aa5c55ffc0801118f3f8d8f180b5,19,19,1,133,19,0,09130,1
9fdb43d1b199e48f56bb3d14137ef54a,21,20,2,73.5,21,0,10200,1
8650547cb336c81d9c7fe1eea07218c7,185,133,3,431.6666666666667,151,34,01085,4
4edb5b462c66bb1d45a60ec05641a3f5,78,57,4,136.5,78,0,08314,3
2fd91cbbad680f1ea52aae7759424555,40,40,1,280,40,0,08314,1
7e16c53b7789e242f3cc031844a4f941,48,48,1,336,48,0,05040,1
396d9b9aed274cf025e7b1f1307cbf6a,161,99,2,563.5,161,0,01027,3
bc6bd7e6c30fe90879fb86d71271cb11,54,53,2,189,40,14,09130,1
27ecfcc88692fb816372f7c8cc906ec4,44,44,1,308,44,0,03050,1
53e07a5a16d3d38c5925c3b0aa19e674,136,69,4,238,98,38,09030,3
34509227c91fc5e0d6d5b72201891e7b,109,79,3,254.33333333333334,73,36,01026,3
e6c425e64b16b3ae9c11b1146396948d,78,44,1,546,78,0,09130,2
4ac2bf53900a2b5b899ee685468cb26f,58,58,1,406,58,0,09130,2
319379af3df1936315d430baaa8330ce,38,38,1,266,0,38,01085,1
47bb6f750b5f7667fa7c62017abdb3e4,192,119,3,448,192,0,01026,4
12de5c9b167b0230cc2178fd5f326ad9,242,132,2,847,242,0,05040,4
b3385c0c024347c80151e9f3fb5cf4c2,18,18,1,126,18,0,05040,1
d08b72fc5e8e2c5d33c3e89a141499f6,36,36,1,252,36,0,09010,1
6175847bdc5b95ece79209fc56a12ade,369,136,2,1291.5,302,67,01085,4
635caf581c439e95acc788e0bfc01509,476,149,3,1110.6666666666667,476,0,01026,4
fae913bd55fe5cd1c81d66180c45a593,58,58,1,406,58,0,05100,2
cba0a7af8669584239665c222b024c08,33,33,1,231,33,0,01027,1
7aeac21f6628b543e64dbce2aef4f03e,57,48,1,399,57,0,01085,1
921cc7356ce901ca065c2553a01b2495,175,107,2,612.5,175,0,10200,3
59d469a5a37835edcf4848f675c95d81,87,62,2,304.5,47,40,01027,3
c5616337c71bdd13ab223233575719b0,285,149,5,399,268,17,02691,4
96099dab63e754ccb32ab352feddd489,159,80,4,278.25,159,0,05030,3
627eba60c831e20c664d8e422d466036,119,75,3,277.6666666666667,119,0,05040,3
02853ec9e41d862de6e05201ba1ff651,187,97,3,436.33333333333337,187,0,01027,3
9997ef84c50b1384a16858dc9917ac18,319,108,4,558.25,171,148,05040,4
9536603a36563e9087f50803d258957c,102,72,4,178.5,85,17,05030,3
ed85096458a7e3694b8790aaa01ed78a,34,34,1,238,0,34,04020,1
87d5d6934aec909d6c01b144df64ae3c,215,87,4,376.25,191,24,12670,4
a607452c02ef3f921d4b3e69630a6687,128,87,3,298.6666666666667,128,0,05040,3
3cc40466e2656b82f0213eca04c8f52a,34,34,1,238,34,0,01026,1
217c2cf44fe841dbdcea4e6c4a6d02ea,184,82,5,257.59999999999997,151,33,05160,3
ca83cc00dfbf9c9670601420550c3f95,40,40,1,280,40,0,08132,1
2b67138462a36fdb4f81309d98a67b24,30,22,2,105,30,0,08150,1
5d225e690ade721682fe1a3fcb0973f6,14,14,1,98,14,0,01013,1
aba32c7094c49a5fdf03e261fdcdf4c1,45,28,2,157.5,15,30,05040,1
aa7823b8c2954b3ed6ad3240d66a4c2f,26,26,1,182,26,0,03050,1
e8fc3d3f0254d7b02c1c02a7e23d2142,17,17,1,119,17,0,09091,1
3fb024beaa55e3ccafe9e14bac23aff7,104,47,2,364,67,37,14301,3
e434d125ea12a5c75f859f8dd49e6fe7,44,44,1,308,44,0,01026,1
f52a7a61917760a45c3d78a7ef1c3c00,68,53,4,119,33,35,10240,3
5300e8a847005059e5665b34cb604870,126,70,3,294,126,0,10200,3
5c7d9ac7a6d0ef8208957839b43abad1,42,35,2,147,42,0,05040,1
65d35184893c75ccdd195b79a8f60014,157,104,3,366.33333333333337,112,45,05040,3
b843b2aeb2507eece4108801808e8df6,67,67,1,469,0,67,09090,2
4e45d9aa0ba1e8f1194e5e3183f65fa2,79,59,2,276.5,79,0,10101,2
b7e08606f11d9f0271fbf62196f69199,135,94,2,472.5,135,0,04060,3
7030150915ddab9a7f7f5cfc327e2380,141,45,4,246.75,141,0,05040,3
beae32966b423f856acbdb410e8b2d31,39,39,1,273,0,39,02650,1
35161674c09b2a4550034c0218efecd5,9,9,1,63,9,0,01012,1
b4767a756e3f8d65c211d400562721f3,65,47,2,227.5,65,0,05040,2
9bc03343861204421c33459f6bf2d839,153,92,4,267.75,74,79,01026,3
2e809e7baf52b9c1dd1bc7718685a821,356,88,2,1246,356,0,05040,4
4495e3f739691711922efdcafa1d583b,28,28,2,98,12,16,03050,1
21d72dfc7517e2991ba16d0d0da19a97,513,131,4,897.75,513,0,04032,4
4c09e4b85c7d8252ebc46ae6df7b5842,73,60,2,255.5,73,0,01085,2
721b7661a35003a8cdb386a11415fc28,431,180,5,603.4,359,72,11040,4
13494eb9ef992595cd742b62c782a2b0,44,44,1,308,44,0,02720,1
94bbec38852c4e377ba4cc7c1fed1b86,27,27,1,189,27,0,05040,1
4f3013b99288d31adb071524f653b315,49,37,3,114.33333333333334,49,0,11040,1
b921bae3de7425b1e855c899073f7d36,31,31,1,217,31,0,11080,1
498dbd64e253fefeefe20d55135cbe31,70,57,2,245,70,0,11040,2
b6ae77eca015abae5549c521e9039de2,6,6,1,42,0,6,05030,1
2f41da19b1978b7abc05c2fb2ea64a8a,24,23,2,84,24,0,04032,1
92ba06a6cc1fd38b788288936e0e4e69,279,136,4,488.25,194,85,01012,4
775b9d0a43b068cf36dfd15f44cc1906,194,104,3,452.6666666666667,94,100,05040,4
ed1def6d9f418e8570d2c17b4b3eaaa7,311,115,5,435.4,277,34,01201,4
bec0b7628359e6f1efbd9b067a9ec98b,17,17,1,119,0,17,01201,1
d9526dc5dc511eb4d95501b46c7012fc,200,133,4,350,138,62,01026,4
b2fd4edf34174d56a8715ca06adfdd3c,36,36,1,252,36,0,05030,1
d8d1e6f41edf644ade99c6256fc034ed,59,58,2,206.5,59,0,05040,2
6afd1dd79af658c3974f690702441106,49,49,1,343,49,0,01013,1
77ee317123e3e86f80d2e5fe4a1ff2ff,38,38,1,266,38,0,01012,1
3ed41734cb859670d770d67cbad86c3c,12,12,1,84,12,0,08452,1
d79ccbc8f539821134247ccb3300039b,56,53,2,196,29,27,01085,2
29653aa4aededec92a4ceb7c5981008f,2,2,1,14,2,0,05030,1
d66b7d5ebaae4ce1bfccbeafbf973961,106,95,2,371,106,0,01026,3
72b5c0da3cca896d4ed53d5694703704,106,64,4,185.5,106,0,01012,3
e95cb9d159864dae6ba70036226e8132,200,117,4,350,169,31,01027,4
aaf26a94dd27a136d8a36f41a8bb0b88,106,77,3,247.33333333333334,106,0,04020,3
00a8f692918c6fbada0e3d763353384a,17,17,1,119,17,0,05040,1
905bd826bcb576a4f80e7a32851fb4e4,41,24,3,95.66666666666667,39,2,11080,1
f30808ce6806c7dc367376ebe55674fb,53,52,3,123.66666666666667,53,0,10200,2
48abe8f5f6c028e9e0e8f78837341e76,66,66,1,462,66,0,01026,2
dfda77214ffff61ab6d5ca71e752e5d0,23,23,1,161,23,0,05030,1
52fdadca6c121c460083d503c8834bf3,30,30,2,105,30,0,02690,1
dc7b1d7eea2aead94d85b91b10baebb3,238,129,2,833,30,208,06100,4
dab759be10ca9dacd821dcf949c2545e,90,77,3,210,90,0,05040,3
59c5b8169510971726ecf56183bb5f16,139,71,2,486.5,102,37,05040,3
da233aab458f545a27e5c0760b1f6f10,111,83,3,259,60,51,05040,3
ba8e33c907bc09dae0c9a12987a2c2d3,115,73,4,201.25,115,0,01026,3
86167ed483e4fd4991cc634bad04a054,1,1,1,7,1,0,12770,1
5c4db951583868f531c08fc268726d5f,311,122,2,1088.5,311,0,05040,4
acd3c669ff6160c2f9f44876390140c2,41,38,2,143.5,30,11,02620,1
49555234af3a341a3840c418018a0079,258,125,6,301,209,49,10200,4
fd74ea5e14ad82b18ace7f0f64d2ac35,71,53,1,497,71,0,05041,2
cbd8b819ea7906e9d84fe8d94e957c1a,66,66,1,462,66,0,01026,2
9b7fc5a20d8d75cdfaa71ae9e27446ee,11,11,1,77,11,0,14301,1
74048282d57cfce02b1e4b6023bdc67c,67,45,3,156.33333333333334,56,11,01085,2
ebd82e73956d909271049f169f15e5b9,240,126,2,840,240,0,08314,4
00790c20de4dd762da3935e44500c703,84,66,1,588,0,84,01026,3
666b946b78701e33f31be56e970cf6af,169,67,5,236.6,169,0,05040,3
d8513f838363507783d0d70aed5530d2,47,43,2,164.5,11,36,03050,1
f646129ba2b0c20d2cd95b72819f86e7,26,26,1,182,26,0,10200,1
9b7fb38c3a2e760b4a5020b7fafde3d6,16,16,1,112,16,0,12570,1
09a9c9e6595dd2ea3766d520baadb478,41,41,1,287,41,0,03033,1
32be599f8d40a813ced27dc7c8feec3a,168,102,4,294,112,56,05040,3
7767961fcf909f84543827f83c59fb8b,153,82,4,267.75,131,22,10080,3
e3910d55c33641943ced03defbe9de77,1,1,1,7,1,0,10153,1
678c5b4517b08c83212e3cb393011afe,318,119,3,742,280,38,04060,4
40c455a6a26484fb43e2312ccb0a5ab8,240,116,4,420,182,58,12500,4
b7d20e6a237bdc1c0dd10b811f4142fa,140,74,3,326.6666666666667,140,0,05040,3
d66ec7fc2d85e2992e92bf684201f65a,39,39,1,273,39,0,01026,1
01c3a379e029f541cc580dc1fddb0e8f,21,21,1,147,21,0,05040,1
9d98698749b20eed92f172abdc60955b,4,2,1,28,4,0,05040,1
1c87f534dfad64c7fa937b5db3554533,24,24,1,168,0,24,01013,1
3fa21b5b5343eeeabebdd5a82dc3640a,55,55,1,385,55,0,02650,1
b3978b9ab78b3662ac7da328f5c68a7e,25,25,1,175,25,0,05030,1
896e83ff1085cda57f9f38d7822e7afe,62,51,2,217,29,33,10200,2
a97c09cfdea1ba696599bc469deb763b,140,91,3,326.6666666666667,140,0,10200,3
c83d4a79c1545fe3c195a22e8dca6780,61,53,3,142.33333333333334,61,0,09150,2
4f6e9f93595209d57245c93722ba1788,190,81,4,332.5,190,0,04020,3
c561f0b7bc015d3b85906127994e14e4,34,34,1,238,34,0,03070,1
8e9a0accbc84354183f2881afdf2d216,18,18,1,126,18,0,03033,1
69191f697a002ebc3a0f12dabd7f0390,31,31,1,217,0,31,12500,1
6940d5b0009b911ba412d1b124d1a248,16,16,1,112,16,0,05040,1
71e9d1c0cdaf4929b93d41947e151b47,30,30,1,210,30,0,04201,1
21c028297464b75e3f67cfdbb85ba2e1,68,68,1,476,0,68,01012,2
134c88dd0bd726faff862c75311ac9a4,210,131,3,490,110,100,11140,4
e7a08173b96ded5485e6f3b696352974,23,23,1,161,23,0,12501,1
60e4560e57fae2c6b70119bb94f36cb0,53,53,1,371,53,0,14301,1
a51995c0efeede2639c6abb89b088dcf,30,30,1,210,30,0,01026,1
550968fc6c4adc42189f24172be6affa,27,27,1,189,0,27,09050,1
aa273856611a48f28c697694235c08cf,115,90,3,268.33333333333337,66,49,10240,3
40ef3832caf233bd692b000dfb7f8359,36,28,2,126,36,0,11080,1
402543188ea5163dd44f382489262cef,345,168,3,805,205,140,05040,4
6224f154b3001d5c80bd6eed943ae8a2,77,53,2,269.5,53,24,08090,2
02960bd19b4179386088cb23b4df29c9,95,80,2,332.5,95,0,01085,3
1189400c209f43af067f6988d93b9a93,96,70,3,224,89,7,11100,3
d9c1eaab830b77aa14a73a0dca9503ad,18,18,1,126,18,0,03070,1
3bcdb08793bc5f3305528103508241d8,51,39,4,89.25,35,16,05040,2
b4083b73d16a6c578dc59dac91e8d172,64,46,2,224,64,0,01026,2
e4ff4888e2d49566705e14195ad78841,207,148,3,483,123,84,01026,4
870979b5a519835fb5806ac1874c6005,83,74,2,290.5,83,0,05040,3
17bfc73b083d485904e10b696dd7ee68,15,15,1,105,15,0,01016,1
1378e4802bd4472324f878a2d9b1cc68,63,63,1,441,63,0,05040,2
a09982a3c88db7a945b88efd40526a67,72,57,1,504,0,72,03070,2
fc7ce9e8f2fc38c08e2ca05c70c08bcb,361,102,5,505.4,298,63,05040,4
d04bd1b544e39cfb756476c4c889bb0a,157,106,2,549.5,157,0,05040,3
8549eba7f34c7beddb4f141109e8e52b,137,79,3,319.6666666666667,137,0,05040,3
b7aa9caa5da75b75bf1139dc27d75350,124,84,3,289.33333333333337,124,0,05040,3
c5d3aec517a2c6f0919a17142f005687,40,40,1,280,40,0,04201,1
ba3447eb17d0d7cae1d399533196ecb3,53,53,1,371,53,0,10220,1
a196c0451f10e567c23f1ca1ad2870a6,233,96,1,1631,233,0,02754,4
722f11baa7b2844ef1a7fae33308977f,71,61,2,248.5,71,0,02650,2
3432156462c8f46d7261284483c11b56,50,46,2,175,50,0,11140,1
b61ddebfd05764af5b5d6288ec8bd8f4,134,90,3,312.6666666666667,85,49,10101,3
d0a04a125a9af11515f2d5367aaaf5f6,17,17,1,119,17,0,01012,1
0775647adfe6e43c1c20d66ef91d661a,120,84,1,840,120,0,01085,3
606fb01aa9bfb9248d877373beeda013,581,253,5,813.4,419,162,05040,4
6ee26a1f5e32bc49598c64e9d2f67630,11,11,1,77,11,0,01201,1
d6ae2e7015f873a0108fbd1c68da29aa,154,56,6,179.66666666666669,93,61,10028,3
1465ceeaaba9d4bad12e83b490fb83aa,42,42,1,294,42,0,01085,1
14f0700e40ec1b5c1f4b61ed320eb000,26,26,1,182,0,26,05040,1
e06ebf16cb755fcad60ebee33f2d338f,23,22,1,161,23,0,09030,1
572e1c8848d57e1f82e607c18dfe0f14,329,210,5,460.59999999999997,275,54,03050,4
44b42ce9f64195d0d8ac30218cbbc660,46,37,2,161,46,0,11040,1
ad3735b5f365eaec418b7faaa07d1452,29,29,1,203,29,0,01085,1
66f2e0d46688897e531ed7b3b3ccf7b5,28,28,1,196,28,0,01027,1
3095d15b42f2f0c083072f93b7add199,97,75,2,339.5,39,58,05040,3
30d3c3a267c17458fb927b55cb7f95ca,78,78,1,546,78,0,10200,3
e3aa0e4d44bba3b61c46451634886154,15,15,1,105,0,15,02690,1
063a25102760ce9d36102e4319c29ec7,175,92,2,612.5,175,0,05030,3
c0ba70b788a07be647cca53aacb94133,266,114,4,465.5,266,0,11100,4
7b4c8fe3688d6203a54800ecace24d60,27,25,2,94.5,27,0,08052,1
1bdaea60e29c5384a80df3aeb2dde03c,51,37,1,357,0,51,05100,1
81edf5046bc13c48609970e01c8bb4df,26,26,1,182,26,0,01026,1
5a46c7db4324da59201180bc1c507820,20,20,1,140,20,0,05040,1
aa89faae6333e087faeea7f70cd07821,128,62,3,298.6666666666667,128,0,01027,3
4e840f5c68d4a46e32283f3024e4a2de,52,36,3,121.33333333333334,40,12,09090,1
4ee3c716386fa3b9469569b0dfae4515,62,44,2,217,62,0,01012,1
bd4ebb0ba7b26c90c5379c2328f65dd5,52,52,1,364,52,0,01026,1
21a34785fffdd945116b511e03580e14,24,24,1,168,24,0,01026,1
8585b17d3b0f54ebd207dac73aea1d17,79,67,2,276.5,79,0,05040,2
6b527c61e31935b7945e22b64fa333f9,76,59,2,266,48,28,03050,2
f1ae1cdcf48271e49d1b15270b827de2,59,42,3,137.66666666666669,59,0,05040,2
ee305849ffc09f4e16968a0563be7f61,14,14,1,98,0,14,09130,1
53588f43c30aecb8552718197f604950,291,97,2,1018.5,1,290,01012,4
dae076190ced22796b7e3a7e263b823c,43,43,1,301,43,0,01013,1
3fee5c9ee32bf0d301331b7d715f767b,92,53,3,214.66666666666669,48,44,01026,3
2830b953b1873f41a465b67f70308145,133,76,3,310.33333333333337,133,0,05030,3
0dfd11dd361c4b10f94f3f9f9227ad98,104,63,2,364,104,0,03050,3
21abc844d66826fdaaf0e715f8e62c5c,19,19,1,133,19,0,01012,1
eb66c961f38799663f571e32824bc689,61,44,3,142.33333333333334,61,0,01027,2
2313b03062e009db5df6f6effe1882ff,295,94,2,1032.5,295,0,05040,4
0e0966c8b36b267d6e3c91dc83f7f4f5,15,15,1,105,15,0,09130,1
41bdc5cb90c6f68c0213418f1b9e28c6,44,39,2,154,11,33,10153,1
aa38e1363da9757f2eadd675cac3e306,49,33,2,171.5,49,0,08314,1
768e4e7a8482f92bfe7145312092ce0a,335,146,4,586.25,335,0,01026,4
8b7de16400a2e56175f585798ec11162,352,171,4,616,352,0,05040,4
b579851d5ce0c243f21d96efd64c6937,10,9,2,35,10,0,11103,1
1922fae52da0b8b5437d559b6843a137,10,9,1,70,10,0,05030,1
c524a87434273fe2f647a36814179c76,53,53,1,371,53,0,04060,1
0ddba9437a77bd7584c3539f7bc23f0a,219,74,5,306.59999999999997,188,31,05040,4
d562c99416f0869ad7eb34c0f4314e50,36,32,2,126,36,0,11040,1
98742884c8d246866540976fc8e7e767,98,52,3,228.66666666666669,98,0,01013,3
f8a3150e0e4dc0cc3921f07f4da3ccd4,154,69,3,359.33333333333337,87,67,05030,3
5c8582eafcce71c5ec9348d498adb5cd,584,144,3,1362.6666666666667,584,0,04020,4
b011d65942829904665593b142f6a3cc,239,76,2,836.5,137,102,05040,4
c3ace3f8ee5d3c661f42ec34c386f649,114,63,4,199.5,114,0,05041,3
0f2dc044aa0afe4f18277547ce02a35e,55,55,1,385,55,0,01026,1
e0047da7e1d1a0eb195e15b53c5038d3,141,98,1,987,141,0,01085,3
45f2ddaf3c136d9de5f84a95e999d04c,409,107,3,954.3333333333334,409,0,01026,4
743d4bc54bd47bb3f5d7d4af0f130383,71,47,3,165.66666666666669,41,30,08150,2
0fdb256ddec8b02dac3978d7e3213322,24,24,1,168,0,24,08010,1
674bdc48c7db4270c721bfe99b770089,29,29,1,203,29,0,02690,1
391e3b039800c63b2845b3d1269a35fa,115,73,2,402.5,59,56,06120,3
5e5e73dfcf3ef79e58888d21661db8a9,5,5,1,35,5,0,01013,1
4d2d95bc90595416b8898ed8560fe5ce,54,37,1,378,0,54,04020,1
d3f96a89b66265726c2401346b0d003a,51,36,2,178.5,51,0,05040,1
8c68acab60f036547ff785af54fede08,76,68,2,266,35,41,01012,2
3b76a7a0f8eb9d6e543d85a82d4debdf,20,20,1,140,20,0,10200,1
c08c33bcb1011a3b51451e96d7b37dbc,31,31,1,217,31,0,01027,1
c72d5f06a63f9743f301e3f68a5b6744,57,19,4,99.75,57,0,01012,1
57dbf260cdef3e3eac98549fad25bafd,53,43,3,123.66666666666667,40,13,04020,2
87edd9789cdb7bbc05e37e5347625912,24,24,1,168,24,0,05040,1
85840cc10b23b5b8d39da41ad5c3fa8e,18,18,1,126,18,0,03070,1
25b7b7044ab4629ec1e3550866b387d4,89,65,1,623,89,0,04200,3
dd10cb78389b9e49880d819fd56ef623,86,61,1,602,86,0,09090,3
39d400c95e861a029fa66fdb02fe2f9a,54,39,3,126,22,32,05030,2
a410ffef77139546a39121db053e7eeb,10,10,1,70,10,0,01085,1
f4127e27615d6a6e3078413de72e3b2c,41,41,1,287,41,0,02650,1
86c27e6856eeb73fa77a1966f8992efa,103,57,4,180.25,82,21,09190,3
314b5c7e4b6af9d4d2981719dd7411c8,73,56,2,255.5,73,0,05100,2
57308a1426e1254a48093c52aa4eb6b7,42,42,1,294,42,0,05030,1
2a0e9c4ff31325b0e655d55563acf6fc,280,128,5,392,184,96,01012,4
270f856aa56578bf2c6d0287743c3f54,42,40,2,147,42,0,08100,1
da97eec080b03779636c0b6c1bbc6218,22,22,1,154,0,22,02751,1
c81d2b985f245a286131fc74edc08a37,30,30,1,210,30,0,01026,1
13cb5648af1ca1a9fb52ce0754485a40,377,187,6,439.83333333333337,309,68,09090,4
19870c894884e720b1941768182af046,26,25,2,91,13,13,05030,1
722f3dbd513a87e281e42d2bc00e7156,51,40,1,357,51,0,05030,1
5e4abde9ee9060c9c4f3900264971eb4,40,39,2,140,40,0,01012,1
94a5e9365944615ba0a3f11d529ba977,48,48,1,336,48,0,10200,1
025fadaca239339e929c0186f673b2cb,19,19,1,133,19,0,05030,1
57745f44958dcc21a0e62445255072dc,137,83,4,239.75,120,17,05040,3
0684d5d585f99c44e96c686717229065,40,34,1,280,0,40,05040,1
a619b9cc4b29124b5df22916c6a8ff33,26,23,2,91,26,0,08230,1
717fdb60d2ed25646bc1547e0a47f37a,39,39,1,273,39,0,05100,1
fda914c43288327361de52a7dd072324,24,24,1,168,0,24,05040,1
756a5c1d233e25b125a9e8f454e438e6,202,82,5,282.8,170,32,11100,4
54b034f2e31f8c3d9c1d8b30e7b0f81c,39,34,2,136.5,39,0,10200,1
c8a233e055e7e519be4d9b7a4090b588,75,52,3,175,75,0,05040,2
8c3a90158e69849238752396506e9d0e,69,60,2,241.5,69,0,05100,2
89ad3105b7ea11736e3e57cf2e46c8c8,22,22,1,154,0,22,05100,1
503ffd2f182cb25875637a6b8990992a,31,19,3,72.33333333333334,23,8,11040,1
c62635dfcf3134ea86f340ffdb6b187f,40,40,1,280,0,40,08010,1
dec6d663a03127abc3796b6366530c56,44,44,1,308,44,0,10200,1
78249e7e95113c3af765365ef1ce8744,204,124,3,476,204,0,01027,4
6ea0c0e2dbf6ede50abb48e449f0aeaa,13,13,1,91,13,0,10200,1
658a4de7bb5db3fd6c6fd3ee996d366f,3,3,1,21,3,0,11040,1
fd21857726e88023a55ac3fef022f11c,18,18,1,126,18,0,04201,1
1a6569961e7dcb90bf8cc6a89a0c9089,130,56,4,227.5,90,40,10200,3
17d85e1712921e91179e7ec5d7b69f1e,39,31,2,136.5,39,0,11080,1
3c03d660900176eba25e67d135990816,40,40,2,140,40,0,01026,1
d1386e8eaa8b3ff409535986f42907f1,94,59,3,219.33333333333334,94,0,01012,3
14dd0873f48a633005dbf533a2ff9544,37,20,2,129.5,37,0,01012,1
3e00316aac3ce8a549b838bd06cd99c5,169,96,1,1183,169,0,05041,4
241e3ac30a63c7a06c95085e8a6f25c2,31,31,1,217,31,0,05030,1
2d2b0b58c626440266e729d85b82ea00,32,32,1,224,32,0,02650,1
1e82558fedb033d6f3412bce4c835a44,48,48,1,336,48,0,01201,1
c8d85733214a384ebe80149b9d6f328b,98,56,2,343,98,0,01012,3
c61c06b195a65068307d427020e61827,41,41,1,287,41,0,01026,1
b5e7a79332db976606ed7068314f5293,36,36,1,252,0,36,05030,1
6461d8fe51a0cc1c08f214ffbb23d0df,349,100,2,1221.5,349,0,10240,4
efce697654733a702b678687360ae590,148,97,3,345.33333333333337,148,0,01027,3
30aa2d35c78f12266df7b04541d951f8,72,72,1,504,72,0,09030,2
e8a343de71fae7267eeb68f276e85094,4,4,1,28,4,0,05040,1
3eee431ff0bd63783b6221bdf6179372,156,99,4,273,123,33,05100,3
67148edb095c329bd741cbac8bdbd282,14,11,1,98,14,0,01013,1
099a08a66763c5c367806983df245c41,24,24,1,168,0,24,04032,1
fb7b6ca5312d230a3ec58a8ad13427b0,8,8,1,56,8,0,01027,1
4691d373debc70393d3d785fc6a35e3e,95,95,1,665,95,0,09030,3
7e9723cf8022773382008c63e5a6e2fd,2,2,1,14,0,2,05030,1
ccc8cdf4400b2681d39f4d545988e10b,47,44,2,164.5,17,30,05040,1
ad02043f48c2f2325ebbcabb920ddb8a,100,57,2,350,100,0,10200,3
63e91f23e967eea957022adb12a6240c,15,15,1,105,15,0,08452,1
12411eb58d4568801acb27f67ef3222d,63,60,3,147,53,10,08052,2
62a222273c9964fbbfbd2b1085479a37,362,86,6,422.33333333333337,267,95,01085,4
fc5f9c2b2030afe9a675d969a27eb83e,259,141,4,453.25,199,60,01013,4
04fba1b6ab9facdb2eac2c9af73881e4,67,46,1,469,0,67,08312,2
29efb89ceeed630798020b40fe3a5385,14,14,1,98,14,0,04033,1
54b88fe7dd854567b01073a4ca078346,39,39,1,273,39,0,05041,1
65aebd57d0957a73154de9245ca71883,36,36,1,252,36,0,03050,1
a93a7078f8f3bdda0d63bbd0a2e2cee7,21,21,1,147,21,0,03033,1
c7d76b5d967343f39c9abaa3a836e75f,23,23,1,161,23,0,09130,1
bbb586646a8fee399b743dd037405160,102,52,3,238,33,69,05040,3
14a3b6de2ed35b85273d4c7eb909b7e7,208,42,3,485.33333333333337,208,0,08150,3
55075d0e24a695704854f210d0e03aa9,126,90,3,294,59,67,09150,3
e98f853cbea1cca81ceebe9ea415c206,110,65,4,192.5,110,0,05040,3
54cf8219dc47b2fe2b910ab7f515d02f,32,32,1,224,32,0,05040,1
8e31c76af21a18ee64b3342f0e3fabeb,48,38,3,112,30,18,05040,1
03d786b1d1c8706700fd7e307db3f128,385,110,2,1347.5,33,352,05040,4
e67321fb757d1f760d43bbe5fc86a505,170,90,3,396.6666666666667,170,0,05030,3
a2485543d52b7923386f500ebe7dccc1,207,141,3,483,140,67,01026,4
c150bbe327a0497e3d7f19989ecf31d5,28,28,1,196,28,0,10220,1
5937479fab4605828ebd57ef40aa7e2d,80,57,3,186.66666666666669,80,0,11040,2
4f75ba2e21fd6d43cb4aaffc96bf4828,16,16,1,112,16,0,05030,1
e5e50cd58c6fefb3b5cd3adec9f3e645,3,3,1,21,3,0,10080,1
4fe017fe8a9d6418abf185b322f87622,25,25,1,175,25,0,01027,1
f80b81d9e8953483ec2a0e60d84f4caf,90,40,3,210,73,17,10153,2
e84961d46cbe67a0a916ba49b17c1401,575,145,4,1006.25,422,153,01085,4
f06d9594bb2c4bebff08dab9fe6ad19b,248,120,2,868,248,0,09130,4
f579ecc965fe9fb940d1f74d2de346ea,72,56,3,168,72,0,09130,2
ec3896f5ea82e314a4a815ab1b37bad7,10,10,1,70,10,0,08150,1
8dd33b8a674926f1a6789e0563d620cd,60,51,3,140,60,0,08230,2
63919da1968dd92b4ad23fed351014a6,4,4,1,28,4,0,09091,1
6fbf68de5656d1c5d317b64fa79010cb,64,48,1,448,64,0,05040,2
762c0c329e253968903badda99798f72,15,15,1,105,15,0,05040,1
f7c0a43a87016cbd0c0215694f670845,73,54,3,170.33333333333334,73,0,05030,2
9184c5cf83e8a57d2d394926ba6749fc,17,17,1,119,0,17,13580,1
b418eaca636c92e440909178af55bd2d,204,104,3,476,159,45,05040,4
57fb6ea8e2ef74979ddf9e41d60f52d1,33,33,1,231,33,0,05040,1
421152c55bb4058aed03268d13ae1559,121,83,3,282.33333333333337,121,0,04080,3
ec2f16c807a2a4931e11fd435b81a71f,35,35,1,245,35,0,08032,1
526915592e98a95ba04f48c2567c6545,77,77,1,539,77,0,01026,3
deed7c97a4190585e0f3872b04617a56,83,62,2,290.5,83,0,05030,2
4f69a9ab4037adebed7f14a6599f79d5,15,15,1,105,15,0,05030,1
b0e31083a0e6a09358d5210761a77daf,213,119,2,745.5,213,0,05100,4
776fce7d03184ae611eca7f1ec2caff7,241,132,4,421.75,241,0,11040,4
cc4cc6a99e87f0fa91db5ff07eff4adf,29,29,1,203,29,0,01026,1
e9710831e531f564333c78e4c81cb2f9,25,25,1,175,25,0,05040,1
28936914f462b0249a3983ef58a27b2b,3,3,1,21,3,0,05030,1
b77e25ac459379aa6de2de646fccd504,14,13,2,49,14,0,12570,1
bc747622b9a96d0901fd33cf091ea222,159,84,4,278.25,140,19,05030,3
987b9fd8c96eb5763c196e5e5f1ab559,68,53,2,238,68,0,09170,2
ccfce5d71850196a89ff458a7ff2849a,2,2,1,14,0,2,08051,1
bb42bd881ae0ca284426854676bec51a,30,30,1,210,30,0,05030,1
5895e820106d83ea95b4f00106d8982c,9,9,1,63,9,0,11100,1
79cb1eaa1407eb4e637abf5eee52b0c9,28,24,2,98,28,0,12650,1
c2ea1e3fe1077d84edfe632a0dfa7700,108,58,3,252,85,23,05100,3
365939fcd7b06a4b9ae4fb478a438552,107,73,2,374.5,107,0,05100,3
e343788790d4ed9699620d756f60434a,72,55,3,168,72,0,12500,2
7777282540325b5cbe9020d18a3cd507,479,141,1,3353,0,479,01013,4
4cc748c1463fd2db368607e114b290e0,417,127,2,1459.5,52,365,04060,4
a5d59053ee9146a6b0be58bd82921972,165,91,5,231,98,67,01085,3
fa1fe285fbc6e665eebc60e017308ac6,40,40,1,280,40,0,01027,1
e47abc1a347958198c006556564e7b23,138,98,4,241.5,138,0,05041,3
9a4c87b457ceec0405a96049b229a6e9,31,31,1,217,31,0,01013,1
22065658d82027a7261809760f640ec1,56,56,1,392,56,0,01085,2
aa0b25812d2073805b5ab7add69cb23b,26,26,1,182,26,0,09130,1
1f632c7566a81c2c387cc9503da63521,24,24,1,168,24,0,05040,1
54140bbe92c9900823b26c4551d9e0b0,256,140,3,597.3333333333334,135,121,04020,4
4ccac87759ff6b293b9b49462c3c56f7,29,29,1,203,29,0,05030,1
0e9fc0fb33703a7390b7e46640d8ba3d,95,79,2,332.5,46,49,09130,3
2faeb4089626e3888ffc230d54e3f932,247,89,3,576.3333333333334,247,0,05100,4
8036db5678d4f53a36c3fd55f5b795cc,103,74,2,360.5,103,0,01012,3
70c2871513bf87292ec3c381cd5c6ae4,40,40,1,280,40,0,04201,1
d44d1ee7a0731f0540a9c4a8eae81e29,94,72,3,219.33333333333334,94,0,12501,3
4fc347bfd2261010012b37015b8eb883,31,31,1,217,0,31,08150,1
d68f7d46fb95daf0ee62f95081a7c326,513,188,5,718.1999999999999,407,106,05040,4
baa86fd2b3ceffc0f10e44e324a5c42a,118,83,3,275.33333333333337,82,36,08313,3
bbfb99fd9dd67adf396675b9b32326a7,23,23,1,161,0,23,12610,1
5794a6dbd918116fefe2815c1b4dee3b,7,4,2,24.5,7,0,07141,1
d73750107bb74d5d4134a3f67c3e4854,28,28,2,98,13,15,03050,1
7789ffc49968b1d4fb3cb3260af77704,40,40,1,280,40,0,01016,1
6de3a90095e7ee6267400cf3971f2789,15,11,2,52.5,15,0,05030,1
b36489a6a21e214ea5a36e4d31a6c70b,46,45,2,161,46,0,02691,1
66e9524c3f8f56281d5450e54613d9b8,85,57,3,198.33333333333334,85,0,05100,3
b04f0a9618d6ef078f93fd652eb8ba29,230,132,6,268.33333333333337,203,27,05041,4
137f16d10f0e0808c7d281e47ff62ccf,61,42,3,142.33333333333334,61,0,02690,2
d32d918bb80bf56afd55e064227c2093,120,64,5,168,97,23,05040,3
15b436bf199802e7eeab41b72a1a4cfe,3,3,1,21,3,0,05040,1
67a377b94450ab2545da4b830a0d752b,126,88,4,220.5,126,0,05040,3
f69f68086e75200a42491c1ffb591980,62,62,1,434,62,0,10200,2
7cc0f2fb81b6178fe017ccd93271b58a,16,16,1,112,16,0,12650,1
33b6bde9b6906cd487f74b9735958681,12,10,2,42,12,0,10220,1
a1c10751a599ba7ed673c2068e6f24ba,249,108,3,581,249,0,05040,4
65e526b378d983d4e906c06cced7bda0,82,71,2,287,82,0,05040,2
ead47d49b026a80d50f055a202a15682,217,78,1,1519,217,0,14301,4
fd5de2beceaa08c101766a4b0110afe5,63,47,2,220.5,63,0,10040,1
8254b5ab0bed29dcb7107f1acaf3955f,128,97,2,448,128,0,10200,3
b92c551e62b6640265cb6864510ed6f7,23,20,1,161,23,0,05030,1
308df039a32522898333bbb7b996a2e2,29,29,1,203,29,0,03070,1
9e109e26198f5cc80900a73788339327,33,33,1,231,33,0,01012,1
94fa05d14cc1c08b75ed5600a28127cf,33,33,1,231,33,0,05040,1
16f74e9590b10ab73b6b8a0ee2c96fc7,34,34,1,238,34,0,04020,1
c1f6334287f766beb9b63e1ca90b2e3b,64,45,1,448,64,0,09010,2
f3a095635cb60b4c2a2756a42049bec5,164,103,2,574,164,0,08230,3
59a2d03ab7a24566a6d02d36ab660dc6,39,39,1,273,39,0,12501,1
4eb4eaf6f57bef05669577772ae7a26e,18,18,1,126,18,0,08010,1
e65f3dec87ebc594f93bb7b3b3914888,144,85,4,252,144,0,04020,3
32f2517138d030339cf88bdf27766e6b,239,132,5,334.59999999999997,239,0,01026,4
bb99f1d7ed62cde20c533ba1c8f716ce,25,25,1,175,25,0,01027,1
72b7fccd7bece4cfc75a23e85424ed58,31,31,1,217,31,0,09070,1
741943651516df2971c0ec59cd2dbe91,38,38,2,133,38,0,13830,1
f76e48484e72d5452d1726dfc9059d87,147,105,3,343,147,0,04032,3
a232e1a1336e035a971f5edc1ab9fa23,12,12,1,84,12,0,05030,1
4bb0f4a290dbc26df36de5cf15b61ca6,10,10,1,70,10,0,04020,1
a24ecca7573443c0e2d3d242b46630fc,91,66,3,212.33333333333334,91,0,10200,3
5ed690a31fcfcdc6fa33354a0a79119e,25,25,1,175,25,0,01012,1
afabb3ce1befd5e1e5359a60fe52ee72,20,20,1,140,0,20,01027,1
206a263f364e74d14ba823c83e041b36,42,42,1,294,42,0,01201,1
454b63b8795f649df3068e88d056ade0,258,120,5,361.2,240,18,01085,4
46b160c6012886fbe7d8d66816a1b7e4,247,99,4,432.25,99,148,06100,4
2fabbaf256cbe62a6f3f857c345f9424,44,44,1,308,44,0,10200,1
045f95be08be3bfe91eca066953696f3,65,55,2,227.5,65,0,10220,2
bb91d1e4c5d99f7a923af9591221d417,15,13,2,52.5,15,0,04060,1
505defd754efb4ee32f370e3309f4cbd,119,92,5,166.6,101,18,05100,3
6fb0c9cf11ba0b192fab88b6f94ca4f1,93,57,4,162.75,41,52,11040,3
d3e2bceba3c565d96bf06d0e78d69901,91,74,2,318.5,26,65,12500,3
e95c8b010c6301f6fc675571bad480f4,7,5,2,24.5,7,0,05180,1
b7f1849d56d77c1f3fca199cf036b10b,15,15,1,105,15,0,08230,1
a4b7dd019ac4a33901af3b2a1024816f,135,64,3,315,135,0,01026,3
854e92598f5e3a870f1b3bc8a6423d09,27,27,1,189,27,0,05100,1
5cd38e18426c4b13d225823e78bc5f73,214,106,3,499.33333333333337,214,0,11040,4
f999b6c47c9d3b314ec182cfa92ee8de,70,55,2,245,70,0,05100,2
b0b99e82cc33f0e084f1c76b7cec69a3,47,17,2,164.5,15,32,05030,1
e956c798b681e02b5b7d2482652eea87,23,23,1,161,0,23,13490,1
98b2c2b9379071d6b7b0ae9ffbed467f,53,38,1,371,0,53,08031,1
01a60d17b9ddef63ee7e3d432daf3f9c,35,35,1,245,35,0,01026,1
1af0f057392ed2c92c3ddeed0f11d4bc,12,12,1,84,12,0,09111,1
2381ff544b1962304dba0d630cae22d3,32,32,1,224,32,0,01012,1
ec8b81e67c899128a9e346b4ed2f92ac,18,18,1,126,0,18,11040,1
4dade66d072a9c8d7c4cdeb0b90daf8f,10,10,1,70,0,10,05040,1
580a0fcb6ef94af481221ecf9705f256,209,108,4,365.75,209,0,10200,4
2db23db8273ef73584074c521d450d71,71,54,3,165.66666666666669,34,37,01026,2
a416465a0bb67e7c380e901228066ed2,49,47,2,171.5,20,29,04060,1
a0420fdc02fdf5becda5123b1ca9b9b4,54,54,1,378,54,0,08010,1
1fad99d6e609b9806715b653509de754,63,51,2,220.5,63,0,09130,2
d0211fc994360fcef7a0e3748aaf6450,18,18,1,126,18,0,01027,1
c84606540e0b6c1b08680fa0738049ec,180,136,3,420,180,0,01026,4
21d9246a5e59511f6605eecd5d418ace,6,6,1,42,6,0,05040,1
d4217e4601dfd142f6ac03c41b15a323,60,48,2,210,60,0,05100,1
de3a02b9aa5683a392c11b2b15f89474,18,18,1,126,18,0,13930,1
c112b6de6cc8fa9652bbfb415a5caf65,62,54,3,144.66666666666669,62,0,05030,2
4110155cc3d9a71862d3b0ba7e4fd899,47,47,1,329,47,0,01012,1
34bc86d33f09cda4805206fec7bbe907,67,50,2,234.5,67,0,10080,2
5606128dcb935e646873a0bdcf3f2837,97,57,2,339.5,97,0,01026,3
f69bc06f0fd25e9ffdc1912924626de2,29,29,1,203,29,0,01027,1
4addba2838e6ca0448b5842194e6925c,132,97,2,462,132,0,01026,3
1260dcce68089fd193a32f767289d052,98,38,4,171.5,98,0,10240,3
d6957c6f73ac33b5a87fabf76c81ca2d,28,12,3,65.33333333333334,18,10,05030,1
084a6550beebe18bb7bdae81b75d916f,21,21,1,147,21,0,09090,1
fdc7b8fab179b9bc7a6276b69518df81,23,23,1,161,23,0,05040,1
c1f8a9077b2ad28d9bb48613cd694015,104,77,2,364,104,0,10240,3
d3b9db698a329fd99b649ec9e591f05b,78,42,3,182,78,0,11100,2
6827be8548790be3494bf34b33584b4a,56,48,2,196,56,0,05040,1
b71eb71948947eb035ad00a903fb7e3e,88,72,2,308,28,60,09130,3
152088984bd7c4af1c1ef30698bbd104,51,38,2,178.5,51,0,09090,1
90310aa7ecefb9e12e0c2c045a1e3d55,72,49,2,252,72,0,01201,2
e3ac8e1b70104ded0cfb4c07c5313ed2,40,40,1,280,40,0,05040,1
274d9f8dfa4efd4ddf755168596798d1,171,99,2,598.5,171,0,01013,3
466a1a1681a7893b9137af49026c2d36,157,102,4,274.75,128,29,10200,3
a251d8b6b2e0c1963772ad33906eebe9,44,44,1,308,44,0,05040,1
e5a29648ce43ea70ff08be3b1ee69dcf,56,33,2,196,56,0,09111,1
c0cf725aaa6f424ba4e07a302dd141dd,28,28,1,196,28,0,05030,1
b1f015a44627b696be8d11a658527a01,116,74,2,406,74,42,05040,3
d2bfa9739c5584bcaedb6de724106950,42,36,2,147,42,0,01026,1
7b0dc2ea72a8e6bec89bf8fee3e663d7,76,74,2,266,48,28,01026,2
f9a65b15cee06ec0eea4d9956597be45,226,85,3,527.3333333333334,153,73,05040,4
7c3f56cc62f294990d87f54f318447f6,19,19,1,133,19,0,08051,1
ff9be7a6f7a315ce0759904e9e7eaacc,190,83,3,443.33333333333337,190,0,01027,3
c689149fb9e5c9ccb66efa01d2bd01b7,140,93,3,326.6666666666667,140,0,01026,3
8450627aed7d265902096791d149ca21,370,131,3,863.3333333333334,267,103,01013,4
b8f42c9c9cd347ddc58b7181e3cad29b,101,66,2,353.5,101,0,10200,3
87ce403beb239e6240ea08b61bee88fe,18,12,1,126,0,18,11180,1
857c26fc94d2cda19122005990701902,12,12,1,84,12,0,08032,1
b0a83148add3acd482a8327523403767,65,65,1,455,65,0,05040,2
b1e46fee91a47cb62ca05c4ad858df39,88,73,1,616,88,0,09170,3
31d3991bf326b1a14fd23eff5429033e,145,39,3,338.33333333333337,95,50,13820,3
f935a0820bee8b2331cf18b181f334bc,82,66,2,287,82,0,01026,2
48796451d7c67d112c5efa4ab487196c,4,4,1,28,4,0,10200,1
1f81879d6ddc1ae1fecd108521d31f4d,35,35,1,245,35,0,01013,1
0cf8796dba2f6597160cf2430fe77d33,175,96,4,306.25,153,22,01012,3
5cb17dcd570b5f9985c12954daa5957a,131,80,2,458.5,131,0,03070,3
4b99762825092b6c2bbe2b10d6a33a4b,97,82,2,339.5,97,0,05040,3
f766d365a75d4675cc4c1092831af934,205,93,3,478.33333333333337,138,67,01027,4
e8ab559ba2b0ecca98ddd115dbf14c96,25,25,3,58.333333333333336,6,19,03090,1
66f7267968480263373e5bac11b3759a,243,118,3,567,89,154,01027,4
40f5c7f247846df68be5fc250bf1abf0,23,23,1,161,23,0,09110,1
419d785117e98e4c3668acbd6d087b1e,380,115,6,443.33333333333337,334,46,01085,4
e9c401fd015546eb7d98949e6985866c,23,16,2,80.5,23,0,03090,1
ff3f02455f6ef9dece9543293aae6641,20,20,1,140,0,20,01027,1
cff5412b88e18c77920a48877c3901d4,50,50,1,350,50,0,05100,1
66ab0edba42c8717c1ed1403a6e4d036,83,68,2,290.5,83,0,01012,2
259e3ebb408b9496e3b7747d80af388b,47,42,1,329,47,0,05030,1
afc9ad94fe4f5c2ce92183a64b61a003,21,21,2,73.5,13,8,01012,1
d6694f48de6cd9a844e4a3a8c44c9244,46,31,3,107.33333333333334,46,0,01013,1
e0b15538afabbab43d2be4dc67517960,23,18,2,80.5,23,0,10101,1
d5ac123b723b6e905149e52ec785c8a6,37,32,2,129.5,37,0,12650,1
119f1600e4a3e65556237ec5f919b8c7,16,14,2,56,6,10,11080,1
ec497187f4f148a1a3ad1f022e65307d,64,64,1,448,64,0,10200,2
9d3d8f936726adf1681fe956767eba24,40,40,1,280,40,0,01013,1
2c504a2b4a79d6118f63b00dff893c86,84,47,2,294,84,0,11040,2
f934d0bf7f8a35ba0233a2108e791ee3,40,40,1,280,40,0,01012,1
d0fb51e0de4fd5e6a0528310a2444d6c,160,117,2,560,43,117,03070,3
35666e3b6cc0152d9026d0379e1c9728,43,20,2,150.5,43,0,12710,1
e001c7c24b52b6ca6212effea33402c4,61,61,1,427,61,0,11100,2
6d0e2340a005ce91dc970331e6b1514a,108,71,4,189,108,0,03070,3
cc762156a7de9d45fea353e109feab21,22,22,1,154,22,0,03090,1
ee982be1748166d93fcd25185758be03,18,15,2,63,13,5,11080,1
20dd89a850348c317bca23ff25f9b10b,41,41,1,287,41,0,03050,1
d70ac9ce999ea69de710e59c3b0ff1b1,124,71,4,217,88,36,05040,3
6b96011b5c896bde295484cdf60e5871,358,136,3,835.3333333333334,358,0,01085,4
511cf0b0c3817babc29967fbf076933d,76,54,2,266,76,0,08230,2
dae046581cc3385fcfc4617bff58629c,40,40,1,280,0,40,05030,1
d1b574f0bfb588fc8375a129d9f34652,43,36,2,150.5,22,21,12670,1
9365e85675ec4bb27b3866c28460f9a1,1,1,1,7,1,0,05030,1
e144f27b4f0736b9770652e7b16ed130,29,29,1,203,29,0,01026,1
f0179bee18d8f5fc0839393cee6772d2,19,19,1,133,19,0,02620,1
5023aa8b2d618ebce3c36a18b3079f57,35,29,2,122.5,35,0,11040,1
f8f9fa4184bb436153721647371428ba,12,12,1,84,0,12,10240,1
7b5f938d02850bb8b13fa8a0d92e094a,149,115,2,521.5,149,0,05040,3
ab068e0982325ad35cf7a6c89336dcb9,29,29,1,203,29,0,09030,1
26d438a449ce401feb6492951c1a10e9,132,78,3,308,132,0,05040,3
2adea4b63cc13036f8d0400a3f75afe2,130,96,2,455,130,0,05040,3
406cd9b86d3131a9bd3f13ba7b964e85,20,20,1,140,20,0,01012,1
33d132d7b53bcd05d4b6b510c62ae69d,330,158,4,577.5,330,0,01027,4
2bba909f8fbd908250fff6bc83e79bbe,15,15,1,105,15,0,01012,1
0d8248ff571e1a689bdf6bf33a86816d,197,109,3,459.6666666666667,197,0,05100,4
fbfcdc96b8ae854aa73663e4c3556121,77,63,2,269.5,77,0,03033,2
09cbf4c69a66735b99bc893f209ad832,82,35,3,191.33333333333334,82,0,05040,2
fce53ec94e0f242055a9539d44d45a7b,155,106,4,271.25,73,82,01026,3
e793e31e91276069dcf32cddcd12f4bd,218,76,3,508.6666666666667,218,0,10200,4
8c0b958350fe5aeef46f12039fd0a4b1,25,23,2,87.5,25,0,09090,1
9dccf5c67d87790ff0e3fe8d38a0eac4,164,101,4,287,164,0,11080,3
eae34108984abde5e5a9c1164408241a,10,10,1,70,10,0,12410,1
825f031fc0142477c7355f1761489c86,46,31,2,161,46,0,05100,1
82429d62ffaa9621109ad9b1bec36d64,66,56,2,231,41,25,09130,2
6f88f3c14d177b06f2c399c16d7f1577,129,85,3,301,82,47,04020,3
cf7571e8a9ad4fb2e677577aa009def3,18,18,1,126,18,0,10028,1
079476a1374108b2f49f028a6d033aea,11,11,1,77,11,0,10220,1
8227167f79d0934622f0f04070394b45,28,28,1,196,28,0,05100,1
3d32e5e673e2b1b5504ceeac7f3c4e77,83,63,2,290.5,41,42,05040,2
6d980a75e23e10f43876fb38041904c6,195,87,3,455,163,32,10200,3
93cce116a236f49bffd51f51aba502b0,436,135,5,610.4,388,48,01027,4
dbb741807c6bb685aa9b48e5a9f0d150,433,169,5,606.1999999999999,241,192,10028,4
6cd5c254cb57b41a094b9a69832dc18c,323,138,4,565.25,323,0,05040,4
48120e9107b375b3184f6f66f4040284,191,85,3,445.6666666666667,139,52,05040,3
faa8dcc613759ae47055eeaab61df1ca,273,133,3,637,273,0,01012,4
ba48e65dfe7cef7024bda7249825a105,9,6,2,31.5,5,4,01012,1
059886aa8c50458e71cdb6669a17fb59,40,40,1,280,40,0,01012,1
67d01ce9103db9f421ea751d3cf238f5,47,47,1,329,47,0,12500,1
f257bdffe7f667593e9dbd3c3ff02205,54,27,2,189,54,0,01026,1
77e520b709d70fea431674b8aa02af12,212,96,2,742,1,211,05040,4
8282f848984aac9a9005f666c0bdc80e,67,67,1,469,0,67,10200,2
6143ec20293fcc001f74f0eae4c80c00,1,1,1,7,0,1,08315,1
7e9dad2289f5b05df871fac1bf42a4a6,102,64,2,357,102,0,05040,3
4384c007aae7b3438895f79aca5447fc,16,16,1,112,0,16,09170,1
fee4954c9296d0eaf6eb830309831bea,39,39,1,273,0,39,01026,1
a147b711e8b3eeefdec2f3300f33c4e2,30,30,1,210,30,0,05040,1
3c6406ebb4ed2d953ae67e4f89fa8aa9,86,65,3,200.66666666666669,86,0,05100,3
c2c2c3ba8c628f05d4172183faf89262,81,81,1,567,81,0,01026,3
00b3e87c014db217475535de8f76a3b7,194,115,2,679,194,0,03090,4
d0acae7b2f494f649d65b3665b4b9017,86,45,3,200.66666666666669,86,0,08100,2
7f15ff31a0002100996e6446464bfe58,31,27,2,108.5,31,0,05030,1
7f440185197530301a6e9ebb30994e26,9,9,2,31.5,5,4,03033,1
622d8e6ba12b50331053d81175d1a388,40,36,1,280,40,0,01012,1
f10cc0f97648cd74b45a958207ac3a19,167,110,3,389.6666666666667,167,0,01012,3
439d85388fa5623e16e59b357817927a,47,36,2,164.5,47,0,05041,1
7f0046603babe9fe391c05f901631567,26,26,1,182,26,0,03050,1
af6e3e6145551a62fa6134fdbf2b608a,249,78,1,1743,0,249,01012,4
1442b3bb8a58fee52b5d4bf44aaa6658,166,102,4,290.5,166,0,10200,3
b42f42fee4761795dc63dbafed483eff,156,99,5,218.4,121,35,05040,3
3a5d8c93a9e60095ad2e74efa1582cf0,29,29,1,203,29,0,08032,1
5c667fbe8a22e232f9f259fdfec19a23,2,2,1,14,2,0,13877,1
f10647e0ccff24f83f181a65925d464b,108,89,3,252,108,0,09010,3
f07759df217448160c2e63b8c787ce52,137,75,3,319.6666666666667,137,0,05040,3
08a91a744c122f797bbd0b81ac2bfb54,128,104,3,298.6666666666667,95,33,01013,3
317b10f443fddca6303952d727642bed,103,90,2,360.5,103,0,02620,3
82a79e7696cc3056ad34ca1409bbc23b,33,32,2,115.5,1,32,09030,1
a037be7c373a60fc1dea2f15786b9529,207,137,4,362.25,207,0,05041,4
5d0285ae1e05c23b2c575afbdeb4a9f5,107,76,3,249.66666666666669,85,22,05100,3
28685ec1582e5c4bcbf3b4e938383763,40,40,1,280,40,0,12501,1
c1f4016d3ddab960640064b8691b8a3a,47,23,5,65.8,37,10,05030,2
e5f425f56709b426acfd61b4de239a22,11,11,1,77,0,11,12710,1
b2e8f28d58ec72ac3881d91af3cae205,113,54,4,197.75,72,41,01026,3
6641ed3db9bffd5f0f01bc29de3e4687,29,29,1,203,29,0,01026,1
15b1c742928cf1778dc40c1ac6ab7b09,30,30,1,210,30,0,05040,1
ac866ac759268918b13b2af0a5373bf5,44,44,1,308,44,0,09030,1
08be0ac87288acaff71207e87878b143,111,95,2,388.5,54,57,05100,3
a5ecf26d7319c70ba1749ee9f1710ca2,18,18,1,126,18,0,10110,1
ce53bafbe7ac92ba99cbd5d9a733675c,24,24,1,168,24,0,01026,1
09c8d9cab6f7f2de23e0934c66b17153,43,34,2,150.5,27,16,09090,1
02236575bc8225955cb1ff2f7e3d4b4c,214,107,5,299.59999999999997,186,28,05100,4
0b69eadcf6a5fcf060bfb1ba46b8186c,8,8,1,56,0,8,05030,1
f69a00b902a3264cfac58edf631bf177,119,85,2,416.5,119,0,01012,3
eeaa86c3c36ededab37a1dbf33877b56,349,122,2,1221.5,319,30,01085,4
cb5dbdff865af9db9d3af30331a60079,43,41,2,150.5,2,41,01085,1
fd0508075dad6b226556cfaf5073befd,128,62,5,179.2,115,13,12650,3
4e0ca742afd72fbad381fff69082e9e4,64,20,4,112,64,0,01012,2
4fd45e31035ac0d4f253e80f09712b0d,47,47,1,329,47,0,01027,1
2871a89202bb33cffb2755bbf519792a,155,103,2,542.5,155,0,04020,3
ae440caa66887bb793eb752fbddee148,16,16,1,112,16,0,05030,1
9182c688733ea45043801dc467cf1696,30,26,2,105,17,13,05041,1
ac91666b771fd1726a223c179dda9dd4,259,123,3,604.3333333333334,259,0,04201,4
026f9dd665dfb3a14c0bb1d061861c02,59,44,2,206.5,59,0,01026,1
bf1349ce049918103052780d1cbf833e,24,21,3,56,14,10,12470,1
9f29373dd69f95404a72696cbf11c27b,162,102,1,1134,0,162,03070,4
253d64b1d2908a1ffccd397e1d0a7710,83,70,1,581,83,0,05040,3
8ef37be97cab12e2c3231bd3a1de2959,22,22,1,154,22,0,01014,1
6d911b7eaf7fae686bdf3dae6c858e5e,51,42,1,357,51,0,05041,1
24a53a5cd71c20f198abcc5181167d9f,208,93,4,364,208,0,01012,4
ae9f32c2cb4e6dc907378bf862735141,23,15,2,80.5,12,11,11040,1
5eba7754952563eb43999178f80efff6,28,27,2,98,28,0,13953,1
13bf0f2fe6fd2c7cfd66e28161c0615e,10,10,1,70,10,0,01013,1
2c2f7d064fd940e69bf12dbc02be4d0e,163,87,3,380.33333333333337,89,74,04020,3
2a0b1579553772a7a6e8718e97d04d37,44,44,1,308,44,0,05040,1
ad1fccb10d6f9bc38663bf943a0be7a8,78,56,2,273,78,0,05040,2
db57c60eb0e66dcfcc1b7da76541f170,120,91,3,280,85,35,11080,3
9b03b8e7a93dfcede0f4d2cb1a4d2f8f,62,55,2,217,62,0,05030,2
f7aaf505a1ee175ff063ae4f7ea51274,382,86,2,1337,64,318,01012,4
45354a2f22d2664615b91b7b4d894be3,75,52,3,175,75,0,05040,2
17a4e38090534afbb2d72218d2e4e7b0,46,40,2,161,46,0,13830,1
610d5a80bc22b27089ad99c8d44ac754,4,2,2,14,4,0,11040,1
8fd3ffa1e016267a3a596dc0fb973f42,24,24,1,168,24,0,04201,1
8dc6ba20edf843fc30d7fe2eaa8ecd0c,82,45,3,191.33333333333334,56,26,05040,2
cc6d14cf1cf27c4ef13c5dbe6a76d504,61,48,3,142.33333333333334,61,0,01085,2
b588a96cb74deaa52f8355b31be155bb,139,100,4,243.25,113,26,02650,3
4c12d1e8122f47805bb54921405c5b6c,37,27,2,129.5,37,0,11040,1
124f7ea9156e28412e63832d62f8c485,31,31,1,217,31,0,08314,1
8fbbe54548bf6e5232d47dc65ff7b222,87,57,3,203,41,46,10200,3
12f85598aaff9f3c9a5925ec56577d29,5,5,1,35,5,0,11040,1
e35ac1f7fe2b302819dd89b00416dd87,191,95,3,445.6666666666667,158,33,05030,3
ad8da802a9d79e47da1474ce2f87fc0d,207,160,1,1449,207,0,10200,4
86c020b2705a9533d58deba746170659,1,1,1,7,1,0,13530,1
1904f4194f24cd7eb807db4b0b51e3e8,38,38,1,266,38,0,01026,1
36ffe57aa60ce38efe6860d0fa91fba4,23,23,1,161,23,0,05040,1
dfcccd33393a3766043a9ecc65d27dd2,283,81,5,396.2,283,0,05100,4
8fe6e74501c510537585480d08f595b6,15,15,1,105,15,0,11080,1
c228bec54dee571e417c37adf7bf7cee,190,134,2,665,190,0,05040,4
262b1f317d22b7b2e40fbd418f06ca76,11,11,1,77,11,0,01026,1
2fe5cbc871bbcbbaf16aa318b0950922,20,19,2,70,20,0,01012,1
8fe6e3ed19c6dd868a3e260b0a291123,51,37,2,178.5,51,0,05040,1
62b9ed02e77617e8b26ffda9934ae123,43,38,2,150.5,43,0,09071,1
e83c61ba9d1ba88097a01922f8f909fc,53,39,2,185.5,53,0,01085,1
000420e88d1d6032d2a9957576177fee,29,29,1,203,0,29,08010,1
11426f88920a9a1ac294037b4215e377,55,47,2,192.5,55,0,05040,1
514c82227442fbc610a0d4110144c0d6,24,24,1,168,0,24,03050,1
334f4407c8834d2e605921052d29fea7,15,12,2,52.5,5,10,11080,1
759e4ab00739c7e7ff42253542b50cb8,82,62,3,191.33333333333334,82,0,02750,3
d0cd6add8f352f3316bc938bcadaa459,131,71,5,183.4,84,47,04020,3
789777222c1ec628474152db5c70713c,24,24,1,168,24,0,01026,1
1506801764b56c0382ef24c3be088277,95,83,2,332.5,1,94,05040,3
390adc7ba2d3a9e840fc2357d0ee65e6,34,34,1,238,34,0,01085,1
2ed4a572e803bd504f40f362528bf445,42,42,1,294,42,0,09130,1
b17b5d2fd0b5ea92b200e7314a97abed,65,54,2,227.5,65,0,02691,2
2b47dfadfab04c9c8588ae2fdf6902a0,49,49,1,343,49,0,09030,1
cee0bf1fb20f6e6ffe42992dfc8f762f,25,25,1,175,25,0,01013,1
56ab2ab4b93f626497b527be7cfef079,279,130,5,390.59999999999997,197,82,11100,4
e3bfbe86026bc87b0e65cd83cb286a7c,54,54,1,378,0,54,05040,2
a2bcc8b8f3342af26e3efbe7ac069f24,54,54,1,378,0,54,05040,2
60945553b497ed9af1b460ef18b71b49,67,67,1,469,67,0,05100,2
669322fd1bb62eb7f23dec0b87d1c938,36,29,2,126,36,0,05041,1
3e2199820343e5cce8f880c8b2a14605,129,88,3,301,98,31,01012,3
4966055fc6a5d5a097544315b4d5f416,64,52,1,448,64,0,09130,2
c2c964bb117282e34117fc23481f6545,64,46,2,224,64,0,05200,2
8a7005084d2ddeececd48e8a6e597266,108,75,3,252,108,0,04032,3
61fe6680486c202ae0d847e3873d97d8,22,22,1,154,22,0,04200,1
6c1da92cc32e87642f67bc6b3b138ea3,45,44,2,157.5,45,0,08230,1
6c0d5148ebd5c32b7c73a05fae8ee857,57,57,1,399,57,0,05040,2
b9b099ae4cdb71bbb46efbf2202bab37,401,92,3,935.6666666666667,370,31,05041,4
f5679ac34e6bc825e86079a3c2da0671,51,43,2,178.5,51,0,13930,1
6679def34e0c903715dd37efe2edbf2a,81,56,4,141.75,81,0,05200,3
bc599757da3ff54a6ab6a86256e4ce97,214,118,3,499.33333333333337,214,0,05040,4
161075831906a59d08e0b3b62c523783,160,73,3,373.33333333333337,126,34,05041,3
6a971c10a8d47cafd089de3cfa70e0f7,149,119,2,521.5,149,0,03090,3
baf825572ee41392d428f21ec5f41b24,16,16,1,112,16,0,11100,1
c2bd75e097620bacd8926776e19e5082,183,107,3,427,183,0,10200,3
2b419b0957c1d91fb179bc8d6450410a,8,8,1,56,8,0,05030,1
2fcc9ab647411f5367eb836fda44b040,84,71,1,588,84,0,05040,3
656eab06e9819a8a57c6b50a11d30010,22,22,1,154,22,0,11040,1
7d726ec45072ed0ff94e4bf9f84e686f,11,11,1,77,11,0,09110,1
ef1e173f236f01a462641ac6e110ae77,130,97,2,455,130,0,09130,3
9864c7bc88f7c387bb8dd77112a8b9a1,59,52,2,206.5,59,0,01012,1
2e5fb21ac7abbf0dde40a7b04bd19e9c,21,21,1,147,21,0,05030,1
9f51746ad79823bbce9f37251920f9f4,166,107,3,387.33333333333337,95,71,01085,3
c2e871496a5595a1fbee6d198ad00c30,55,55,2,192.5,55,0,05040,1
345a159781d375ef921216e06fbcb7c5,96,79,4,168,50,46,11100,3
1644c36e6a90afe570c8c4ae989f3351,207,84,2,724.5,28,179,08010,4
87f62f46bedde7fa353ec24ae0815c55,152,102,3,354.6666666666667,102,50,09030,3
b86a0a44bcf331dcc67e046538bc2e32,162,54,6,189,154,8,05040,3
326c682d72de9204aeb777699e8b3fd3,58,55,2,203,58,0,09150,2
06a0e62ef9364aa442f4729a6cfed11f,37,37,1,259,37,0,05040,1
af9032d21c8d3ed3906f68794e264e87,36,36,1,252,36,0,05040,1
c83c7e75e6d1fa535155e6cd0c1ebfbb,31,31,1,217,31,0,12570,1
440351b57aeea2a79233a3622b1ebf16,35,30,3,81.66666666666667,26,9,03070,1
a86ef6c0850bc73b1131dc6ca032e84a,1,1,1,7,1,0,11140,1
d0c43fe92a0c8ad571976e193e1a7a12,117,101,2,409.5,117,0,05100,3
27bd4cad35f723533f3a349a9a612356,108,73,2,378,108,0,01012,3
c4bab2ec06c9264eb46aecf48f457ad5,253,140,3,590.3333333333334,253,0,04020,4
ed5072c455eb857dce8b8a053f5719a5,128,81,3,298.6666666666667,128,0,05040,3
539ba56747fed7f65c4c0fdf7094b10b,73,68,1,511,73,0,11100,2
3351ca18d2fe5969dd5d73ea467ff49b,37,37,1,259,37,0,08230,1
9eaa85b16764509312bd47cba8c7c575,127,78,3,296.33333333333337,93,34,05040,3
1b4f57ef49e883517072b1cf619c5636,23,23,1,161,23,0,08032,1
1a065a8c1f2dcc09ee728f12e92001c2,21,21,1,147,21,0,08230,1
4f77db7368c1e2125e9092805b8d82df,97,78,3,226.33333333333334,41,56,04060,3
bca5ac9f88d32f5f1cda15e4dac28795,80,48,3,186.66666666666669,80,0,01013,2
e63bad099c27a936fc14760ac18027fb,123,69,3,287,57,66,11080,3
27e51480fee664659f43bf58f8e21db5,35,35,1,245,35,0,04060,1
4cb9f66b86e8fa43ac89fb13a78af098,10,10,1,70,10,0,04032,1
1bfb0d66de60625225bd98166ce65cbf,18,18,1,126,18,0,09030,1
2cb5f4caf0e10391e37be086e9f174ed,98,69,1,686,98,0,11140,3
01e9dec935b9cd32d494c14a682cf72c,26,17,2,91,15,11,05030,1
3e8eeadf3cef4d06d88cbeb8cb4adbc4,170,105,1,1190,0,170,05030,4
2cb9dbe44d11ba2dd5632bebd89b4f66,11,11,1,77,0,11,05030,1
b6e7cc364d8e30f61aaf1232ca1f232b,20,20,1,140,0,20,05030,1
156d620cc9e0db11a5c56fc7ab0bc35a,54,26,2,189,54,0,12500,1
301b1e18bc8c159aec435124cc7a38fb,42,19,3,98,27,15,04130,1
da5e198ea864e286745d989912c1f886,125,96,1,875,125,0,01027,3
cc86f730c36f04d289d8b07be7a25a10,55,54,2,192.5,1,54,05040,2
51afaecf9100bc144f8bbd2fd7e75d17,17,17,1,119,17,0,06100,1
d0d5d86fb7f9008bb9bb66fbe0b72444,20,11,2,70,20,0,08090,1
6180b17275448661a9c497d09dd203a5,32,32,1,224,32,0,01016,1
0656dfc1eb5c5c83f0db796c130593d0,246,140,4,430.5,246,0,05040,4
fd8b064adc17c10c05095361ff9a3181,21,20,1,147,21,0,10152,1
f439bc6213c82820423e95c98f9124d8,84,63,1,588,84,0,01013,3
be446e605417b0e9d1e3f08425d618ba,41,41,1,287,41,0,09130,1
8a87a1436d1e2f6309fba833aa530825,20,20,1,140,20,0,01012,1
7aa0e59ed284a95c85ac569080d58714,28,28,1,196,28,0,01026,1
fbfc64ef3188318f325ce24e1ab63055,94,58,2,329,94,0,12570,3
de16cb46bc500fd0a522d413ec87c602,252,97,4,441,225,27,01026,4
8395bf7fc00a08a820e071ab9ecff23d,58,50,1,406,58,0,01013,1
30266166872e139b7afd994daec2337d,51,32,4,89.25,35,16,11080,2
a160fd15c5e6bcfb524aff6ef77fe942,137,89,3,319.6666666666667,137,0,08312,3
2bfa0a644d44a192c9ba2f23dc3fa254,155,108,2,542.5,47,108,05040,3
27bd564c0ec241432befcd1cd2cf5c28,33,33,1,231,33,0,05100,1
dcb111163e0dcbdaee5656b9003ea82c,32,30,2,112,32,0,10200,1
e4b7a1362b134154b8e272507a3a6cca,102,70,3,238,102,0,10200,3
25f06058563b183bf45d4f08014df936,210,130,4,367.5,210,0,05040,4
7485f88d71ff99a90f924e572da6cbf9,93,67,1,651,93,0,10200,3
b87c8d5d1f8a8a6fe69fa9e630bf8882,25,22,2,87.5,25,0,05030,1
73b2497bf58f9e5be628c1507011e188,33,16,3,77,19,14,05030,1
a797a0f5694f30db88004af73876ec40,102,73,3,238,60,42,08100,3
a5dff36b9c493500cbb1c94ec972b44b,16,16,1,112,16,0,09130,1
2978fe0eb0b07405787ce53b6e4ade2d,92,25,4,161,92,0,01026,2
d3eaca6791b36407d919774305512e14,25,25,1,175,25,0,05040,1
2a5b735400a9d7e69a34329a2d0d5df0,129,60,4,225.75,129,0,05030,3
3c9c7cd7a411c231a748ddd2002f43a1,129,74,3,301,68,61,08031,3
f1faa3bb8e901053c769130cee3b63b4,10,10,1,70,10,0,01012,1
57abf0765161404ab053ee0c0fc74c12,129,72,5,180.6,107,22,10153,3
47965f7ccb60ff1c7ea4efae74139fd8,74,70,2,259,74,0,01013,2
3c1d9af45a1b38ecf15ce131bc8dd220,115,58,4,201.25,86,29,05040,3
529969ac8454a05bdc8cad01128fae7f,192,139,4,336,150,42,13820,4
d588ba064c0cfed13811ad7055dcd703,27,27,1,189,27,0,04130,1
2ff41a5f72c3d613ba96bbf623527249,62,44,1,434,62,0,09090,1
495d31e0eef4709337aeea74287c7a20,37,19,3,86.33333333333334,26,11,08100,1
072e1fab4a5c3b224a20303715326afe,19,19,1,133,19,0,04020,1
01426e3fbf6f4d20c8c4b255fc695b14,42,31,3,98,42,0,05040,1
2b8577a3d2f079db2097ccee70e58441,11,11,1,77,11,0,03070,1
d1bdc1f00c74d17caa9580589c0f5a65,70,61,2,245,70,0,01012,2
5a29920ce4673e3ce6e4b8219e64fafd,32,32,1,224,32,0,01026,1
d73ccdae80c4597c4bbe45057263547b,88,66,2,308,88,0,04201,3
c40b488d9f8920a4fbc8c47fbd2d4685,830,225,6,968.3333333333334,752,78,05040,4
2f42e70c5311c7c5aca90aef11a644b8,62,40,2,217,62,0,10153,1
510ddbe03c42d7da2058c1a0314bdecb,46,38,2,161,46,0,05040,1
7f745bb164fbc572127bff7d4fd06e9b,73,70,2,255.5,73,0,05040,2
5cb4a9666f7e261d9961522ef59d8cd7,15,15,1,105,0,15,01012,1
a91e8315ee0ee0266323666a177e1f89,40,40,1,280,40,0,12590,1
dfd5cc2a17ebf16a2fda80d90ddc7191,109,86,4,190.75,96,13,05030,3
2b10969b1fd6cc64d9483eb2429a0a39,210,93,4,367.5,186,24,01026,4
3a20933b9febfa83537764170c157d53,46,39,2,161,29,17,05040,1
264fca8c1a331b613810728938c01075,316,137,2,1106,316,0,01027,4
de9b3599e332486220ba57779d2aa4a5,29,29,1,203,29,0,01016,1
bc80c365ae5e50cdcb281a0f49d557b1,59,59,1,413,0,59,08052,2
f30185047ea9f4b9edd79f6531488698,8,8,1,56,8,0,13490,1
085382ac9d41e3c9a5bd643ef0761068,17,17,1,119,0,17,05041,1
902e45863ef6a8f99dcfdf7c0c54b0f6,30,29,2,105,30,0,01201,1
1311dd958cd06394c1a3cfc4f6a4294c,386,184,4,675.5,386,0,04032,4
0ba529feff8b6dc93d5413335535bd25,50,50,1,350,50,0,05040,1
0973f5410111cfa9ff8cdff19f079c66,101,64,2,353.5,101,0,01012,3
e774f626b8ac4612336f789a2cb7118e,361,120,2,1263.5,107,254,01026,4
ccbcfa7f2167331a3e6e0eabb0e980d3,444,156,4,777,444,0,02650,4
70f138803326c1f4205f8b0d496391d0,227,107,5,317.8,227,0,01026,4
3b309044aae7465857d2f441c23090cd,17,17,1,119,17,0,01013,1
3f7a0f36718f2bc08521b1528fbbdf54,11,6,1,77,0,11,05030,1
288144fa1423222a4d1075f0c8cca50f,193,96,3,450.33333333333337,193,0,01012,3
cd7fa54f593685fb992ce6e36357c614,166,105,3,387.33333333333337,166,0,05040,3
aaaf0cca454eca2aeca67650117faae4,144,103,1,1008,144,0,04080,3
3635c974830ee0e9af5e71eac5257c38,24,24,1,168,24,0,04080,1
38315a9660f4eb5e416d1f0f3cccfac7,161,111,6,187.83333333333334,138,23,01027,4
400e4e618bee728d4ae2b9115aa8a257,94,71,3,219.33333333333334,68,26,05040,3
48dca3db49b0ecfc870ebe4626cee060,132,77,3,308,132,0,11100,3
747307101d3dbf7bdeb033809c78e276,17,17,1,119,17,0,02751,1
fbf1feb8b0d792ea8fd59ad14e3b0417,201,82,5,281.4,201,0,05040,4
96cb6b3811733b2d203e7bf3d8975fae,95,87,3,221.66666666666669,63,32,08230,3
a7295d7e4f109a207c27e9425a2e6a3e,65,48,2,227.5,65,0,05041,2
f766fbda56df03a617d8a17d9c334bff,32,32,1,224,32,0,10200,1
dd341d5a99f46c4a8f2158afa3859ec9,24,24,1,168,0,24,05030,1
852e4ec463326026699d447dd79b3334,26,26,2,91,26,0,04020,1
a84cfb45d624362c1c9302f231bbee2a,33,30,2,115.5,11,22,10220,1
14d51e53e4841bd3cd41568de8dd686f,32,32,1,224,32,0,05040,1
ac1b9bc46e94707be293ccfe50927015,354,108,3,826,37,317,01012,4
899661d515577592faf0e07794e1ed06,99,70,3,231,99,0,05040,3
8d658dccde06d0e809a2e9015ace630e,2,2,1,14,2,0,01012,1
a1156542ed8280f672460734835dd186,60,44,2,210,31,29,10200,1
60671ed52bc87a18fa0f5e664363b9f6,20,20,1,140,20,0,01012,1
2ade5906b1a9972e4afba8fcb6d8fb8e,168,53,4,294,168,0,05040,3
8bec3ef2a60777b8d9836952f600ab4e,62,40,2,217,62,0,01026,1
b8155d7628f1aaf6b50d856113811489,182,123,3,424.6666666666667,182,0,05040,4
29e9acc2c32755346ce74aba88134697,41,41,1,287,41,0,01201,1
b041a2c1f73e47569a86cca745045e14,4,4,1,28,4,0,09020,1
1a2ec30787194ac926773c00fd409b07,30,25,2,105,12,18,10101,1
8794f51fdf144a9a0e78c0dcf02ec9b8,45,44,2,157.5,45,0,01013,1
9daf148632812a1cfaca2fbec71f3d05,47,39,2,164.5,25,22,10220,1
21d201cacbd39690270831925967cb4a,22,22,1,154,22,0,05030,1
399bddf18739059e56066bb6f51ad41b,39,31,1,273,39,0,08090,1
c0312cb3437a5764920a6435f9273921,43,37,2,150.5,13,30,05041,1
c904dfe02cd2338a50a40a81509cc8bd,126,80,2,441,38,88,01026,3
57879edde6b8c03e11e6f41ce49f39b2,58,58,1,406,58,0,09130,2
b4afd3f81f7a784058604a7b8075b08a,28,23,2,98,17,11,09091,1
cb02bf2a3011b58b6ac05614e406e108,211,94,4,369.25,165,46,05040,4
e4501b31c3c5bfc809e29a201b719473,36,22,3,84,36,0,12670,1
a2bbb2b47f86d6513d78abc5cb34ebb0,27,27,1,189,27,0,12410,1
41f99b3fec0dfe45d2a0c29f2fafbbbb,10,10,1,70,10,0,11140,1
877f0df86b7cd07425c3914ef23eba8a,42,42,1,294,0,42,04060,1
2cdc39c70af025eb87a60cc897ba12c9,138,103,1,966,138,0,02690,3
9890012cb1727eeba14e64e33953ff3d,16,16,2,56,16,0,01085,1
7804bb9c8bccdac6ffdca954156cc5ab,18,18,1,126,18,0,09010,1
d6b8c0e6956e8834af4075683ce685d6,113,69,2,395.5,113,0,11040,3
843d32a69377e11dca237771d9665ce2,285,163,4,498.75,285,0,05040,4
f8dd45c98555fec15a786f7cbef60266,58,45,2,203,26,32,04020,1
19267eb1a62e710571ba1ce43435fe6b,21,21,1,147,21,0,11100,1
fc00390a4cc9b9a9073546eed7c4c008,21,21,1,147,21,0,01013,1
f80581594902d16c92ce408bfe9b1a76,110,82,2,385,57,53,01026,3
1c57cdb37b8a59bcf65f45f7e5184f4b,21,21,1,147,21,0,09010,1
a02b7c3d4262433c9f21738611eef8bd,196,132,2,686,196,0,05040,4
a895152b33add212cc06e7a61845a3bd,45,45,1,315,45,0,01027,1
f49b0e261fb9268997ec2dddc0f40c64,30,30,1,210,0,30,05040,1
b73871c922ea88667b3cf243d126cfae,17,17,1,119,17,0,05100,1
eb3e08067ff7bc279b19f9f5b69943ca,72,45,2,252,72,0,05040,2
0dc67bf7870fcea680257fd217ab2d42,40,40,1,280,40,0,05100,1
26336213a547eb5e05c02bbb165b99d9,16,14,2,56,16,0,13930,1
ee90ea2d9f2aad156be05de706e99f7f,3,2,1,21,3,0,11040,1
82cd20556f18be08f7aba4c72b370a21,138,90,3,322,106,32,05040,3
1f1b19a7493390e5a6f642b29a5ac05d,1,1,1,7,1,0,11040,1
7a9153620fac64b80f88e279483b56c6,114,69,3,266,114,0,05100,3
180c16f53ed1611290280fd68030b08d,24,24,1,168,24,0,05040,1
4c49bde977e4ce86e3afd2abf32f300b,76,68,2,266,32,44,05040,2
86cd3e8582d25c5c92eb55de70d3ca59,71,57,1,497,71,0,01026,2
88cb1a11e9b47df6fcc6dfe0fa899b28,29,29,1,203,29,0,10200,1
53313e1921097f0729a3fc3e4352e431,55,44,3,128.33333333333334,55,0,05040,2
ee024ce89344bdb11f98af195d5d1a9b,131,69,3,305.6666666666667,99,32,01026,3
851c8c5fa075e3278185856723766101,7,7,1,49,7,0,02751,1
7a5f68af53990c612a8c639cc2d6dbbb,83,57,2,290.5,33,50,05030,2
f3179caf28ba5a555ba0da3f1cb1ba1b,4,4,1,28,4,0,12710,1
c76d21c2d69b0e06ef65111410a39ec1,27,27,1,189,27,0,01012,1
6859191535ed7966b1be001153b33512,70,57,2,245,27,43,08451,2
2a56dbdd98c00dd6c58f795ed688f9f3,83,57,2,290.5,52,31,10040,2
dc201a3699da50d047d2bde9360cf158,55,55,1,385,55,0,10200,1
3c484faddc5b2d98e620da0bbff2ca19,424,149,6,494.6666666666667,382,42,01026,4
4e0a7241223deec8a1821b4ac7292113,15,15,1,105,15,0,09130,1
cb94e82ba793f53e94c61f63abe53eba,11,11,1,77,11,0,13820,1
a488752f1f27852c9b2be99d00fc88c8,23,23,1,161,23,0,08100,1
2ba6b3b3c54d52f424c5a9c758409979,29,29,1,203,29,0,01012,1
dca16fe6a86b0283d9f5d2428f5e6c5b,188,66,4,329,154,34,01012,3
94dcf10748b8f8023b6485e12d57e0a6,6,6,1,42,6,0,12470,1
0740ed6af826253db76782212cd5ad96,54,42,2,189,54,0,05030,1
4a7a8d40d8fd8dd6cd8699e92ce25aff,136,102,2,476,136,0,01027,3
d573aa7ee804a803e737dc2d238f92f7,57,53,2,199.5,57,0,03070,1
1c1e33207091c82fa3654487de01ba83,33,33,1,231,33,0,01026,1
b579360bcfa9178913080c3d2acf5025,71,46,1,497,0,71,05040,2
ff0440b094a05bbd12bca9c1533a0783,14,14,1,98,14,0,13620,1
67b89c99eeee1733fffced5c10a9e41e,37,37,1,259,37,0,08232,1
ccbf2b683b146ae0d8c588a8b8a1df28,246,140,2,861,246,0,01085,4
3ccaa7804e137b9f385f6bdcfdc58773,183,105,1,1281,183,0,01026,4
98700963cbe0f9465142347167f2b78f,146,93,4,255.5,146,0,10200,3
317ef8e129269d16b0c356788ff9680a,86,59,2,301,31,55,04060,2
46091a5816f9baabc71d3ac8ad7be922,29,25,2,101.5,16,13,11080,1
0b497843a2104120ea43214adb188346,257,142,5,359.8,218,39,03050,4
e79ef4d5bb1454ce4964aa2d587d931d,9,7,2,31.5,9,0,05030,1
8e0f8f4ee62951b722e2cf96cf2c1801,234,141,5,327.59999999999997,234,0,01026,4
114f717d6f4b9b5f7ba4fa9617ef4a78,15,15,1,105,0,15,03090,1
1377acb4af13856c9f85abaefab30532,37,37,1,259,37,0,11081,1
36375b30dabd6b38b27b8c8f740a2a78,30,30,1,210,30,0,08052,1
f1d97eceb05c7b9a7390122525171f92,21,21,1,147,21,0,05040,1
387545b9dc15d164ddf0ba458bd3ec8f,89,54,3,207.66666666666669,89,0,08010,3
82c2f315f1156d2b4e06251c98fc088a,132,77,3,308,44,88,11080,3
42fc00ca505b4964b73ba4a48d6fb60d,60,45,2,210,60,0,03050,1
a426e7585b8a1b39979a8067b8d905a9,27,27,1,189,27,0,01085,1
1e5aeeb0465391927a94d42dab6f4b98,27,27,1,189,27,0,01026,1
8b11a68113ddbf92addc08b0429d7598,155,78,3,361.6666666666667,155,0,05100,3
66eb0fd615a4a70e02cb4755cd9095d7,24,24,1,168,24,0,05030,1
abc6a2808d9f4315d488520a5a1a0584,128,100,1,896,128,0,08100,3
bc9b1835e0b68f874f06b70ec09236e7,127,76,3,296.33333333333337,85,42,05040,3
d472547153e4706480718007b2faf25e,108,67,2,378,108,0,05041,3
76a2f5f0c04c829b8a24461761c6d72e,27,27,1,189,0,27,04020,1
1cc0a635bbd2ddabd8b5313601bb56f7,31,31,1,217,31,0,12500,1
33f53c15c3b8fee4a32d3e0c4508f69a,156,111,3,364,114,42,05040,3
eeda40ae2d385b0d3e07aaaffd18e635,20,20,1,140,20,0,02690,1
f93652ee16e8e047334265af97443dcf,59,47,1,413,59,0,05040,1
b86106b31f7e6d9a4f8cb68093fba5eb,94,74,2,329,14,80,05040,3
2218b11ed052f42eb8396eca41dbc25d,117,82,2,409.5,37,80,01026,3
66072ad8703289d8c527eab77332ec4a,77,58,2,269.5,77,0,01012,2
4162242766998483149153b25de33a03,59,41,3,137.66666666666669,59,0,08031,2
eb45643ac604748fdca20d2769769ab2,29,29,1,203,29,0,10040,1
8ff5d9f440e523ca923d604ece649ae9,8,8,1,56,8,0,05030,1
f14b647804eb06a56b9c7451072c4b1f,49,38,2,171.5,49,0,05030,1
7a44b54d7a264f04fb3c63fefa74a6e3,236,97,4,413,236,0,05100,4
40e99e8613cbe21116905f7f700772c3,122,80,2,427,122,0,08312,3
cf79f1daae73a2b2c051fd3e659a57c1,134,108,2,469,2,132,01026,3
5690329d095096273fbd083c908c6f95,45,39,2,157.5,45,0,05040,1
66a918b7e28eb8a16ee5c24008b4b500,11,11,1,77,11,0,09021,1
85a0cfd379eb30ea4026be320e90eb7c,34,34,1,238,34,0,09130,1
84602ce0405082f9b2bbfb9d76eb69ce,27,27,1,189,0,27,01012,1
9276d5e09c24b6df1d729fee98ba96fd,123,96,3,287,69,54,05040,3
9febe026b2a2d059494e9dd260c1723d,23,23,1,161,23,0,01026,1
8199dda3a3a2cce3eb678fcbed50207c,200,141,4,350,200,0,05040,4
582e3cbaa1f4c0174294b8aef6f098f2,126,96,1,882,126,0,05040,3
b1c0e04d12c367c01eec61e47a2159c9,84,50,4,147,59,25,08133,3
37209b9d8238e61c44f6515032a21816,92,92,1,644,92,0,10220,3
c0daf474464c5c8b4a114f7b55f00a87,97,57,3,226.33333333333334,97,0,11040,3
72602539b7deaf04323f05d5b0327736,295,143,2,1032.5,64,231,01012,4
359e72309b772c0a3c0969d4825764ba,15,15,1,105,15,0,09130,1
56b5e3e9ad3ef1b81500cc045c8b95f6,193,103,2,675.5,2,191,03070,4
37a22df36bedc0d584a8a859c155521a,31,31,1,217,31,0,01012,1
e67325dc7e5f24ed7867b83fa91a99e0,99,75,3,231,64,35,01026,3
5352f828aff658033eba68a9f5f08705,35,35,2,122.5,28,7,05040,1
a6a6adaf54bf7b1a4f74deeadb1e8691,115,75,3,268.33333333333337,115,0,05160,3
f828a8022c05011df6bd64077737224d,61,61,1,427,61,0,02650,2
52fa183176710013ba26145cdaf193ee,347,135,5,485.8,303,44,05040,4
f4d55af8ef6f478ec81c93691d4414f0,30,26,2,105,14,16,05040,1
c3c808e26407756676a39e8e724bca12,2,1,2,7,1,1,13600,1
1b0e6c686ee96c211ed9b111f2bd2894,7,7,1,49,7,0,09131,1
6962f7e5e6e2f405ac4b2a967ccf0e2d,19,15,1,133,19,0,05030,1
5faceb2997b8419bf51a5398d0f7060c,4,3,2,14,4,0,11140,1
86e6cb653c461d57e9c37be5da51062c,72,72,1,504,72,0,05100,2
3e2c8f59772e616122043661837e8b4b,57,46,2,199.5,57,0,03050,1
2afbaf52bd8b7edee54a1987f585333b,12,12,1,84,12,0,11080,1
1f231330e59628c4fccbaa5a739b5f57,208,93,3,485.33333333333337,119,89,03050,4
1a20270e4dc53e147256f3221648bfa4,121,64,5,169.4,110,11,09130,3
7ea3d7489cd38de203996fdffdea9d38,167,95,3,389.6666666666667,76,91,05040,3
bc186fd38bf63fa2ccb5794bc51f8b57,3,1,2,10.5,1,2,11040,1
18967628583915fef7341e4aad966783,76,63,1,532,76,0,03090,2
ba0681e85111189a65499365f151bc12,64,21,3,149.33333333333334,52,12,05040,1
5a97ac36addd4e108e51420bd9838288,27,19,2,94.5,27,0,10152,1
b838443dcf671f0d27bf5cc5d525cf59,38,28,2,133,38,0,09091,1
cbeaaa347db2c51c164b2c78e04efc69,47,44,2,164.5,25,22,05030,1
9f1a69c4ff4d980a2115bb3f0d3eb762,35,35,1,245,35,0,01027,1
3e3eef194c740426ff7c06274043f921,52,52,1,364,52,0,04060,1
756143358ac29caf947b265846ca5007,121,56,2,423.5,44,77,05040,3
88bfec51ba81415b2f2a4b1c209d0d8c,30,26,1,210,30,0,05200,1
fc3596b9d381254a7e737a0322c9be09,52,27,2,182,45,7,05030,1
0719d8063473543905cacceed00e9a9e,85,63,2,297.5,85,0,08230,2
473b97f900ec1efe38f19df34f8f8f81,45,45,1,315,45,0,05040,1
2477c10ec56aa5b3e545052af0fde65b,122,90,2,427,122,0,09150,3
b4fabf1c29c169b47dbaa2c77c2b04e6,223,128,4,390.25,223,0,01012,4
4810d30a8b7d333c1624c6dc85561509,23,23,1,161,23,0,12590,1
9b0bff7573c345fe10604a91a5121708,34,34,1,238,0,34,09130,1
54614ed21ca36e8bac9f587dd17ab6b0,102,85,2,357,52,50,01026,3
1f1b2103b20aea4c2849edc27bdf5661,37,28,3,86.33333333333334,24,13,03050,1
7c15359229e9b7bfa7f9515d2b70f1ce,19,19,1,133,19,0,08230,1
7af00da3337b322d0dc9b37bcd2985a5,99,78,3,231,99,0,11180,3
6fd83a639ce345bd67997c31a6309bf2,123,67,4,215.25,109,14,05040,3
1e035cfcd33b4a5ba4947cfda59d6b7d,28,28,1,196,0,28,01026,1
62deafaf02aa97c58d586e80533addf6,29,29,1,203,29,0,05030,1
09b171be530462ac2b7a287bcacf3bb4,26,22,2,91,26,0,05030,1
740e6109297409d9d3fbafd7be1dcc29,31,31,1,217,31,0,12590,1
31ad3c08ca53ad45516d16eec5a7e12c,58,58,1,406,58,0,05100,2
02f07398b5bb0e64a701fcd25ef42ba5,17,17,1,119,17,0,08090,1
acbfcf58de5aae51ff867bab76cd6f8d,93,65,1,651,93,0,05040,3
1b0c8e94c4619da8e0e06e0707e52501,150,82,2,525,46,104,05100,3
2f55f3315ceb53b0be26a1d7c8c8d6ce,499,157,5,698.6,283,216,05040,4
2b325139f4f75947cab2e2734eee335e,8,6,1,56,8,0,11040,1
87568e7b9aa3df17b6f519e29bdb8bd2,15,15,1,105,15,0,11100,1
6098f4aa5bc7aa39c5922dd2737e5682,46,46,1,322,46,0,09130,1
9bd7efb532f338f0898ff2952c71ed76,24,24,1,168,24,0,11060,1
96d0cf1882ce9b74ac8d00a465d1f81b,69,51,2,241.5,69,0,05040,2
f1767ac07e8c611b7922bd0210609a53,18,18,1,126,18,0,12570,1
ff72a29e8ce5db2dbd7de59da4061cac,16,16,1,112,16,0,10028,1
ab7cdd6347c7eb466d90daaea5b136e5,185,90,3,431.6666666666667,185,0,01026,3
95deea69138b147845a2d1bf0f5e28bd,279,68,6,325.5,232,47,11040,4
409a1ffeb17ca726e90b666546bf110f,81,57,3,189,59,22,05041,2
755ff62550bb8dbe8049c7134b4bf94f,85,65,2,297.5,85,0,05040,2
1964f955b7910ad639eeef7f80f638f0,14,14,1,98,14,0,05030,1
857961a3443b5cf55ba3655fa63327ca,25,23,2,87.5,25,0,01012,1
a9977f28df9334cf4885d1518dec1c69,105,65,2,367.5,70,35,01027,3
c94993572a343bcea9eb31976a5d537b,48,44,2,168,48,0,01012,1
57a66f54ebdd4969f8ae55a7fe18d44e,12,12,1,84,0,12,05030,1
e40d5b6049cdf842015f5fdfcb4e82e4,91,46,3,212.33333333333334,91,0,12500,2
217693b7c77f335c521e9afc8dd99b8c,54,47,2,189,54,0,05100,1
d60b06c6393e5e5b27e2f48385ced578,15,15,1,105,15,0,09010,1
cd56067c01d4cb8468663bd268fd1096,54,37,3,126,54,0,11100,1
c26b9814d0aff638dbd037b56632dac0,109,80,2,381.5,109,0,01026,3
557498b17f2732b9cdaf7e0f6174f902,14,14,1,98,14,0,13820,1
56e1ec4f774a516ade79718ab6fde472,41,40,2,143.5,1,40,04060,1
ea7b6d31d873bd22d2264e7687b875c9,87,60,2,304.5,87,0,01012,2
4ccede8729e85fc5230fe023e3619c85,127,106,3,296.33333333333337,86,41,10240,3
9e50a8d2c2cad12cfbf841f7a945135d,20,20,1,140,20,0,01201,1
ddbbe12141dfb87e73e1d2516cf11ba4,40,39,2,140,40,0,01026,1
6ecb0e93bbe62e08313356f7a2945c70,16,16,1,112,16,0,10040,1
0d4fb5a76939d3816a6752c3aa214c40,95,65,3,221.66666666666669,66,29,04020,3
69e9913adee43b85a7311f85fa9ab7c6,160,70,4,280,160,0,05040,3
26c7e39adaf490c8ac79c585b3aef29a,190,80,2,665,130,60,14251,3
062f6f73b25a38308db46d3a6d224e03,6,6,1,42,6,0,08032,1
9066193b5e72f7500558b22b81ff55b9,218,141,3,508.6666666666667,218,0,05040,4
87881b8546be5f7815de94b8ed5b5395,16,16,1,112,16,0,01013,1
6fa5b08c9dadb85573b21e51114349f4,8,8,1,56,0,8,01201,1
3c48cb2138c0ed1b7095621eb81c8ddd,250,117,3,583.3333333333334,250,0,01026,4
5e627a8168420f3782b49ccfc1214c86,35,35,1,245,35,0,05100,1
2a513ddfb71b51f0184465974823adab,103,71,2,360.5,48,55,01026,3
ee34bdc13d328e58fe89e14444d01dea,40,40,1,280,40,0,01027,1
59fe29a6c7971ef97d4e91bdbd162398,87,77,2,304.5,51,36,01012,3
291db2697e026a95e5370bd8c68aee8c,327,61,3,763,260,67,09111,4
76ec0aae81d37f647378d163464af2c7,30,26,2,105,30,0,12410,1
2aad6d95af5ed3cc9925227c17e2f0cf,31,31,1,217,0,31,10240,1
ede885203ebc0f27a8cbb6aadc1cf13c,5,5,1,35,5,0,11080,1
2be7e4aa5e103a1dd509648b242078d2,51,31,1,357,0,51,06100,1
4f7d39b1c8255eeb095f6a7f328bea4d,31,31,1,217,31,0,01012,1
3f3ace4d43e4d34af2c8f0174e8bb63b,164,106,4,287,164,0,01026,3
07e60d8d2e256a99a3dd6cc3712237f1,44,44,1,308,0,44,10240,1
0b61c081f9098ca74c9cee7746fd38bc,15,15,1,105,15,0,12410,1
0b17e3535b6164fcfb038bff4cdd629f,70,45,4,122.5,70,0,08090,2
37ab473e8a019df76f9fdb4697270502,115,70,1,805,115,0,11040,3
88e3861d9afb3a904d087ca90ebe00d9,41,35,1,287,41,0,05041,1
f36af6861aaa75b89b1903ecf78e2cb6,44,44,1,308,44,0,01012,1
758e929432776b6af51bbbe04282233c,70,43,2,245,70,0,01026,2
b27a8bcf727307168ea82c60af874eb6,32,32,1,224,0,32,02690,1
c4dbc47aba637713b3a1ef94f73dd71a,101,78,2,353.5,101,0,05040,3
df13d5c4c2a00b111370d956430a4865,55,55,1,385,55,0,05100,1
5291ce9113945668d80c43e32834d317,212,110,5,296.8,212,0,04060,4
2f4c5426a80bfdcc40ca89a8a3298edd,25,25,1,175,25,0,05100,1
298619ce56b92d93f64577ac13cf19c1,21,20,2,73.5,21,0,05030,1
7656266035583aa6b0c49aa4adb79971,129,106,2,451.5,129,0,05040,3
b7a3f2b5efd0994d6b5551343779e118,26,24,3,60.66666666666667,26,0,11060,1
34d7398b1781eda3498912387bff13f9,33,27,2,115.5,33,0,11100,1
456fc7b51270403947a18de7e98fee37,142,84,2,497,142,0,05030,3
6b69d10c6381d5b2c32a2b936da91a9c,239,89,3,557.6666666666667,98,141,01026,4
aa9d60329b01396d67b7492625ac1ef5,44,44,1,308,0,44,05030,1
1b6157017d3e881679977acc225cbebb,9,9,1,63,0,9,01201,1
4beab02f80d29b40d5224f95bb99116c,51,51,1,357,0,51,01026,1
85973a1a56c70593de72efef6ccbd619,333,183,6,388.5,194,139,01012,4
49d634c2a499dced7c2f615131423fbf,14,14,1,98,14,0,09010,1
b4c25e2390adb32de2b52aeadf2634fe,46,34,1,322,46,0,04080,1
50e1f139da62183f22b8d33c8e861ff9,77,63,2,269.5,77,0,01026,2
b0b5296dd5a9f1cfee0291ce7ba1db58,27,27,1,189,27,0,04060,1
f02a00bd245792311b8700423ceeb9c7,201,102,5,281.4,164,37,04020,4
fdda6d27959f585f854b4599fcf81cf7,130,68,2,455,34,96,05040,3
5a0d6747f2cdcf85b9f87bc6130780da,5,4,2,17.5,4,1,11040,1
b16d3b04112a995c3daae466dc9c19e7,9,9,1,63,9,0,02750,1
dfb35ab89a2fe9b1e146083e76745787,338,116,1,2366,0,338,11040,4
e97e941900af0a030c3d785dabbbcf85,170,129,2,595,170,0,10240,4
53da3c0229cc941769d6719b668cc48b,26,26,1,182,26,0,08090,1
ec7917e527a108f56614c7a8abde9d29,14,14,1,98,0,14,11140,1
c42e2c3adc57f15db88fab27225d0c17,16,16,1,112,16,0,05040,1
87d722cf0dc7d81d9659894491407ce8,59,39,3,137.66666666666669,59,0,11040,2
d6d2024a1d9dbbdc5e02e0f2f6d51683,35,30,1,245,35,0,05030,1
5958b7946e6dc615b2d0c3f137316229,102,83,2,357,72,30,05040,3
ff92eb44ed0c747afff47e3689bb922e,249,142,3,581,249,0,01026,4
4abb66392ee598e74d821ed47ee49b58,23,23,1,161,23,0,12570,1
0213d1ac8383cee0460d49fc93e315b3,14,14,1,98,14,0,12501,1
07123cda350b8eee7c81c6f0411fd49b,28,28,1,196,28,0,01026,1
e9a040055bcf22020fe14936ab93f255,487,172,4,852.25,266,221,01012,4
04a733fbdb7324ecd5f73c3691cd8c1c,83,83,1,581,83,0,03050,3
eb1c1abffe81e45faa4767402bf758c8,39,39,1,273,39,0,02610,1
319fb2489ea0e4cb7e241286f86a718c,186,66,4,325.5,186,0,01085,3
4c604990d0f9cfc1dc5498d165054339,263,95,4,460.25,263,0,05040,4
ec9dca8e645e50fe81374ad3498630a5,33,33,1,231,33,0,01026,1
df91cd6ad427f793f7bedd6b0cdba8dd,49,42,2,171.5,49,0,10200,1
3971ddb50c67c3a9241af901ebda24d5,5,5,1,35,5,0,05030,1
57d19dfa284de68c708eddccd9efcb0f,24,18,2,84,24,0,05030,1
abb224d70bd2618b85e2839da59e005c,239,144,4,418.25,189,50,01026,4
862ac656f2998ae9a1da683d8b95c832,22,22,1,154,22,0,01012,1
78f507ced6d46c35007fdb5e8edad6cd,28,28,1,196,0,28,01026,1
04f5a1b2f49ca1e1f250ca6f4a96468b,79,67,2,276.5,79,0,05040,2
3235ac8c885b49877f4b50e44d81bc1d,152,90,3,354.6666666666667,152,0,09010,3
00b476aeb0b215bab34626cb955aefff,287,103,3,669.6666666666667,287,0,08051,4
177db8558d3e9d9e63c046f7db36335f,170,123,2,595,68,102,01012,4
9a7151b53c54fee30ce118540427920d,12,12,1,84,12,0,09130,1
b249f7dcf6c2a1e4bb5bc1c03d15562a,8,8,1,56,8,0,10102,1
b8c995963085f2fa91d87114298608a4,26,26,1,182,26,0,01012,1
699b52973887efd24c11259599e114e6,57,47,2,199.5,57,0,03070,1
2d9f9f67aa63761ce78df1f3e1f0de65,47,47,1,329,47,0,01027,1
13402dd8176533e7fc9bf9cda15af9ab,162,91,5,226.79999999999998,137,25,01026,3
fad048c8abf6942521ae324ddb0d67e5,215,108,3,501.6666666666667,215,0,10200,4
c6188bab5f595ab1d372f56873583ea9,22,22,1,154,22,0,05040,1
aed7acf2a84470343861e5284e3f9d73,24,24,1,168,24,0,01012,1
90305e482d4d6c5c297913006dcb9e32,37,37,1,259,37,0,03050,1
df0f11933afa6f3e8f6e513103303536,292,112,4,511,292,0,05041,4
281fd1f74a2368f79de617d43bfd790c,190,98,3,443.33333333333337,119,71,10200,4
c093102145e4f0e7ba9599aa37b293d3,157,70,3,366.33333333333337,106,51,01027,3
924dadf0349008b311bad05379ec7613,37,36,2,129.5,20,17,05030,1
441278464656c1a8a8312de118189540,107,66,4,187.25,87,20,05040,3
3dd5471789c9e6ed92875eee4a5d0328,39,39,1,273,39,0,01085,1
7e940c722e327c048995d2fd8ebbe238,40,40,1,280,40,0,12500,1
dbd9cfabc7c9ca95c85b682356d5d23d,111,87,2,388.5,111,0,01026,3
396f8260dfa2866bca834ee0f98f1f65,277,134,3,646.3333333333334,176,101,10140,4
2f9887d463325b0198dca07abcae0d36,40,40,1,280,0,40,11080,1
b4e3029c40d21e0b2db35c299a10bcae,15,15,1,105,15,0,05040,1
627086e05316790fd9a25c7db8d81598,76,61,3,177.33333333333334,76,0,01012,2
004c59dafb02a53e4e2ca68b66053df4,26,26,1,182,26,0,08132,1
550b40c884615fb51c8ebe003f86c2c5,3,3,1,21,3,0,05100,1
8819acb4c58f19b746773bf1cc472274,130,83,4,227.5,111,19,01013,3
9f46d83546d5b93b8c82f48066ce4101,44,23,3,102.66666666666667,44,0,08110,1
13544f5bb5260d0c56edc96d10f74b68,44,44,1,308,44,0,05040,1
48b3d41ec499a93a914913fec47198de,169,94,5,236.6,169,0,05040,3
f23b465cf4c9f10bc0e19f09ea011082,13,13,2,45.5,13,0,01013,1
fa280fd3e854d90f7716cea23362d8e3,41,38,2,143.5,41,0,01026,1
78dad3bfe43a0695ca2b7c362c59b3c0,45,38,2,157.5,45,0,06100,1
9ef9a2ec1ef1c492a9cda2ccd5d55957,220,105,4,385,169,51,06120,4
7ddd64f4e62306808d5358db6c02096f,42,42,1,294,42,0,04060,1
ab89d3ed4a947cd909a6ae86fc212f59,33,33,1,231,33,0,01016,1
a7b2c36bc7f67eaa02dff438818ebc05,51,40,2,178.5,35,16,08052,1
fc0e25683cda145a8a820e50c9876f88,181,68,2,633.5,98,83,01013,3
77dfbb35cff84a537f99a4529f5b3cfa,19,19,1,133,19,0,05030,1
62bb8c38dc2cc1a9bfbcc3484d2a41bc,25,25,1,175,25,0,08010,1
4c0b6542e2be401f21f9f5d801c50a84,181,128,2,633.5,181,0,07143,4
e3c1f233b94d2ada84553b61b844ad26,77,75,2,269.5,77,0,05030,2
3650668d979e59b3bab49e4c91cd2a14,29,29,1,203,29,0,09090,1
2da218a68c5a712f6d7169d283c4ed12,126,74,2,441,49,77,11100,3
462acfddef22a2a9400cf48173632078,131,84,1,917,131,0,10200,3
9a216ec8bd7cdfbf1cb95e3136ab9786,51,28,4,89.25,51,0,11040,2
9cde29fdaa7699da0e95c45d3919bca2,23,23,1,161,0,23,01012,1
86172ce9f014b48f2e912bc8f601a8bf,29,29,1,203,29,0,08134,1
34f5998b156d892c24efdd716cb0f971,184,89,2,644,184,0,09150,3
c70012b1a9d72d07cf5eb2e041adf814,42,42,1,294,42,0,01026,1
386f619d29b38cd3bc1cec9f7ccaac89,5,5,1,35,5,0,08315,1
4eb95bc0fc9281601d6613625046601a,182,78,2,637,182,0,10080,3
e23cd642430e2d0b8dc043cb500b986f,495,132,4,866.25,495,0,05040,4
fbf3327d34565451c2f7813b490f2861,106,56,3,247.33333333333334,74,32,01026,3
18ad50b09f69f0283e760fd5c83b8313,48,40,2,168,48,0,10200,1
0080422d8ae594ea199ab00659f692cd,151,76,3,352.33333333333337,107,44,11080,3
ea8a9eeed02094b4cb93b51be5eec173,202,90,5,282.8,175,27,05040,4
12f0c7eff671679ecb7db569ba0d0eb5,9,9,1,63,9,0,01085,1
e9f5b0bddea3ac5190a47aefa75cebbc,18,18,1,126,18,0,05040,1
0a9f7eae876f1d368fc8eee578f49d64,140,89,2,490,140,0,02620,3
b24659d259deda8a4b5a7034c5b730bd,37,32,2,129.5,37,0,01085,1
b4800891a3b5234bd86314d663da5901,47,30,3,109.66666666666667,26,21,05030,1
2b85f8c540dc364185badceb94cec76e,38,37,2,133,17,21,01201,1
01dca03dbbb94312ffeebaa7f8596855,307,126,4,537.25,307,0,05040,4
0fcb45bc9c2ad83274fbde8c34c4ac0c,55,55,1,385,55,0,05040,1
cd388b2304092178a040308d8f3ff57b,34,34,1,238,34,0,08100,1
cbd551d9660315e069fb79f0656b002e,20,20,1,140,20,0,02690,1
0eeae06da39b967c4bd8f9d6587f7b2d,194,108,2,679,194,0,13930,4
5282c45360336ef061cb137b85746e57,90,66,1,630,90,0,10200,3
531efd8b2a17fcbd8b75c688272baa4b,47,47,1,329,47,0,08031,1
4373c023c94f30ca4a6061a34288bccc,47,47,1,329,47,0,09351,1
8d049701d3c0cf376edd71c4c6ab19ed,202,68,3,471.33333333333337,165,37,05100,3
5da38527a76286267119adc101125a52,93,37,4,162.75,83,10,08051,3
2d512af6940978f72fb7d95f6249f0e0,278,105,3,648.6666666666667,278,0,04060,4
aa39d8419c337a48a79c4e77aced172a,450,124,3,1050,354,96,05041,4
f85c4493543228c400f0736e65ce25d8,237,104,4,414.75,237,0,01027,4
521ed4492da2e560ef1b2d4c81e0779d,22,22,1,154,22,0,09130,1
c92021e9ce84d0ae02719bde8ab0eab0,39,34,2,136.5,30,9,10140,1
b4e1dcc55ec78a8194bcc747e3298dc0,205,102,1,1435,0,205,10200,4
c4496a11298daf469a954e6e4b2cc1bb,111,60,4,194.25,111,0,01026,3
48210360f04258b576f67642c98488dc,374,154,5,523.6,284,90,11100,4
8a7d9728fbe1d22404da7c8ae7071160,163,72,2,570.5,163,0,05030,3
3e576bd4ffd0676c98a8c7bd47531a4b,73,57,2,255.5,73,0,10200,2
a32a8a256645f5f0716368e4bd622a13,27,20,2,94.5,27,0,05030,1
27ce83eca1ecdbf83ecdfd94f407fd36,168,95,4,294,168,0,11040,3
4f8976e88758dab870135e9974cd2b70,108,62,3,252,84,24,04060,3
6f84e204b6e7913f354179b0ecd760a9,114,87,2,399,50,64,01012,3
aa4f8efbe93c19ab6c2c90d7b9349a51,48,43,2,168,48,0,05040,1
aebc088c09a7830efb9e105af659a9e3,15,15,1,105,15,0,01085,1
cd43eb7126e81f29908addd612dc1e21,187,102,4,327.25,145,42,05040,4
5a26f7aba97478c0ddcc9a885db4bdfa,46,46,1,322,0,46,01013,1
8aa6afbf520323f7cefd07bc2e747765,121,107,1,847,0,121,03070,3
1693b355d2e809ef5401525982ad2325,91,74,1,637,91,0,13490,3
46cc2fc15a3311b84cb1e6aca44f2918,33,33,1,231,33,0,04060,1
65a53f1bd85d2e22e531236d86c8f79d,16,16,1,112,16,0,12430,1
666e7c5e64c2d356179b44935d296370,154,125,4,269.5,154,0,05030,3
3b157eb5a93f00737b26d0e2b5063ef0,106,86,3,247.33333333333334,106,0,05100,3
81a5bdb18a483a598eaf297b49660121,23,23,1,161,23,0,08010,1
40462ebe52491038230d2607c2b5c3f5,1057,232,3,2466.3333333333335,1057,0,01012,4
d1210f6d5bc3a6a3cac129a54ba3ea81,82,57,2,287,82,0,07122,2
866a9b5b017459d50c368586145bb96e,89,60,2,311.5,89,0,11100,2
3f0f6ca0112e0e8874a4a32c67e890b1,54,46,2,189,29,25,01013,1
65af3dbbd2f8e38c7b1690e09e8adf5b,37,37,1,259,37,0,01026,1
960af849739f1881cba17448dc328982,24,24,1,168,0,24,05041,1
dad64e568d4dbb7ab97689ca50cfed83,31,31,1,217,0,31,01026,1
4b98cc817d293f899621b2ec65f2a9ae,138,74,3,322,103,35,05040,3
3ca3fde21467932968c3fa438a5b1a0d,73,45,3,170.33333333333334,73,0,01026,2
b729b2120b99bd58df49cd7d6f9ff39e,131,102,4,229.25,113,18,01027,3
cc9beeef7d899ced86169d6ce6759205,6,6,1,42,6,0,05030,1
4b1c77f357ce4200ef2b789b87afce29,40,40,1,280,40,0,10153,1
b01b77fb01c6ee05366868c0dc4ef786,31,31,1,217,31,0,11100,1
7bc3d2c3722e0c79ba0cb61950dbba12,276,143,5,386.4,249,27,01013,4
470846b20c2c144db1f77e544619e0b0,453,215,4,792.75,406,47,03050,4
800a41f33248c620f5677e8e43b9967b,29,28,2,101.5,29,0,10140,1
6a9c7a0a6226ee6d4003cd578b2c2186,272,108,3,634.6666666666667,272,0,01012,4
52e40a04e16d59148818220cff16a3f0,167,91,4,292.25,120,47,03070,3
6b9f44249690686591b1e8cba85465be,8,8,1,56,8,0,01012,1
11e9a5264c930b781d2ba6eafda71fe1,51,46,2,178.5,26,25,10200,1
5d3b14de9de85f760c08cf86377efe07,77,66,1,539,77,0,03090,2
8162864ba6d0763585a2100539b3cc7e,69,59,2,241.5,40,29,08312,2
c3688875a26cd9d29726564e44891e4a,47,47,1,329,47,0,10240,1
66a68ea72a74a8cf60305f941e05861c,247,126,5,345.8,247,0,01026,4
5f6fe9abc786b19b0337d6b22185db43,30,30,1,210,30,0,05040,1
20a3f455cb91b0c01eaf4d05faa650de,270,104,2,945,194,76,10200,4
00de9fea9c64c34947f5e4628f3b89df,19,19,1,133,19,0,01012,1
fdd24c9d038fcf5ee80991995ab2d57a,44,44,1,308,44,0,01026,1
2fd5dc0dfcddcb153969352ba7e96c18,133,84,3,310.33333333333337,86,47,05030,3
4cfd1636934fa3a2c54301575b88d33d,53,42,2,185.5,53,0,01027,1
eb97c9c19beea0b3d3a56290f6acf149,41,31,1,287,41,0,11100,1
e555ab8303bce0c91e892efbe28f84fa,49,49,1,343,49,0,01026,1
5da13ae0568cc1996057d077effa9f6a,51,51,1,357,51,0,01026,1
a063eec220722eb2cc7a2615146df67a,20,17,3,46.66666666666667,20,0,10140,1
16ebb843acf304475eec69d456523a8f,66,58,2,231,66,0,10240,2
01597bd49ddea6a772935c29663aa864,56,48,2,196,56,0,09130,1
bc649965e0dd106d77675f3ff7514671,346,175,3,807.3333333333334,182,164,05040,4
4534727dc53ba1683990a1472c60c728,109,80,2,381.5,109,0,01026,3
32fd106b3f029b82f325d8fb92098f6d,51,37,1,357,51,0,03070,1
04ad35427c80c69ce329f18d29207072,8,8,1,56,8,0,11100,1
09566e873ae8b86d027a159c4f1afaf7,60,60,1,420,60,0,05040,2
11cd9eb34667a0280f8c21dc09444b2c,25,25,1,175,25,0,12742,1
69b7600eaa14343bdc758c5942b2cbe6,240,124,5,336,169,71,05040,4
cf3c49a07b3802b62d2b08cdac86e139,65,57,2,227.5,65,0,05030,2
3c9227e1e5e2a1b29b0dc7de3fb8c596,84,72,2,294,51,33,01026,3
6f19fd3fb531c7e12302d4a83d6c2fd9,43,43,1,301,43,0,10200,1
f9852aca230a9b775875ca9eb4a72c94,119,59,3,277.6666666666667,119,0,04060,3
d191dda80520496f4c31d72f09c984c2,28,28,1,196,28,0,01012,1
65ae24a00bd5fc535fb5bbda5b916409,339,145,4,593.25,339,0,05040,4
3da7670fc0414e0417c895bb39cde0db,44,33,2,154,44,0,01012,1
a456811500618c228662cef3fcf06cf8,47,37,2,164.5,47,0,01027,1
94aaf77fe46838b21203dbc737afee87,424,152,5,593.6,424,0,01013,4
a0212452a7e37f001417279f6eb19cd8,29,29,1,203,29,0,13953,1
0469affe3a95aadd69c5a2e4785ccdb4,78,56,2,273,78,0,08010,2
002867cbb9f0de2b4678b73bc8d8b3d9,59,51,2,206.5,45,14,01013,2
1cff4b3510a14317981f5a06e872ebd2,43,37,2,150.5,43,0,01012,1
720a74d8b562569c4232ec986f541dce,942,315,3,2198,741,201,01085,4
2849526800cf8e6b77598644a95fbddf,398,204,5,557.1999999999999,351,47,01013,4
2604a24374e270d5fc2004e81797cc3b,100,59,4,175,100,0,05040,3
7932e43cff7cf307d2494194ea21261f,249,52,2,871.5,249,0,05041,4
9cb9f05b1c688c2bd6a7223866d6da5d,85,70,1,595,85,0,01013,3
90aac75212a2b007db4b280388db9b01,58,56,2,203,58,0,01026,2
9fdfec19e1aef56852e698bf90a47c4e,24,24,1,168,24,0,01012,1
8a5f663bdcffa536c2a6f86479efef5d,204,123,3,476,204,0,05040,4
fa41a4efd6da16f1e6a0190d33353d8d,71,71,1,497,71,0,05040,2
1e9ca940b47a4a8474322af861c3d7fc,61,45,2,213.5,26,35,01012,1
c6b50a204b4e6f0b1ca620cb6ffb957e,28,25,2,98,28,0,02650,1
9344235c34f08511d2d42ab16d6349a2,41,41,1,287,41,0,09030,1
6b6007e9e35dcaa3945cf17b5404bfc2,162,106,3,378,162,0,01027,3
b4cc4a4705cf6ea0710f004c6b29f218,287,136,5,401.8,193,94,01013,4
700c1a494a017e788ba4caea19f9620a,67,57,2,234.5,31,36,12500,2
90294b5d9dbc292e97626f2ec342c4ef,69,56,2,241.5,69,0,03070,2
8af359c0930ae9b5623532551470803f,19,8,2,66.5,19,0,03033,1
77292a6f7c01634e7c414f84eeded38a,7,7,1,49,0,7,05041,1
fa585eb191546f7159a10f2cde47f169,79,59,2,276.5,79,0,06120,2
cd44be6b95f1eba5322ad6ba6e56dc5a,24,20,2,84,16,8,11140,1
5ffe43f81b468761ffc71ae6e3741d21,272,106,3,634.6666666666667,272,0,02690,4
8199c7246c2feebff749fac5277f9cc3,27,23,2,94.5,27,0,10200,1
c8a6fe449b9d44bad5913c08776fe78f,119,84,2,416.5,119,0,10200,3
cb8fdae8af5105e7bcb4e2a438f2e477,64,59,2,224,64,0,11100,2
566c2145798b647d6d19d537ebeea33b,263,56,2,920.5,263,0,05040,4
7d786f20ad1d7a5936b0de6154806826,33,33,1,231,33,0,09090,1
3da136d7b0d20868b461a65de7d7f9ab,18,14,2,63,18,0,01013,1
a5746fb39a741bf33eaeb30d7167daf1,95,73,2,332.5,50,45,05040,3
6f4911d26ae776c17816401dc1733c3b,52,32,3,121.33333333333334,52,0,10200,1
125ea42568223b4b74ddbf81682a15ae,93,55,2,325.5,93,0,08032,2
264a8f2a041f5ee3658559586642bba0,15,15,1,105,15,0,04020,1
4c33a7bf30da79c06dbacf0c32b74f90,55,50,2,192.5,55,0,05030,1
5d9ffe91ee0e26649e00029d3adcffe6,9,9,1,63,0,9,03070,1
51325e51904b0b66ab2f948e76ac648a,35,35,1,245,35,0,05030,1
081a042ad70d1322f2e8b625187cdc61,150,92,5,210,150,0,11100,3
f735b585460e3fdadca104bd2ce4724b,202,110,3,471.33333333333337,128,74,01027,4
de577896db27178e2a5e03c7db6c0adf,16,16,1,112,16,0,01013,1
d9eeb805b3f29192e15da6ce90296073,117,84,3,273,73,44,01026,3
4836c212269e3011b055d9dc19364b15,532,186,4,931,532,0,10200,4
6523c086bba503055adad37cfa95405a,4,4,1,28,4,0,11131,1
9e6db5392e7b99567fcf0851fb398f4e,22,22,1,154,22,0,10200,1
0fc0cd645ebbf78a183ae20b5d7b8e34,17,17,1,119,17,0,05040,1
af67d8a69574dc259599d53852bf6b4a,53,50,2,185.5,53,0,03050,1
4e9e5d60bc97d4622d9137d4a9e0fd8e,44,44,1,308,44,0,05100,1
33ec259268a3a70db2633eed3ca6a308,136,81,3,317.33333333333337,136,0,05040,3
e39422455a353bda01c7fe9e40fffbe3,255,93,2,892.5,82,173,05041,4
70c6c4b3e83a36cb21785ff7599838bf,274,87,5,383.59999999999997,274,0,04020,4
2ab6d68797a0406d671339174b132128,24,24,1,168,24,0,01026,1
788d66b1d98cf439cacc44efe44687d2,101,65,2,353.5,74,27,10080,3
dfe5fe35cc7b54cacf4ff31bf3047e02,391,86,5,547.4,174,217,01012,4
b099a077c70658cdbe13f6aeda983e05,52,46,2,182,31,21,01013,1
d1640c9e5ea8c0d5cef577416c92546c,143,89,2,500.5,55,88,01012,3
185d45cea17deed3db7d834ff3c451dc,85,49,3,198.33333333333334,85,0,05040,2
23d69a689ce8a2ee2307d2b9e6760df4,34,33,2,119,34,0,01201,1
3376cca98601ae96a8d3cbafa8d4cbe2,117,70,4,204.75,117,0,10240,3
4220eb72d854693b65ce7e6f3ea8b63b,9,9,1,63,9,0,05030,1
86c1e19d6e3c8d918b9646fa5a626c3c,244,78,2,854,49,195,04020,4
72037777093c99bfaafb84facca31a37,35,34,2,122.5,21,14,01013,1
1d761a2201e46915edb993b2924ccf41,143,80,2,500.5,18,125,01013,3
e7988de4e47193a48a830ad522b1d8f1,35,22,2,122.5,35,0,08313,1
5e3c4bffaa79c1376c11137e6b270446,288,127,2,1008,45,243,01026,4
6c4ad9babd87892df766e5b990a11f82,138,111,2,483,138,0,03090,3
d81d386e51ddb2d59a15c2254e1b72e4,98,67,4,171.5,79,19,12430,3
4a92aa1b28a70d61140a834a582b4eb5,59,51,2,206.5,33,26,05040,2
c6b57705bea614e1de36dd3e2d3f729c,116,90,2,406,116,0,04060,3
676ecbe24cd62dbf401cca6f805abb2e,21,21,1,147,0,21,08452,1
42c9426c572c20659e4b6bfbadd0e392,131,67,3,305.6666666666667,103,28,08131,3
56d19e6da22eba68f54654c06925127d,32,32,1,224,32,0,10029,1
6cf4dbfdc9065cac5fe00a8e74dba2e7,7,6,2,24.5,7,0,11040,1
49f6eeb55458d01df5f13eafa8518248,29,29,1,203,29,0,01013,1
fb8e85c442d9ed114325962383f23adf,46,41,2,161,27,19,01026,1
98906142d38fdce98f71f9617ed90f3c,25,21,1,175,25,0,01085,1
e9bbbd8e4ac9ec50047d4e5792761904,88,64,2,308,88,0,13875,3
8ceb3908e22d205a17b7629ed7f7e244,40,36,2,140,40,0,12570,1
bcfffcf61a2955df6c64eb03c1708490,19,19,1,133,19,0,10080,1
0e02b8b0738643027723b78e4924ec9d,23,23,1,161,23,0,01012,1
d65da6c35ae2171b5b1f093fc8e74466,32,23,2,112,32,0,08031,1
a002d78f3600ffbe2f968ab8aebae3f3,40,40,1,280,40,0,01027,1
cc264adf140c6ba7232816ee41e0a2eb,34,34,1,238,34,0,05030,1
55902400623d15bdb20289ddda5e36ba,36,36,1,252,36,0,08052,1
48150f21d5092e2a4808295e3bfbe616,72,62,1,504,72,0,05040,2
00d120f76d0826a47e664f86449e6147,4,4,1,28,0,4,01013,1
1932fe826bc6ac15f1b1f7128b69f09b,124,96,3,289.33333333333337,124,0,04020,3
58296f45f8a5bce1e5f71e35343a8653,37,37,1,259,37,0,14301,1
76cbe00b2dc6c6cad6a203a1d372f551,28,28,1,196,28,0,01012,1
71cfafaca3a45784a02f0df6a353d9a3,82,57,3,191.33333333333334,82,0,05040,2
3125ecae5f8b953838dbb197f75d2ec1,81,58,2,283.5,81,0,05100,2
342215354dd2eb2cd1454df41438d524,130,86,2,455,130,0,05040,3
76cf8d1fa5d509f010bb5dc672c18e60,11,7,2,38.5,11,0,10200,1
f58e05558e9e9def591eb998b469f8f8,50,37,2,175,22,28,08100,1
c09a1aef73098dad7d06ba87e7f5ade5,24,24,1,168,24,0,09090,1
4e2d448909c6fa72fe36585759b26585,153,89,4,267.75,153,0,01012,3
15ce38b359c1425baf8a4554bb541927,8,8,1,56,8,0,05030,1
0e5ffce9a347c699ddc4c1028cd9c0ff,67,62,3,156.33333333333334,67,0,03050,2
3d336299a914de47d7d1f30ce26e2f64,77,57,3,179.66666666666669,77,0,10153,2
a499f1a9f6d5fd16fe4748c82af59374,263,124,4,460.25,233,30,01013,4
77d474942f829254c8ee58890bf83e1f,103,49,3,240.33333333333334,103,0,05040,3
ca5ba3410dd165d087598a57f3c759a8,257,94,3,599.6666666666667,257,0,01026,4
e24eeee3f7aa74e56f837423c4c2bb94,63,45,1,441,63,0,01013,2
bb741c4756d00639242e3efb3d917c07,72,49,3,168,72,0,05030,2
d7be3cb5c840a67380084c8403af437e,36,36,1,252,36,0,01012,1
50c57460c60e7fcaf680f245bab1158a,113,77,4,197.75,113,0,01012,3
0ec27a348200461ee54182cde485df5c,45,45,1,315,45,0,04201,1
537e8e798637dba47dde070bb5d99f37,46,39,2,161,22,24,05030,1
b483b19696313907106dcda29eaef221,62,49,1,434,62,0,01026,2
87f3faf24de9893e1c2db9e38e1cb066,22,22,1,154,22,0,04060,1
044939e58294b8f6010614cf02f01f88,114,80,2,399,50,64,01026,3
8f17832bf4133414e278a6069c01b39d,78,61,2,273,46,32,05030,2
20ac69a79961bdabda19d80753657da6,38,38,1,266,0,38,04032,1
04ff57b4ee7848e90b946c8e5af73ece,24,17,3,56,12,12,08230,1
b03ab3097267a7933d25c7afde18541d,7,7,1,49,7,0,08010,1
f04aaa261b1786e7234054a49774ce56,117,65,4,204.75,70,47,01027,3
4e8cffed7b64ebce4b661dffc67b79d4,64,42,2,224,64,0,01026,1
d3ba115643e22ae54663a3a781250e3e,26,24,1,182,26,0,01027,1
5c1931e0b919c5ca2da9624b617cd4bf,11,11,1,77,11,0,04080,1
a427d96537dae71573d483b52ed941e1,375,191,6,437.5,335,40,05040,4
39365607be5e784c737add78028a3e9a,35,35,1,245,35,0,14301,1
409fd4b5cc50aee2532eb6451cf0a7e7,5,5,1,35,5,0,05030,1
c97d25e7258d042ec1e6cdb70ec270b3,22,22,1,154,22,0,04201,1
a22b894986805942296dc072015a4406,82,72,2,287,23,59,05040,3
3f9a7404f5ba224ba25a161911da0942,174,50,3,406,174,0,11100,3
20dfe202643e6456957a1c143ab25984,90,56,2,315,41,49,05040,3
6f548f0bfdeaa7116e375989aa0acc75,273,125,5,382.2,206,67,01026,4
7ce65595c01fd7c09b6de9cf5cba8494,103,62,2,360.5,103,0,03090,3
9bb7c87b4ed7598cde45159ff7669203,34,34,1,238,34,0,01085,1
981ebe19999107183383742e8624d1d5,70,45,3,163.33333333333334,70,0,06100,2
46a3c6c1611e3711602bd85327c109b5,84,67,3,196,54,30,09090,3
dd8ae68385d4cc1e0e6db39d1c93f3f7,134,87,2,469,48,86,10200,3
73a2fa64c96feb5313666581fe003ea3,231,87,4,404.25,231,0,05040,4
c35d5e48e2491cb79cd8c7c0f57f481f,17,17,1,119,17,0,01012,1
1f1dad5c884a6e8ad12e967f936393f0,22,22,1,154,22,0,05100,1
0b7518cf7c290441ca3ff97d03b0b040,29,29,1,203,29,0,03070,1
cf0c83ecbb7e74fa7c8dc6db159a3107,34,34,1,238,34,0,01026,1
20b0fac432610e208ea66ec0975b5495,18,18,1,126,18,0,09150,1
060210ad06568f90b8291c9649d95cfb,427,100,2,1494.5,427,0,05040,4
7863ce5c1c5e64f2d74b51b83af55ad2,70,51,3,163.33333333333334,70,0,11100,2
22d6427ca9643609757cb6d165b188e3,349,103,5,488.59999999999997,327,22,05030,4
f2fb94c6ba64ca1f3054ff0eb9aef025,140,103,4,245,113,27,05040,3
b200bac904e30ea96251c6cb4d4aa210,34,34,1,238,34,0,02690,1
aba76fddf4b812185d233c5e16abe713,86,64,1,602,0,86,01012,3
b44f647698aa120bf8e4792a08770968,41,29,3,95.66666666666667,41,0,05030,1
882c77ede3185fc5d6b9bacc3907f306,4,4,1,28,4,0,13510,1
63746e008cbdfd2b6c64db6f5dcf528f,28,28,1,196,28,0,04060,1
c6640d89d6457b236cfda0163e400f86,37,37,1,259,0,37,01085,1
29091683545ac7e98c8659f29b6f8711,146,105,4,255.5,72,74,01027,3
e38904b3afa6237640fb0f6cb7fc402d,114,48,3,266,114,0,09090,3
eeeedb49249f9fc51b4fa8a1c5584326,59,37,3,137.66666666666669,59,0,01085,2
0f6a967245493fbe4b7c0071b3d05a15,15,15,1,105,15,0,05100,1
9c00d37453c6b808debbd4ef4b7dbf29,235,173,2,822.5,42,193,01013,4
856e63e45623879f5e2565229f207845,36,36,1,252,36,0,05040,1
889f1e2712996db226c7e2a3781ee337,128,69,1,896,0,128,01027,3
dace895b9c2b406354c84a01c9684225,30,28,1,210,30,0,10200,1
1341806c0c3a022082ed117867f44ade,32,32,1,224,32,0,04201,1
d2aa749adb071fa21ca4cb13908a781f,29,24,3,67.66666666666667,29,0,01013,1
3aa7cb5675ac01e67ca22003437cf6cf,33,27,2,115.5,33,0,04032,1
2efd6c5ad397b68d510bec8527fe6502,21,21,1,147,21,0,09110,1
f0f8db7a0526feffb8df734a160be668,213,96,4,372.75,213,0,03070,4
19b1c01e28a3f9fb28c17fc342bbd780,91,69,1,637,91,0,09130,3
33a6e00a109054b7d5047434ea9bc789,273,147,4,477.75,273,0,01026,4
322570428b9af5ace5efc5e43eb39cd9,32,32,1,224,32,0,05040,1
b28f86b21ae7a5144232e22037aabfec,151,108,2,528.5,151,0,01201,3
8d30e510fdcfc92cbbcbe0dd958779e6,105,77,2,367.5,46,59,05040,3
4d2f24527ccf82c23c22e75bf49b14d6,47,47,1,329,47,0,01013,1
aef2266838ca84718ad23bc42327f518,44,38,1,308,44,0,11040,1
f3bccbedef771d620992430f59314258,337,85,3,786.3333333333334,27,310,04060,4
67f9d468b1d72cd7d8ba6ce8fa3b929c,16,16,1,112,16,0,09010,1
c94cf277413ac11d2726a0e4b866b298,85,68,3,198.33333333333334,85,0,12470,3
5e46dca4d1e4d2a3f374c875ed4ced8a,303,129,6,353.5,262,41,05040,4
177f79e0273c2659c3a1839d70cf4bd2,256,182,4,448,231,25,05030,4
f5db52eb957d770a2d509703ac7c5f63,21,21,1,147,21,0,09090,1
8c65685c77e80751a3006855db212c68,26,26,1,182,26,0,12470,1
65a95b2761381bf6ee5e1307163c5bec,15,15,1,105,15,0,03050,1
06f86cbc1936c5817a43f41d1735c522,51,51,1,357,51,0,08010,1
e2db3a7883a746dac5a4cc35917233a1,59,59,1,413,59,0,10240,2
b83b723f03be6d4def115ce0efc55b77,20,20,1,140,0,20,05030,1
19bfe2804158c03d71f528b5fa232160,28,28,1,196,28,0,01012,1
7a73eb5155aeb2f012cd9c1d27f46f4f,56,47,2,196,56,0,01026,1
c2c5c5f7cc4bb25472bd71e4635bcae9,21,21,1,147,0,21,01026,1
b6b7151941189624def2459e23c45b57,32,32,1,224,32,0,02691,1
0e6a40353e867e7b34a1d041d65451d2,28,28,1,196,0,28,05030,1
21b9c360dc87ea460ae23aff3183b522,93,60,3,217,93,0,05030,3
841f46081d14e29e7754aac528e786e5,46,41,1,322,0,46,01012,1
58441f2da1738ba00d5bf1b002647044,166,127,2,581,166,0,05040,3
147dd9a2837957ce0b84d8ef8b2711d3,36,24,2,126,36,0,05030,1
56143c17a15a35076ae779e37387c0e0,379,105,3,884.3333333333334,379,0,05040,4
fee1bdec8d79dfbd486c953d7f4b284a,2,2,1,14,2,0,05100,1
d2d73c3a3a06351df7fef170302a91ec,116,95,3,270.6666666666667,116,0,01012,3
8e635631553e59cf3e91188c3e168da5,48,44,3,112,24,24,01026,1
99fe2b92a7dc388bdad598eb9d45877b,52,42,3,121.33333333333334,27,25,11040,2
e3d4f91e3c6ff35801e10027ee8d7840,15,10,2,52.5,8,7,03050,1
86654976f3a35a2e5106941c845e8f56,36,36,1,252,0,36,01201,1
10f422c34e9e497215f3a9177306e6a9,33,33,1,231,33,0,01013,1
4f7d233947eb4e4575d95333f421692a,67,64,2,234.5,67,0,10101,2
6019e884e5bc0ba4e4eeb3a6f0ce5f2e,24,22,2,84,24,0,10200,1
81e18fe67f341567fbde53af9e6cf399,207,91,3,483,207,0,11100,4
fe901d5f273fcb02310bd59e298dac69,163,69,4,285.25,119,44,11040,3
acd7620a5c6bbad31c5cdff7ec0da87c,26,26,1,182,26,0,01027,1
4fc685fa0f403cbfd3ff8a36275ddcc4,141,73,3,329,76,65,05040,3
105a973f8e45fe78b1be12648a174821,34,34,1,238,34,0,03090,1
17237fcf0a5313f35042953436cc9aca,150,92,3,350,106,44,05100,3
31a7102529241f0cca88180c4149f856,29,29,1,203,0,29,01014,1
d32977075b426ef0d7acff553e9d6116,140,105,2,490,140,0,01012,3
8c464ced4d2abe924b356f3650226dd8,31,31,1,217,31,0,01085,1
ac893cbe646de35213777bbf7ae34668,32,32,1,224,32,0,01012,1
0f245174f6153da2b33e9989b97932ce,22,22,1,154,22,0,11040,1
cff12acbe8b74ab79a34ed4ec3a29e20,73,60,2,255.5,55,18,05040,2
06351fad0c3bd36796a689ac496f3de1,44,44,1,308,44,0,05040,1
82471acc277d06da00a7140d3b841f5b,385,158,5,539,183,202,05040,4
1ae1bbbc9f31ae9e3ad6f4d675e05b41,17,12,2,59.5,17,0,12501,1
fae41046639ab9503c6e7e14ca0f655e,21,21,2,73.5,21,0,05100,1
39ee6bbca91af8d0a1f47e3b762379b7,124,66,3,289.33333333333337,124,0,08231,3
7ce1c50abc98315fa9c923d759f32072,118,85,4,206.5,118,0,02650,3
891e242c55c85df08d34414b1eba44d7,208,53,3,485.33333333333337,208,0,05040,3
63ff92feaea16f3c06b0486ecabe4ca2,79,66,2,276.5,79,0,05040,2
141b54430bd31c1d2df685a45062398d,92,76,2,322,92,0,11102,3
de52c85249fbb924d5dece595b7db945,47,47,1,329,47,0,01013,1
9fa6db3ba08fd1bc5164f6de2dbd868e,22,7,4,38.5,22,0,11040,1
98702ac4e630fe5f3c195cb79ee38d17,214,110,3,499.33333333333337,146,68,01026,4
2c668ed8774329835f33797b18b64904,45,39,2,157.5,45,0,08051,1
3e70da595083d1854173d92631935b5f,69,59,2,241.5,69,0,05100,2
cbb29da33ce74ef4136edbd838fdd6f0,54,47,2,189,54,0,04020,1
11ec982650f4a7ec4b57f567603f68b6,68,68,1,476,68,0,05041,2
d3248f2d770ec391fbee584e043e7a06,165,84,2,577.5,165,0,05040,3
fcb3991f604828bdd0f675608a9070b7,16,16,1,112,16,0,05040,1
1970c7f23c8038a46d9c69fc86f8ae47,66,52,2,231,35,31,04060,2
75b3a7c8bc699e2bfe4a79c469403b54,13,13,1,91,13,0,09351,1
509f89af2e75944319a0e6d0a39bec8f,27,27,1,189,0,27,05040,1
9355855ed65b0708154640bca172c606,47,44,2,164.5,47,0,10200,1
3e1ec959a436c101dbaf638c49627909,22,22,1,154,22,0,01026,1
28d3779227477526bae3e315c22efba8,16,16,1,112,16,0,05030,1
72a95d55fb3df2456b4c3de89b1263d2,74,60,2,259,74,0,01026,2
42b6b652eb6d387eb39b37ab57d47785,69,51,3,161,38,31,04020,2
cacf82590fa01f91841c2b1183dfaab2,252,93,3,588,101,151,08051,4
6c5815fbdfe22dc0a9fb049a0a8644b3,420,201,5,588,343,77,01026,4
2667aeec6d31de274ac2f6162fc25a2e,67,56,2,234.5,67,0,04060,2
64d5024ee787b11342abbf25729d73cc,27,27,1,189,0,27,05030,1
53eed604b387ec378e684887a12f1875,103,64,2,360.5,73,30,09130,3
59b1e373a058abc48787512daac1ee8a,22,22,1,154,22,0,01026,1
4db6d2517148168e40a411f5865b39e9,135,65,2,472.5,39,96,02620,3
76f0cbeab9255369a437a5edb247766d,100,85,3,233.33333333333334,100,0,05040,3
db263a58ff8544a64a69dee4861d487e,172,120,4,301,172,0,05100,4
ecd801e650551cb077c73c1bef1c1a49,151,67,2,528.5,64,87,05040,3
bb8a6a5e60e2654e5fef6b244a391d8c,44,44,1,308,44,0,01012,1
7135b8f9ee45e8c9b37a8967b2e2e58d,182,106,3,424.6666666666667,182,0,10153,3
50b142193c3c61e829ecbe5dabc72930,236,96,4,413,236,0,05030,4
a232c1ee61f1f2749fc5490ef4dd0bc2,11,11,1,77,11,0,10200,1
68e6a35c96737a2cf6c0330647bc37d5,29,29,1,203,0,29,05030,1
413434aa22f75ed0b6bbee321ce8d02f,11,11,1,77,11,0,05030,1
e73e7e37d5daeb2b17ba4d1659d23a1d,1,1,1,7,1,0,11040,1
9a7430d71f700eeaac2399018dda342f,47,36,2,164.5,21,26,05030,1
dee65f5dca818d2bb0e9e63847cd0c0e,117,86,2,409.5,117,0,10200,3
22f8b88bb665c4e5cefea0cdd06de5d3,139,61,2,486.5,50,89,05041,3
563e94bfab15296cea5e433997594104,184,89,3,429.33333333333337,184,0,01013,3
0ae090d1299c5c4e05ededcc8073dcf7,35,35,1,245,0,35,08134,1
7bb8affb18398b7d86ca59ec9e56ec8f,1,1,1,7,1,0,10180,1
29de74a28fdf1eb5b3d245cc5f10a520,73,73,1,511,0,73,03090,3
84b745a97f61153940913c22958d7ea3,102,76,2,357,51,51,01026,3
0bcec100614c730eb1716cbb89f98604,54,36,2,189,54,0,01027,1
8dfb9370151def70514e24611cd45a80,109,81,2,381.5,53,56,01013,3
ccf9fbee997e06c35976652725ca5d14,23,21,2,80.5,23,0,01026,1
f16c989e613f8a95bccf4a8432602e99,16,14,3,37.333333333333336,16,0,02651,1
a0215ccc600afae57677c35571e2ef52,18,18,1,126,0,18,08010,1
76d17e7c08767d6b1850664c3efce5ad,3,3,1,21,3,0,09010,1
dcff2df48fca337bff7ee1ac99ce584a,71,71,1,497,71,0,05040,2
b91a4074b128bff9b1b2f3496197b832,17,17,1,119,17,0,08150,1
017efdab151a7d2012c1326f449f10e4,49,37,2,171.5,49,0,05030,1
c9ec477220f04f6db37e4981c2fa8b95,98,77,2,343,98,0,09130,3
5867ab1ef894afcff7c91f7d60aea33e,75,60,2,262.5,75,0,01201,2
a708ce21737a8b5a7da8c1d794c78223,479,183,2,1676.5,246,233,01026,4
620f0b245db46e63e1fd1902eabc9ade,45,31,1,315,45,0,12650,1
a8eb021c156a85851d9ca75cd80bcec7,67,49,2,234.5,67,0,11100,2
89bc709d0204b16171bab715609742d9,66,51,3,154,35,31,08312,2
b56f39f725de4ff72a42133cfd6eb1a8,21,21,1,147,21,0,05040,1
8588e67a8faee6ddeade237387faece1,51,46,3,119,51,0,05030,2
f7cf25a5ee3b1c5f85ee95f15a15d361,39,34,2,136.5,39,0,11040,1
31baaa36669f539c508eae7de55cf1d3,14,14,1,98,14,0,05040,1
67d6d0ef3e4599ce466c859e8a9c0841,27,27,1,189,27,0,10240,1
36ac919baa4844a0eaa1f572d1bc38b8,145,70,2,507.5,69,76,09130,3
45f167949fdcec71f544fa53c4eed914,83,63,3,193.66666666666669,83,0,05040,3
e8ddfe1678a3f126541e4646b86f2854,22,22,1,154,22,0,05041,1
9034eca473b054ad8e99e9f916d2d242,26,20,2,91,26,0,04020,1
4f976081dd69b1480b52dc4a872cfc99,138,98,2,483,70,68,05040,3
e43d60855b21c74c1aaf7aa381c497a5,37,31,2,129.5,37,0,01027,1
fff58701d0b7ebd3c8cc03f76ce66526,12,12,1,84,12,0,01013,1
94a9560edbed895e0e5f0a2071f5f830,15,15,1,105,15,0,05100,1
042901f4a5c1c38e2f71118830d7f7e3,385,115,3,898.3333333333334,271,114,01085,4
400594750adec72eab4dd82d68ac81f5,71,41,3,165.66666666666669,48,23,01013,2
3e949ce23cc8050f1cc4f7bf6b33c77b,8,8,1,56,8,0,08010,1
07075b8eef9b2597c361ed41f83f7e0b,36,32,2,126,36,0,05030,1
166352748ac1109950a34d4c46c7acf4,24,24,1,168,24,0,09090,1
e7e5b74c6479cc5aea7f299acba72579,2,2,1,14,2,0,07141,1
69267bcf77adfc753339ae3668baff17,7,7,1,49,7,0,05030,1
791d4b06400779c9a387feed8e092527,61,26,3,142.33333333333334,38,23,05040,1
f129e10e1ec6d03a6eb4405e82cdc982,52,52,1,364,52,0,05040,1
3e25216fdade3069e1a69040c838fd3b,192,108,3,448,41,151,05040,4
518578806ae2a5e921ea10c009cae185,133,95,3,310.33333333333337,133,0,05040,3
3242e5012b8f710d4632e52048ddd112,50,50,1,350,50,0,03070,1
a2c6eb9ecf2b9943987cbbbf5ebced31,53,48,2,185.5,53,0,07142,1
f8d1ef2b893ea1ed067bf1af036fa60d,19,19,1,133,19,0,13490,1
5aa990eda4fbf489cb419a5b8792557d,45,41,2,157.5,16,29,11080,1
d69b3d06863d302a3414485cc2d56201,80,58,2,280,80,0,10200,2
862cc77ca4d209a7e82cdd3cdeba59e0,161,78,2,563.5,134,27,08010,3
a488326986c639dbaf60b92626155643,36,36,1,252,0,36,01015,1
3f027854b6353772c02cdd86ac3d1140,6,6,2,21,6,0,05040,1
51d3d105d26b9f1767a968597788babd,67,52,2,234.5,67,0,05040,2
4cef6662d169a45e33f10c913f309b12,115,71,3,268.33333333333337,76,39,05041,3
9a5cad0dd1ad9a4990331aea2bc611f4,46,40,2,161,16,30,11040,1
03ad6907d5de06f98c9a6aaa2b862a5e,467,198,3,1089.6666666666667,467,0,05040,4
f21dd7638954f44baf0825085be05c97,53,42,2,185.5,53,0,05040,1
9de841176a193a5710c38ee7923652e5,11,11,1,77,11,0,11180,1
5de8e17be34ee2b11161c3cd6601cd7f,103,66,2,360.5,103,0,03070,3
25e907defb2b35f81abc4e0eba1a3b71,245,127,2,857.5,245,0,05040,4
0709d02686f37acd384362e8c3bf87e6,15,15,1,105,0,15,11040,1
af30d404e282749ccd5f5ad0c8e834c7,26,26,1,182,0,26,05040,1
e697ecadfcccb60c31b2dd385847e296,122,59,3,284.6666666666667,85,37,09130,3
eaed54e87a53039dfb14df41f7ab73be,60,60,1,420,60,0,01027,2
0e81b572b0a6e4547b412b45d60dceb7,201,88,2,703.5,201,0,05040,3
dca06872d2e50cb478f18acc0c7c8eeb,100,62,3,233.33333333333334,64,36,05041,3
f3abf072f613207379a01e60b4ee288c,80,64,2,280,80,0,05100,2
b56a3b8b5f13306e26a0af6eab11b769,273,127,3,637,273,0,01026,4
714c762de94a0357a77f57115767ba0d,99,67,3,231,71,28,01012,3
21ea96117579cef8aa32eb947dce11ee,31,31,1,217,31,0,01012,1
9f070ba202f4d8986d79f7e983bf3e4d,58,47,2,203,44,14,04060,1
fa79196c3c1264ce5d60711adfdbd4d4,79,56,2,276.5,79,0,01012,2
467ef9a0b76d4d96001042830cefab74,22,22,1,154,22,0,04020,1
fea9e38e93f023645cb436cea403553d,14,14,1,98,14,0,11080,1
e57df717b7f9393da2970b13f0ae4db8,35,35,1,245,0,35,10200,1
072591223dd3d537b3936078f88f4068,52,38,1,364,52,0,05030,1
79090705aa00a9507104b3f04dd6fd6f,49,49,1,343,49,0,08052,1
b75dc929562c3241997596425e880762,93,68,1,651,93,0,05030,3
7041a3635a97b1f264031965f7f99d30,394,112,4,689.5,394,0,08452,4
26422f93279e9240258d9b7ceb660e9e,63,54,3,147,63,0,07141,2
1a296d7dbb21f3fd51cb0aaf588dca4b,109,61,3,254.33333333333334,109,0,04201,3
39a491898c41dbe3898a0fbef8bb4d8c,18,18,1,126,18,0,05040,1
9348c282168c11d5330751b51adbd776,124,84,4,217,86,38,02651,3
cb3232f4d184f9d79d51ac1bf7e9c9d5,188,99,3,438.6666666666667,147,41,05040,3
c01689d89de025b477ebd42b0a1470a4,34,34,1,238,34,0,01026,1
f1fef463679008090dca94c61895272b,82,56,3,191.33333333333334,82,0,10220,2
0a1fa669d6cef204687335567afb6ec1,60,60,1,420,60,0,01013,2
f7a30fe50b04a57eaf83dd4910fa2aba,72,45,1,504,72,0,08150,2
092b53d4651c4ea0c5aaf41281a33693,53,36,1,371,53,0,01012,1
0227fed17eead41ff28aa42378e16bd8,18,18,1,126,18,0,01201,1
40ba33710e7850ae2d414d46be9e9919,417,151,4,729.75,383,34,05030,4
436b28e08703b744a88744a66123275f,33,28,2,115.5,10,23,08131,1
3af5c02fcacfcc9562253146db654616,32,32,1,224,0,32,05040,1
86c1c5ffd266b48156a66d43b64e314b,34,34,1,238,34,0,04020,1
f1dee78ce23a6666523b497450a09419,44,44,1,308,44,0,10200,1
bd1b09bcd5f47979c12348e82a17dc63,18,18,1,126,18,0,01012,1
9da3921345e19c0f9d51349f9e16f0dc,38,38,1,266,0,38,01085,1
6eec5b05d5e399fe6033f8e552c30147,52,52,1,364,0,52,05100,1
09ae1183b25f1c43fb2d2d3fbc4ea008,164,102,2,574,164,0,05040,3
0a157acab7e93ddeac94cb9e35f01130,10,10,1,70,10,0,08100,1
e8c27c52eebd75a8458be13e5ec61c71,17,17,1,119,17,0,05030,1
abf4bd1d861a9edd2b4b9ae63b553bad,15,15,1,105,15,0,10200,1
f2238b4d75d61787a3169f24518b33ba,162,81,2,567,162,0,05030,3
7f3f74c438d8ac43997d08e136015f07,23,23,1,161,23,0,09130,1
15cfecd76bf42acc0eecb13811296dc9,29,22,1,203,29,0,03070,1
f6d1a935a71f52df592452b44667af02,541,117,5,757.4,408,133,14301,4
e971b0ad8f90da15c37b65bab4c84d5a,9,6,3,21,9,0,05030,1
984b2ca20d3f4528cfab3e517463906f,39,39,1,273,39,0,01026,1
587e5c62a7ab7d295a7aac25268d79c3,70,63,1,490,70,0,05100,2
988d67978bdfae50ee72ac5860387e5f,35,35,1,245,0,35,01026,1
8c8ffb6461af722045652d2718f1814a,76,65,1,532,76,0,09170,2
fe0b949967fa385df9f1621d1292db58,27,26,2,94.5,27,0,10028,1
4c3405980e94e315cf021fbbba12a4f0,52,52,1,364,52,0,03070,1
35f5bed22dba2e383ed99573b7ac258f,335,89,3,781.6666666666667,311,24,05040,4
5f6347280f191f164ebe3725eab674d1,31,31,1,217,31,0,01027,1
798d92bf753e9f2924e061057eeb9d62,28,28,1,196,28,0,10200,1
8461df50f9496fef276acf89ccae7a28,62,31,2,217,62,0,05030,1
a7c6465c76658eab7d19638904c4fb41,143,104,2,500.5,143,0,08230,3
3b6e683409c5a46e10995084c63cd80c,77,56,2,269.5,77,0,09130,2
5d44797cae4998a269936e5ef906983c,186,113,5,260.4,151,35,05040,4
c42ac73b701c3daba72fdc292e74526e,28,28,1,196,28,0,10200,1
a653960247dc3a6f8f0a589ce24df9e1,40,33,1,280,0,40,10220,1
f529c9f652e97019e87c6eaca01bf353,97,60,3,226.33333333333334,97,0,13820,3
c658221f33fa796189913a66c4b96aa0,214,88,4,374.5,188,26,05040,4
30b770733ea7a3e79e626c8531721e56,153,85,4,267.75,153,0,05040,3
72a386f23fd6ff3711c30312a59e0696,96,67,3,224,96,0,05040,3
78ca6a9a5e403022af7874d17455f96d,52,52,1,364,0,52,05040,1
6ad1aa1fad14d7130ee94d8a8b406b77,31,15,2,108.5,31,0,11040,1
e0984690076dc6f1e7e36469d61079a8,29,29,1,203,0,29,03070,1
decb1883a8159f34b9f54f227012c0b7,85,52,2,297.5,85,0,08132,2
ce765f6430d1335520c6bf00ea189b39,94,84,3,219.33333333333334,94,0,10240,3
a8867edfb6ee88de86e0de32308e6bd3,32,32,1,224,32,0,01026,1
ec9dcc93d700e84e7b65b722ccafa78a,91,62,2,318.5,91,0,03050,3
1ed64d64892741711783e7b23adfb224,52,35,2,182,52,0,09090,1
a1238fcbeb40e26ac04fc7036e151bc3,79,62,2,276.5,31,48,05040,2
57e29d740a80af76ee2a7d4e95d4bd02,8,5,1,56,8,0,10080,1
f7eace16e07e3799bef7b1c29db1d7b3,115,79,2,402.5,115,0,01013,3
e9c1bcc8e45f35cd1f583b8564645b1f,165,102,2,577.5,93,72,04060,3
a51315681f8057ceffabcedb1518c9a8,103,52,4,180.25,103,0,02650,3
e53e9d28c50bddcbb50cd87460869f48,141,72,4,246.75,80,61,05030,3
8b163d5d4ea520a1dc5c072021b1386d,33,33,1,231,33,0,05040,1
7d8cd5820dc8fce1b2d2f1308f64d264,87,74,1,609,0,87,03050,3
9e8bbf45fd4df96e711b1e2519f495a2,40,40,1,280,0,40,01012,1
54fb33a7cba88a772f6a7ff20c3c2130,239,127,4,418.25,239,0,01026,4
d6b9ef50a36f4be3cfa1007ff4b37cce,105,61,3,245,64,41,04060,3
c5ccb5dd00397f2d43509c0f33cae750,34,34,1,238,34,0,01013,1
d38967a88ffdd370ca7d50357ccbecac,219,103,5,306.59999999999997,219,0,05040,4
c51c8eca6115a88d91aa80bd92f96a5a,42,42,1,294,42,0,12500,1
86bf23e4715687ac8f1982def5f9a541,135,120,2,472.5,79,56,03090,3
efc4d87426ef6bc88a85f60d6263711b,106,74,3,247.33333333333334,106,0,02650,3
2c4ce71eb3f39937e8a5b1ed657642e8,39,39,1,273,0,39,10220,1
9812d561c121bae9ace9c0e57d5195fd,174,107,5,243.6,172,2,01012,4
2a9c38e1635a9207c60c8055b75cd64a,12,12,1,84,12,0,12570,1
238a5b0e973053f3a00ca8c04b94f4e2,102,73,2,357,102,0,05100,3
78e2a5e04678d0bd56c4195d0901f9e2,68,47,3,158.66666666666669,28,40,05040,2
a36e3de0613ec7a336267893c7d907d3,194,102,2,679,194,0,05040,4
d83a5472035b8adda4b77f0ee095ed66,37,31,2,129.5,37,0,05040,1
36646d4ccc795cd5002f268ea628d1f1,88,63,2,308,88,0,11040,2
2616f5842c631cc3a2a0a170f87ec019,67,53,3,156.33333333333334,42,25,01201,2
d664b43edd1799aed55ad47284106e17,8,6,1,56,8,0,09190,1
8204d55c98ad7599c0a7221adfc2aff5,21,21,1,147,21,0,09150,1
d28497a0ea0480ec15ce936fb564d0e5,9,9,1,63,9,0,04060,1
fff8df7c5dd582d051e4bb7786da22f5,31,31,1,217,31,0,09010,1
18003ec0de98e228e25ca2ba82cd83c8,48,48,1,336,48,0,09130,1
d8b2b1b7d0f65d2932e0c2a20da899ac,9,9,1,63,9,0,09130,1
76a35292e70bf4fcd783f7fdc807780b,78,59,2,273,78,0,09130,2
30fee9051612df12799435a3c33f2c05,8,8,1,56,8,0,04060,1
826c4327a5d2bad08b05c1f9bea37406,2,2,1,14,2,0,05160,1
d9e8320cabfaa7ce2c8157b6d2a61bdb,69,47,2,241.5,69,0,03050,2
5450658d2cc850792bfee5228b227cae,29,29,1,203,29,0,01026,1
11b68417b5c7bca1268f50f33a1bbda8,54,54,1,378,54,0,08032,1
a94aeb321130ef044fbaaac68efcd60f,90,89,2,315,90,0,10040,3
21b3a13c35311a267b77467f4d0049ce,84,61,3,196,46,38,11080,3
28a23db430618478f5bd773fc1a8e7c5,37,37,1,259,37,0,01012,1
15021c35401216a3e52ff3238a0c1ae8,219,138,2,766.5,151,68,05041,4
81486c5a4f36bb23af8ee6c245bf32dc,4,4,1,28,4,0,10200,1
82fa9128b27a71b8f7f4ac16d6891f34,6,6,1,42,0,6,05100,1
cb156ee7abacdde114ab4ce9fe5d1aa7,8,8,1,56,0,8,02610,1
aea171c96f4b0d96642b213fff63e1c2,22,22,1,154,22,0,05030,1
8269f1089478d585fd565f9fdf8d5899,64,64,1,448,64,0,04032,2
4ed43d781a57bca3b94bb2fea5ce005b,68,50,2,238,68,0,02620,2
6f8b1d987af14f9a3ab432cbfee7e960,35,31,2,122.5,35,0,05030,1
eb80ba2a42c732844667ad7b1f7edfc0,55,55,1,385,55,0,01026,1
805fe6fa055c2a7eac77a76e1fd7ccba,42,42,1,294,42,0,01027,1
d061ab789870e2648ab8b8a229a7917b,128,73,1,896,128,0,02650,3
fd40583705966902605d53813188b91a,50,29,5,70,50,0,11100,2
6aa22d17b7c0e925c486a1b8106dd381,37,28,2,129.5,37,0,05040,1
bca3f12bdc431a2e0487456b047cd45f,120,65,3,280,120,0,03050,3
fd3f1a769cfbcf7af7e4f567dfc35eef,26,14,4,45.5,26,0,11040,1
e7cc2d206a549e2e2ab5230c00ddbc43,106,58,2,371,70,36,11040,3
6f69174d86840588bc3d52dc256d19a0,42,34,2,147,42,0,11040,1
774803b637198d4d1dad9d5c24c72f4c,151,117,1,1057,151,0,10027,4
e2fff76c200d963cd64fe6c2c097be6d,48,48,1,336,48,0,08131,1
0e15bb1264e395f67bd05f354ce1574b,32,32,1,224,32,0,09130,1
9c4c819c59132950636149353b11678a,17,17,1,119,0,17,09010,1
b63dfa2e93c8ad14fba7c906841a6ac2,99,55,4,173.25,78,21,05030,3
32c4041274acd9216161d6531fb845c3,22,22,1,154,22,0,12650,1
cabcb04251dbb9ae8aa750447efdb5ba,270,113,4,472.5,159,111,01026,4
d66b54c1d242b823878cd6e92bb45157,60,39,1,420,60,0,11140,1
20c29cb81a9dabf44d13ab75aae1817a,81,77,1,567,81,0,09130,3
ead587eabfd09552be5658a7592bffc2,160,116,3,373.33333333333337,102,58,05030,3
10e6d3e8016979d5c6d9f50d0ef26676,260,176,4,455,260,0,05040,4
da501c5a670f19d07bb18f363395718c,226,65,4,395.5,193,33,01012,4
ad72b7d793d4ea2b27664501dfc62401,13,8,3,30.333333333333336,10,3,11040,1
274f0e46cfa1b959be32c7f27aec681f,64,48,2,224,64,0,09130,2
985402fe77e94c27cf372cf51d7f282a,21,16,2,73.5,12,9,05040,1
a3e9f10986ad5327ebbb03e26adea652,281,162,5,393.4,202,79,05040,4
670ec73b84edd237dd1442d155cdfdf3,19,19,1,133,19,0,01026,1
09806609edd0ff160d85c8069c9ac575,5,5,1,35,5,0,08135,1
858f322fc4425831f1f8afa5aa137f19,22,22,1,154,22,0,12650,1
e742a4a68bf18223fd2292ba6a097994,73,65,2,255.5,73,0,08314,2
89a707325ec93ee232a72308d6915f1e,241,76,2,843.5,205,36,10200,4
3efa552e9303f05b77b5b17d8317009b,33,19,3,77,22,11,05030,1
1aae2a2968ec847f5d1ffd4e0e2149f2,43,43,1,301,43,0,01012,1
8bff6ff6968d06e46a03879359d70633,132,80,3,308,132,0,05040,3
4811871a97c79a83c490d8879d5006ae,51,44,2,178.5,21,30,09010,1
e40d0c4d74987a8b1a2a04623e4496a0,23,23,1,161,23,0,01012,1
0033f6b64fd807c3ddde4a5b5e3b5f9b,188,109,4,329,151,37,10240,4
7fff4b75f0eb40a6ac5792e17a12635c,97,85,2,339.5,63,34,05040,3
28d0d7a3924f65953cb0952b60c10126,43,32,2,150.5,43,0,01012,1
db402eef441b9eb1c81aeb9a60933ef6,56,56,1,392,56,0,10200,2
e08125550f9554afc4411d8ff8f2b310,83,65,5,116.2,48,35,01027,3
8ccbb0fa1ffb044d0d82945c94236aa3,60,44,2,210,51,9,01016,1
601a040389b29f8aee3485b3d2a9d9c3,8,8,1,56,8,0,05041,1
adfbf796f2059619f53d6a0d243f906d,72,52,2,252,37,35,01026,2
a9dc5624ffd7386604964fa9d8a623f7,80,57,2,280,80,0,01026,2
fab4956b41027960c0ede6829e3457d2,138,66,2,483,117,21,01026,3
67cd73573bb86ae4860fadeb5731fe3d,277,97,4,484.75,200,77,01085,4
a90c81b964ca5c637889fc707bfbba03,11,8,2,38.5,11,0,13820,1
1decbc24636025fbeb965cc73a15739b,39,39,1,273,0,39,11080,1
0725c8a5fa0bbb5922992914310505eb,26,26,1,182,26,0,11100,1
d96805460fdb05aff1c43d29c6f67ee8,39,37,2,136.5,39,0,08032,1
bf242dbc6b762d2ef635c886b6ade06d,27,26,2,94.5,27,0,13830,1
ae11413bdc073e765fa3462daac65837,20,20,1,140,0,20,01027,1
b5ece44f25a119c2daf713884c48cf01,11,11,1,77,11,0,10240,1
604bc1958fc5d7f12627154beaf33f03,122,57,3,284.6666666666667,86,36,04201,3
c2a6a45efac7383a2450f6e3aaebb163,65,38,2,227.5,65,0,05040,1
74aaca3fca0de5013f5f7b99bd4e483d,25,25,1,175,25,0,01027,1
d0258f5e2afbdf787ebc7c23e8eafc21,26,26,1,182,26,0,01201,1
89b6bc20084785ae3b9adb1781a6368d,245,154,2,857.5,245,0,01026,4
751152c05551d2fc5ded84c60d010b11,74,66,2,259,74,0,03070,2
adf0fcd11f024702eae5e09dc61dddc1,38,25,2,133,20,18,12501,1
96ab8cce0e5765545953e2093cbac133,66,41,1,462,66,0,05030,2
f940819d270332d04c015a1567bf067c,182,84,3,424.6666666666667,182,0,05040,3
d9414af33e0d552a72c376fc2ff8e78f,13,12,2,45.5,13,0,04032,1
00212c01b2ec3458680a0edd870d9685,312,122,5,436.8,270,42,05040,4
5bf0753516d241c4dd2ec1fdd8e4fae2,31,31,1,217,31,0,01026,1
fbd6172f8d84ac3141e0fe201f7e837c,16,16,1,112,16,0,02690,1
1829b7fecb9046c8c69c262d80e2078e,149,95,5,208.6,130,19,11100,3
fcaebe352e4bfc9c24dfbced2987051b,58,51,1,406,58,0,12501,1
4a3c762f5a7869c82bbc5cc661034851,14,14,1,98,14,0,05040,1
299a995ce40392ecb6e7977dc9d5bc61,16,16,1,112,16,0,01026,1
e675af3c32efb222498ef1a6e59cf27d,114,66,3,266,78,36,10200,3
af3366d36fabb0e6a50a93243c93e072,81,70,2,283.5,45,36,01012,3
0406aeb0d41eaa0646b6d16e7bd66bc4,37,37,1,259,37,0,04080,1
40ee9af6a51c4620a66d69c52e1564a1,2,1,2,7,1,1,08312,1
d8aabc6e68548a6516740b3019f4c1a5,92,61,3,214.66666666666669,70,22,11140,3
524b4491e314d73fb07f960a060b683c,32,32,1,224,32,0,03070,1
4c47e244d72b3541b4a0d4cfb965275a,36,36,1,252,0,36,05040,1
9f57e1ee079b3e7b63c3fcfee4cc5b16,60,60,1,420,0,60,02651,2
81ca1b6e879e36b67080978748da7627,192,106,4,336,114,78,01013,4
c7cfcffa6f2fd1c1595d5287d6aac94e,53,34,2,185.5,37,16,05040,1
550120f31a6a445ce1dff6f18aa9578e,225,106,4,393.75,225,0,05040,4
06ad80e5c7284fe7763eb50602fd80c1,103,70,2,360.5,103,0,05030,3
9146382b561b0f2a9f896269c2b9833c,190,114,6,221.66666666666669,159,31,05041,4
e945f99a8d71d53135ab3448a4673553,37,34,3,86.33333333333334,37,0,03090,1
601957954868a0028862eb3a5a3e07d4,54,54,1,378,54,0,01026,1
5202b55015448998138a9839d836dd18,39,39,1,273,39,0,01027,1
6c20fb262afe8b9967d31b52a27c5391,80,80,1,560,80,0,03050,3
b2f08860bb19957be8a0968c57f64e79,21,21,1,147,21,0,05030,1
debc8038539ebcd70e0895548d41a5d5,77,44,1,539,77,0,11100,2
ae293664599e9eced2b3258e0b4a675c,46,46,1,322,46,0,08314,1
8336414ac7507d82459b6e5913f9c149,79,46,4,138.25,46,33,04201,3
f920bfab71847038505835e49eb9c6ea,9,9,1,63,9,0,12710,1
3d644b11b687e2d8e4e1f2d412e95297,164,83,4,287,164,0,11080,3
e07784104404b1de63daf4d1a483d921,420,132,4,735,420,0,05100,4
234aa74c1080023ccc5f225fb69ad9d9,232,116,2,812,232,0,01027,4
2ae0744f3a338409452e2467f4b58165,46,46,1,322,0,46,10101,1
34d022617025609209c7af769111e652,212,113,4,371,212,0,05040,4
70aae86612d8545533f0fd61a2b561e6,42,15,4,73.5,42,0,01013,1
ad250e4fffaffecd7138430a89b82cef,53,53,1,371,53,0,10028,1
91595045c7ec44c4e65da93885e61e46,284,143,2,994,284,0,05040,4
756551d371c336758e9194b035728edd,294,126,4,514.5,239,55,01012,4
537dd402da12faa891fb0403c931c7e0,40,40,1,280,40,0,01026,1
b9896ffc52c1a056d4fa9a5886b206b6,99,72,4,173.25,99,0,04201,3
ebe7d029ede543deaa7fb8167b8287e8,26,18,2,91,10,16,09090,1
e94a816171c3119d00c5e102943fbad7,66,50,3,154,54,12,05030,2
1af8b983d2a2d21935bb9561aecaa6d1,169,98,2,591.5,169,0,10200,3
decfb3e160195deaca4503a8fdb1c2ee,32,32,1,224,32,0,01027,1
5b8e5953a331f55b3bcfb0b2cf866848,117,75,3,273,117,0,05040,3
2adec1eb6bf9b83c8d20d1eb43ba311b,101,81,3,235.66666666666669,101,0,01012,3
c01ab8b162c55f9a17cbd6d58c18f599,147,70,3,343,147,0,05040,3
4cc1126960478acda9f56521305a300a,496,187,6,578.6666666666667,433,63,05100,4
35b348e788ae23d0bb8e1352e696a2e8,195,79,4,341.25,195,0,09111,3
dbb58cd59bdfd3469a233692902ddfd1,44,34,2,154,44,0,05030,1
6b6f74acfdd100f884ac827b5060072d,96,43,3,224,96,0,08150,2
bfed6b77f66db4ed0635c2edaadcf633,185,87,5,259,125,60,11180,4
8b03f1dacb662f1ef20880e81b4e48d6,32,32,1,224,32,0,07141,1
c12826803bedaa78c5cdfe9e936409a8,22,22,1,154,22,0,05040,1
11b62ddba1f0da16790140a43522b51e,28,28,1,196,0,28,01201,1
2f7320e30970cb7749295230e054689e,33,24,3,77,33,0,11040,1
367a489787742c5350e324acbb9adcd7,327,123,3,763,327,0,01027,4
d885b02eecdaa06714cd92a1c19650f0,17,17,1,119,0,17,08451,1
0ac02255f7e0131edc8e30576ce4269d,40,27,2,140,20,20,03090,1
22ec24211bf6240f7f8e5f7a2d646d62,175,70,5,245,146,29,01026,3
82a1d08a8f9e90ad923a158293d25013,125,80,3,291.6666666666667,62,63,05100,3
36df007ba6cef547cd070a68e301773b,31,31,1,217,0,31,01085,1
44a841f156446939cd4ad67185c5cb7c,14,14,1,98,14,0,05030,1
216b2aaaf3127a7890cdb0901cf27a64,32,32,1,224,32,0,02650,1
89026172498a159c9f8dafaf2870cfda,169,120,2,591.5,169,0,05041,3
a73d4b9cd884d2bc510ab1e837d4b64f,8,6,2,28,8,0,10028,1
2b763c0e0c2d08f2896b803d469bf3ff,70,57,2,245,70,0,11140,2
f8469cf3b3bc32165c6a29cd23553bc6,151,116,1,1057,151,0,01026,4
b98cafcb1e6aecfb737d7c9396916b65,222,102,3,518,186,36,05040,4
42dac0405f952c128b71d83a16dd032d,43,43,1,301,43,0,01026,1
e5839dc61a3e198b933e9243e8728e56,66,66,1,462,66,0,01026,2
41d3033df7f93036d8f4a854965f1eed,16,16,1,112,16,0,12500,1
aacae01109986040f174ee3b4b0994f0,24,24,1,168,24,0,13490,1
9a2dc18f061315c615a7e54c089b35f0,67,67,1,469,67,0,10200,2
843bb5174dd23bffa9a4fb42d1b2303d,36,36,1,252,36,0,09090,1
bfd32847d04ead9940c5e07f6708fa45,26,26,1,182,26,0,01026,1
f4d2ff80ab2e098adcf1f5f6aaf10aeb,6,6,1,42,6,0,05030,1
23efb6e3ed3157ecda9f0739b6f96baf,25,24,2,87.5,25,0,08100,1
60e015921c6a68bdc01f6bc78a4baa6c,63,54,1,441,63,0,09091,2
2e5c99a3492577ba3f0db49409505357,32,32,1,224,32,0,01085,1
ff58bf54eec1e04a0c8a6dbe8721d573,171,132,2,598.5,171,0,01026,4
68e1392791f7aa017243013cd6a4f4b5,24,19,3,56,24,0,12501,1
836bf5c4a336ef82d7b4161c9c75c187,256,164,6,298.6666666666667,207,49,01012,4
4b424978f3ba61f5934fb50cc914e7d3,112,67,3,261.33333333333337,74,38,10080,3
d89070871461cd08841f93a34c10afab,44,44,1,308,44,0,08010,1
0a6533511aaa519074ad730e6b34b0aa,27,27,1,189,27,0,09130,1
683411961b11d0dac9cafab30bb29948,274,133,3,639.3333333333334,274,0,05040,4
e6871d43ce8354a40da9b69b30ecd9b2,121,64,3,282.33333333333337,121,0,11040,3
4d09f802e3d5325001beccd4c57f4ee9,177,96,3,413,177,0,05040,3
75c754bfc24a34ea0eb969afeec390ef,113,70,2,395.5,113,0,13830,3
55f42f277656f83edf697f8a11c4196d,18,18,1,126,0,18,01013,1
9de8970795912065450e96031af21959,26,26,1,182,0,26,01013,1
16b3a9573bb29a7f7c18035782715c38,37,37,1,259,0,37,03070,1
80bee75251f3ff3d3e2e2d80f6779982,79,47,6,92.16666666666667,54,25,10200,3
d8cf11cfb1167dc8456483144db3c576,30,30,1,210,30,0,08032,1
93173a0a6e46fe993d00ce138804ee13,65,65,1,455,0,65,01013,2
e6bfbbd0f2996ec436ad728be9180eef,12,12,1,84,12,0,01012,1
133ff389e1c52c937e958da477c2bbe7,35,35,1,245,35,0,11100,1
434a0e883d9251e7f155a06493562410,459,195,4,803.25,459,0,01027,4
6bca2b03905c30b77255d6a875d30681,100,73,5,140,70,30,10200,3
3f6334252b4319848d0e2ea4c3c23746,10,10,1,70,10,0,12590,1
3274db8ed0d1af7c52ab7b4f31f6f12a,240,136,2,840,240,0,05040,4
c7c539966bc5daf2dd7f6f712bea2f39,80,80,1,560,80,0,05040,3
44d1e4b438682a4ddc85b819b836b277,117,78,3,273,117,0,08010,3
0c4d6669e1ad681cbfff4f9ab7f4a5bb,12,12,1,84,0,12,10080,1
30cb385b5312e35e751ff01be1fe5324,16,15,2,56,16,0,12670,1
1bdbcabf17c28adaa7d44e3633779c10,44,44,1,308,44,0,09130,1
8679e174fa5a88bad9c3cb68ed2d7e83,13,13,1,91,13,0,03033,1
e57ccfb2d118be0839d39c8fdb78c5ef,123,54,2,430.5,123,0,05040,3
7060125d2a8438147dceefb033448630,155,112,3,361.6666666666667,155,0,01026,3
2f594454c90a78a9d32d10b96ba1dc50,61,44,2,213.5,61,0,11080,1
2c5f4402f63aa17006f2bc9ac428354b,18,18,1,126,18,0,09010,1
e0860b8131c112296dfb23848a18665e,27,27,1,189,27,0,03050,1
bc9ca609fa5ab37aac7c8dd9b1da7831,118,78,2,413,118,0,13820,3
a0fa0bb91069a0a664475eba0fd17ba9,24,24,1,168,0,24,01012,1
e973755448def85f3d42804ccfc6d2f7,93,80,2,325.5,93,0,05100,3
a4d0bb782fb443f6ec5cfd3a00316ed7,188,99,4,329,188,0,05030,4
e2fd4df743d28e1ede195b3660058d8d,68,51,2,238,35,33,01013,2
f015df950ac0638fbce89f31d0beaa48,49,49,1,343,49,0,10200,1
faabf24ad8fa841e247bdeb58e9db846,101,63,3,235.66666666666669,73,28,03090,3
641e8e4af152d748f72f18988a11979f,154,97,3,359.33333333333337,154,0,05040,3
7492a9a52392e4539b341fa2bc21b774,14,10,1,98,14,0,05030,1
6c54db6011f52d3eb419f9239a508b1e,92,64,2,322,92,0,05030,3
deb24176ede0a341ee1363bfa05e2719,400,142,4,700,236,164,04060,4
b160728237dd72edb997fbfaa9f83c5a,54,54,1,378,54,0,05040,1
5efe99c45fad855bfc0d0ecb1caed952,39,37,2,136.5,39,0,01085,1
4ce2d22f61b98cba866ec33f776a5ad1,213,114,3,497,213,0,04032,4
bf0ff7afa7328a647b73d80700144c40,362,150,4,633.5,362,0,01085,4
bdf0ca0f38f21b2cb8682733d9acc185,106,106,1,742,106,0,10200,3
8d48f86b4bcc54aaead5fb3b090f13df,2,2,1,14,0,2,11040,1
3cc31fa472bfcf414ba5f0a592339cf8,34,34,1,238,34,0,09090,1
65490422d90b757c09c64cffab1bf98b,87,59,3,203,87,0,05040,3
a6c9f7572b5cb4647d204757f35b851d,83,77,1,581,83,0,10200,3
8bdb81f724323eeba5a5892a2106c5d0,91,62,3,212.33333333333334,91,0,10200,3
24c44a318ddf0d63049bee7a1223d12e,121,106,2,423.5,121,0,08052,3
d9782dee462bc8aa3864abac7e8bacaf,21,21,1,147,21,0,03070,1
6e15b1fb17670b60f6ff548bb22d9186,51,47,2,178.5,34,17,10200,1
4c7e8e6c47665c4ae1db655e5f858588,11,10,2,38.5,1,10,10120,1
646816d2e788275d01ab3e93aeb3828c,18,18,1,126,18,0,10140,1
ba0fdf2c1f3dce63e965b642ea14e7e9,20,20,1,140,20,0,05100,1
0b25df256647a16049e84f61614eb652,84,63,3,196,56,28,05040,3
58e0fd18b70cfc7033d85129100af4d6,233,103,4,407.75,184,49,05040,4
e2f395cc83b18e529efaff865e6f2ef2,30,30,1,210,30,0,01201,1
6ed9386b6bcb78cf3d07a711fc589ba3,94,55,3,219.33333333333334,94,0,02691,3
8995fad899e52a76266842cd254c6567,46,40,2,161,46,0,10200,1
c38d57bc4b74294fcfdbb67ee6b2b47c,236,93,3,550.6666666666667,236,0,01026,4
daa65336f89efefa49bd48e8973a9c4d,18,18,1,126,18,0,05040,1
b8c09d57e6129b63d8c2fb926c056894,230,81,1,1610,0,230,01026,4
901fd5fa1d69b745f1587c60a3695722,70,50,4,122.5,70,0,01201,2
9411d5eecd45b7233087698001da72bd,64,57,2,224,49,15,01026,2
83c8853f5baf3019b3007e651100ea66,85,53,1,595,85,0,05030,2
9719dc295804be86cb4ff8f1311da19d,9,9,1,63,9,0,13580,1
1077300ff4ac98930ec367a9fef2a1db,53,42,2,185.5,31,22,01012,1
adcc88aa47e817f5cfefe6794e05f3df,41,41,1,287,41,0,01026,1
ce00cdb0c4f78a485b8811d9da3348e1,43,43,1,301,43,0,08390,1
f81904280baa4f0201d49897cd82dbdc,353,194,4,617.75,215,138,05040,4
fee4e5862081039f4d83130c4da145ce,25,25,1,175,25,0,01013,1
eaa5e33ad5ce7c6a6ce2c7671c5d0bf8,233,78,6,271.83333333333337,200,33,08314,4
40597216f778dd772ea519a09cbcf6cd,23,22,2,80.5,16,7,11040,1
e28a323ac95a96e0586e1b5513f78b0a,410,153,6,478.33333333333337,397,13,05040,4
067e487970f9c4b055642fb50fbef107,67,54,1,469,67,0,04020,2
82ce40755467d64f00536d0596dcec46,13,10,2,45.5,13,0,10080,1
5c7460a213426f410c82a1f636a0c559,21,21,1,147,0,21,01016,1
4062e5211f5395aff1a037f735980638,41,41,1,287,41,0,02690,1
09d74c5f9f5cf2a090a192bbe12fee47,14,14,1,98,14,0,09010,1
0ae843e8d2eb5661e65f86a638831b5d,39,39,1,273,39,0,05040,1
47c6e55c23434e6d588b71883d2a90dd,19,19,1,133,19,0,01026,1
49e9929c3daf6d36b83988816870ebfa,36,33,2,126,36,0,04032,1
f3a7799182707db22215454f7448a0f2,15,11,2,52.5,15,0,10080,1
23fdcbf9114999e1366fce099bcfc4ce,29,29,1,203,29,0,09130,1
05736898e2de1a35f50a34246e3993c8,28,23,2,98,28,0,09030,1
e6ee5c6e92a50be18a4c93042a6d157e,242,123,3,564.6666666666667,121,121,01027,4
e19b447c411ca38b2999296912bfe6b3,352,128,6,410.6666666666667,322,30,14250,4
d450fa44e1b743cbe783ad22106521c1,164,80,2,574,164,0,02691,3
6b543d1e7ff71db69fec1a43fa426f32,121,97,3,282.33333333333337,98,23,04020,3
3229e1322724c99bbb9751ed87c0cdb7,35,28,1,245,35,0,01026,1
641c5799ebc901e777120acea22d25c3,173,124,2,605.5,83,90,05100,4
144dfddce56a32584f2e5556b9b1f6de,304,178,3,709.3333333333334,116,188,01012,4
88c74433934fe3f267ce6f337a9a7369,78,73,2,273,78,0,04020,2
55bd5eb47cd4956bc54c5ad8a6e93727,110,64,2,385,110,0,05040,3
04df87e9474e5726c2b635eb49a3f99a,120,69,3,280,120,0,01012,3
ebdd2795bb21e5b27eaa74d72800c76f,76,53,4,133,46,30,01012,3
b20abc891446534e07872d031927c6b2,1,1,1,7,1,0,11040,1
23555a0c0bcf70bd496f2d64ccb05b13,94,64,2,329,94,0,09110,3
52a12faa10fe68b9c73179f1a9e46f9c,67,54,2,234.5,32,35,01026,2
6564c843c4607d3a6a0014beeaf8e095,55,55,1,385,55,0,08100,1
a83dc5a837df2e48be41a123f5fb9df6,28,28,1,196,28,0,01026,1
7d778c62c0f4572302451c55f77220cd,130,71,2,455,58,72,05040,3
970a1cbf48037d0bef9ba10d697aac8b,379,183,2,1326.5,379,0,05041,4
cc975f830725946c19e8f680da8895fd,146,74,3,340.6666666666667,146,0,01013,3
6d9e00033462bbf91c7476ec4e2a2958,138,82,1,966,138,0,11100,3
c431e4c086e58921fb3a8d90c4de846d,189,101,3,441,189,0,02691,3
ac245badd3bb36bd855712f05f432aa6,177,111,3,413,177,0,05040,3
972f7e4879fa8d0d308973422801e0c4,28,28,1,196,28,0,03050,1
aa363c485187c83e24208bbdd6e95638,98,59,3,228.66666666666669,98,0,05100,3
63559f510e6300331ff959003661ca69,35,31,2,122.5,35,0,05030,1
d9c83760297c7acdaf8cd35c5d88c784,37,37,1,259,37,0,02620,1
806a00114317f1f3a3f0cc695e6f073a,29,29,1,203,0,29,01012,1
392cc90afe88c8fdd821407eb5189190,72,51,2,252,72,0,05040,2
f17e47a47fd3385706e28011a7dc49ce,53,47,2,185.5,53,0,05040,1
9e22d6ccda26a5ebb38861bbc5d2b310,32,28,2,112,32,0,05041,1
d3330b1b7f5e7522a421734d935e2445,27,27,1,189,27,0,08100,1
438003a8847dc0c1f6214099c5047ebc,482,108,5,674.8,436,46,01026,4
b5929b42342a1efc5bcddeae9b278df6,44,33,2,154,44,0,13820,1
c349edbe164d5b20e31e373bef7883ca,187,114,2,654.5,187,0,05040,4
45c5fa90ac31a3d2c6db433039f21060,95,53,3,221.66666666666669,67,28,01201,3
7352c20ee810a5c25ad82ac9afca19fb,21,21,1,147,21,0,01013,1
8aeff9d33c982741275f1a9cffa419d9,109,64,2,381.5,109,0,01013,3
13ee9680d5014b90f0868e68d02e1d75,50,41,2,175,17,33,05030,1
89879fda2181b074c3b4b80c2611788d,155,136,3,361.6666666666667,70,85,08110,4
7b5b12fe6211aaa2214cf640b683ca90,7,4,1,49,7,0,05120,1
1852938e6aea070970f1450801b3bfb7,80,66,1,560,0,80,05030,3
8590c27934ff09841fe6283cb8b4e59f,95,57,3,221.66666666666669,95,0,10220,3
4058e3e894488177191f51f306732ede,65,52,2,227.5,65,0,03050,2
ac81abd3a8b9fe9fc16619fa6a8f0ab8,194,140,3,452.6666666666667,114,80,10200,4
cb271824e42dfe1cd33f1c2f3daefb6b,67,45,4,117.25,52,15,10200,2
c542c15eea52e9335d58953f5aed2326,216,142,3,504,216,0,05040,4
7fe256574b8f54fc104c0445ad03e99a,15,15,1,105,15,0,08052,1
9882fe22ea46e57d3c1413b46c4b8741,9,8,2,31.5,9,0,12670,1
67a56de32ec78851e82e4c817b6a91f4,85,59,2,297.5,85,0,05040,2
d035f71d07be9456f8f0c4a0464fb6e1,382,172,6,445.6666666666667,355,27,02650,4
b2c853131498d6c960fb786e630eeea8,45,36,2,157.5,45,0,05180,1
cd848ab7253401948f31b8e7a39fa409,30,30,1,210,30,0,05041,1
ed1d1755a26bb2384acf539009871e48,131,93,3,305.6666666666667,74,57,04020,3
f2d00f9ddfcb9b38964d06dcf3ed8355,68,54,3,158.66666666666669,68,0,10040,2
29998ec981bc90a10cb9aac676b5ba4a,21,21,1,147,21,0,05030,1
7a41e454653c9813b475136b9155985a,155,82,4,271.25,129,26,05030,3
9bb4d4358bc71a3e9f87c2cab5c44ebf,63,63,1,441,63,0,03090,2
46306bef2ce08826107dd22a9577ce92,56,43,1,392,0,56,01012,1
d359c9fdb3b35a37fd49a2e067602adf,66,59,2,231,66,0,10281,2
d68df9bd0c5f742fd9fd336b447a64d4,69,46,3,161,69,0,08010,2
5e6f6714179d5f58a42cf2a4a02e0f55,68,50,2,238,68,0,05040,2
c646b8aa35e62996405905a03ab28412,62,45,3,144.66666666666669,44,18,11040,2
5f89b0bc29e5f1b6501881d7afe06f96,155,99,3,361.6666666666667,155,0,01026,3
118d41e5e9ead304c6f356e67748934f,18,18,1,126,18,0,01016,1
36cdd82ae25bd8798dbe63acde8aa9c9,55,44,2,192.5,55,0,08051,1
a95db56346ee7514d029bcf21bf40e43,56,49,2,196,33,23,05030,1
8616d7c2f109b460e07fb36ed561edda,64,57,2,224,64,0,11100,2
aa9bc7c51c40427319c75f3298d76621,61,61,1,427,61,0,03070,2
ff3dea05ccd64e33016733b979333cee,43,38,2,150.5,43,0,09170,1
3964af9b2b57d1f36c3d3b7dbf9e5b7d,67,58,1,469,67,0,09130,2
13a8bc08f4063dd92d3518b5b26dea34,38,26,3,88.66666666666667,38,0,05030,1
0d2557dcb18a1740c6b6b1cbf8e606b7,19,19,1,133,19,0,10240,1
f1d423c88575edf503e2a6da90c1744f,63,51,1,441,63,0,05040,2
e81471a99823a44a5c718d6b2c2636f7,141,105,2,493.5,141,0,01026,3
ee3e5a432423cfe440e7c4b637f4cbc7,19,19,1,133,19,0,01013,1
b24340f04d1c26a7cb2f41fb2633eafe,258,149,4,451.5,258,0,05100,4
00fec8b424bd9003ee5c6eea0a0c1a54,46,41,2,161,46,0,05040,1
dfcde96af4e7767669bf7845d681b939,65,38,2,227.5,65,0,11180,1
ab10418227dd7fe312ff17b9e549f087,64,44,2,224,33,31,10240,2
93ce5409610e649a1ff7db96ff2dd85e,52,52,1,364,52,0,05040,1
f3572f198cecdf330ac1775dfca7cd2c,100,62,3,233.33333333333334,100,0,05040,3
e9780dbe1fff2b8ba5cb128d3e507c9f,25,18,2,87.5,13,12,12710,1
a80f8669be3da58be9d62a59ccfcc8ee,49,43,2,171.5,26,23,11080,1
b38c2f36e3ba90fa98fdcd3d8d9cb706,162,93,4,283.5,162,0,01013,3
a5f6b72a2e2aaf6393f18da06b1fb12c,11,11,1,77,11,0,04200,1
740b69637cd863bebcbbef263c07d4af,99,69,3,231,99,0,01013,3
c0a668fdea97b691436c6aa0ad6f9bf9,151,92,3,352.33333333333337,112,39,01013,3
c0a7dff6a89b4f6800ecc58853fc4ddd,112,73,2,392,112,0,05040,3
c63981b3cd211b10cf5ca2f05b801dab,282,124,1,1974,282,0,11100,4
520db667217d96feb03255f635f07f5a,163,89,3,380.33333333333337,163,0,05040,3
09ff8333a9360e7918ce8e283dbf2a24,26,26,1,182,26,0,01012,1
4e8f4ded17629a40d851e09318456658,13,13,1,91,0,13,03050,1
3c22673f984a23c551801cb38c4f21cb,57,39,2,199.5,57,0,05040,1
a2ef174a436bec27b02c10402aa6c049,27,27,1,189,27,0,09112,1
3593c55876be11dfc1199c33fc677945,27,27,1,189,27,0,03090,1
1c4504637988856f80edd5926f06345a,22,22,1,154,22,0,05040,1
fabf10f7077c22f72e4ca4dcf677d3a2,245,157,5,343,206,39,01026,4
e0a74f474850d7acb6f772d43ce42759,121,94,2,423.5,121,0,05040,3
f90632d396055b473ee1fd372633127d,14,9,3,32.66666666666667,8,6,05100,1
82b63908a34d4675f60ec8cdcdf574c6,50,37,3,116.66666666666667,41,9,01012,1
f5e61ff190a4877479a1b66fc5cf0b62,114,72,3,266,114,0,05040,3
7fe687b2ff96a770cd8f5a4cb042c6c7,211,131,2,738.5,211,0,01026,4
8f922e3227c18bd913c854be018f84c8,23,22,2,80.5,1,22,03050,1
f0cbd16298c6028a88098c659b9c01c6,30,11,3,70,30,0,01027,1
e3cc662abccaefa2cf0a611e08ead870,88,72,3,205.33333333333334,68,20,01201,3
30c30542cbd9538595c315a8d8cfe618,111,86,2,388.5,111,0,05040,3
dc4d1bfeeb69a82b13248940b06115a4,21,17,2,73.5,21,0,05030,1
b5f6c1335986bebffdc98c0fc55c9e44,57,57,1,399,57,0,01026,2
dc1f2d8bb5bd25c68afff9a9c0c9d349,227,104,2,794.5,141,86,05040,4
169d05044cb14923b185166ae0117d1e,52,52,1,364,52,0,09130,1
72ae4728943d7efb13a890f9ea1e5133,25,25,1,175,0,25,01012,1
70f22c1ec761295ed1a36dcf635719c1,25,25,1,175,25,0,05030,1
90ea544531429f0afff664e6b96bd634,42,42,1,294,42,0,10028,1
3e2e09bd92f624bd0723ccc729325c9a,84,55,3,196,55,29,05040,3
e4fe1dee36c7d4618fc56a41ae5899fa,35,35,1,245,35,0,05041,1
0665ecf973f28712c9c30bac640422f7,126,90,4,220.5,88,38,05040,3
5b9e9497703d766016bb1c289505c505,36,25,2,126,36,0,03050,1
7499d20cc74209bc45207fbe1043d30a,82,64,2,287,82,0,04060,2
9133b7566e40bdcb6d9f636bf392b03e,153,116,2,535.5,103,50,01012,3
b29da0fe9f37906ca323f86a278fb1b2,10,8,1,70,10,0,05030,1
621900a518735c4232bcf906026b9d80,12,12,1,84,12,0,01201,1
71ff31a45bddd9a631c33eb2deb6d460,124,72,2,434,124,0,05040,3
f0e0ac89241628215cab7626d314ae52,75,55,2,262.5,75,0,02750,2
6b22aef58f8efb4837845f3b396ff8d9,28,28,1,196,28,0,05040,1
b3c06309661787602bf8c68303b0ef97,120,84,3,280,120,0,02691,3
06c342a8bc9ee5169f5b62572fd61a48,354,159,4,619.5,254,100,01026,4
721ccb8b5f006e592b6a1e2854a1d52b,36,24,2,126,36,0,11182,1
92ce233a8393c6ab671aead6eba4b85e,239,80,2,836.5,108,131,05040,4
9c251805d6a3480dca68f636552336b9,31,31,1,217,0,31,10220,1
5755b028301b006231a0f01665e56368,14,14,1,98,14,0,12470,1
d68d38eca8e971f8ce79b35ba64b51a7,11,11,1,77,0,11,05030,1
129ddf481c5d54ef7902487677507670,116,51,3,270.6666666666667,116,0,11040,3
b7d546281b49e1f3bd5b39c4459e009e,58,42,1,406,0,58,11040,1
ab7ff75174cbe0378a1c4a0a56646032,95,48,3,221.66666666666669,95,0,02751,3
9de45f9d7d07ef3391bb8c6dda104fa4,195,129,1,1365,195,0,01201,4
fbdc7499c0eb6e73ae8d0c070500e1cf,64,53,1,448,64,0,11080,2
9284edc3519af9f00d39162aa149296e,81,81,1,567,81,0,10200,3
512bb6d3a7055b6989b3e2e648c3115c,196,110,2,686,196,0,01027,4
200294024bfc9b3d887ddf3cbd1def15,74,54,2,259,34,40,10200,2
dacf2e6df4edf6aa3f81e3f1a5143c40,81,54,3,189,81,0,02756,2
0ab28cf8a03ec6a11af61c0b05856253,14,14,1,98,14,0,01201,1
5584b0fdd0d46747748aec591dcb164b,254,95,5,355.59999999999997,225,29,11040,4
b80fdc867ccef4994ae31c190a2b7284,80,66,2,280,80,0,05040,2
8b0f2d9c2bc64e34598ba0d0b9bb4cc4,25,25,1,175,25,0,05040,1
2ee442768bdd7f6751a942586297c188,46,28,3,107.33333333333334,46,0,01012,1
ced46d9000d36255e4d7445f6bfe43bd,11,11,1,77,11,0,09130,1
cc335d2f7ddeb6d7817a7e6487369642,22,22,1,154,22,0,01201,1
1a5f44fffe944f2465a57268e65ead90,16,8,2,56,8,8,11100,1
25971a4b9c52c868aa5da8dc1563f57e,20,20,1,140,20,0,02650,1
859af484d8c2f7649c2d04c455c890d8,99,41,3,231,99,0,12650,3
a373fb9a569759ec141c4757510bb43f,24,24,1,168,24,0,01013,1
8687e43e728eaf6a7d4de10b35f4d4a8,34,34,1,238,34,0,12710,1
189fbbb610936d780f5c166c51fa95c1,20,20,1,140,0,20,02750,1
990bd66aeb526d774eb3a1bcbaf6318b,13,13,1,91,13,0,11100,1
50a732c04166eba0069815774127757c,32,28,2,112,17,15,11100,1
74d8bc77378fd597afca9c5c7cb993dc,3,3,1,21,3,0,11040,1
c1af9fdb4a35788d0c7df0c360918738,193,99,4,337.75,158,35,09130,4
7bbc40d591ae89562c8b53ed6289c671,149,97,2,521.5,149,0,05030,3
8290f0182dbabf248fdd4764c2fcd27c,27,27,1,189,27,0,05040,1
91e1ee25e8ed78388a7589067d7037d3,25,24,2,87.5,25,0,09130,1
89649f52078878d49c14585ab168338b,28,28,1,196,28,0,08390,1
f412ccfa00468b7bf29139d251f5ea06,235,87,5,329,172,63,05040,4
355e5e5d76465533c9991a432bfb21b1,244,167,4,427,244,0,05040,4
8574ccc40a9f74f76f467a46d85549be,174,105,4,304.5,174,0,10200,3
aa5222c605a06195083de32353487942,173,140,2,605.5,18,155,01026,4
35cdbc32c4af0fdedb72016b239284e4,20,20,1,140,20,0,09130,1
80717894ef5496fe208fedd3a7cb095a,36,36,1,252,0,36,05040,1
1bdbbe8d97edd92047124a38db4c5133,261,122,1,1827,0,261,08051,4
775a1a82d007eae9dd2e7915b6f7cc0e,116,86,3,270.6666666666667,116,0,08314,3
c37352b24acd288dd9137d718d9adcb6,48,48,1,336,48,0,13877,1
6e352dc43bdcff1cc161c7874ad48194,46,46,1,322,46,0,08452,1
060819df60e280c0bb92c4a852b224b8,6,6,1,42,0,6,05040,1
c083a4027f6b6f7af09c0e04625f6e06,20,20,1,140,20,0,05030,1
c8f3c26fa8becb12b24237507837e3cb,156,90,3,364,156,0,01012,3
b785b5b8c2411e5f2d421e644f6d25f3,248,110,3,578.6666666666667,142,106,05040,4
84b0e5c16747257e23a3297367acef30,609,207,2,2131.5,609,0,04060,4
3c6b2c41aca9a2d726334e8ff1f63146,17,17,1,119,17,0,11140,1
6aa588b6cae2e017046a5c44dc28c4f9,3,3,1,21,3,0,04200,1
8904bd186d2ac8942be22e3c9d4c8f39,174,86,5,243.6,154,20,01012,3
a1d4b9fea1ee5928fa2e68f373f3dd6b,59,33,2,206.5,59,0,08230,1
1e181e4d5712f92e8c92768e2305e01a,68,54,2,238,68,0,05040,2
0f5ef0784198a2f8958013cf708ddfc7,436,152,6,508.6666666666667,402,34,05040,4
83c8063b320efbb63d426782f62d673f,25,25,1,175,0,25,10200,1
c609f55489adf2e6120f5eb5f2099468,285,119,6,332.5,259,26,10200,4
61125b1a6c68d9bfab3d251a4dea4824,23,10,3,53.66666666666667,23,0,10080,1
73fe3dec6b5e85a6777bf51c9ec03a02,18,18,1,126,18,0,04201,1
e01718616a726cee5ed21d8a806dbaf8,58,39,4,101.5,36,22,01027,2
6fb75ff2fa4a3b5af480e635ea0a6a62,31,31,1,217,31,0,03070,1
b24a2ed076d7e68d8c1639dfe4285020,120,87,3,280,120,0,01026,3
4ac50e0a57857650c7e1d04b07e48d75,45,45,1,315,45,0,01012,1
9a6da8394af347e58672fbfcff96e38a,68,38,2,238,68,0,09090,1
3748f394f4116ce617d923dc5a1e854c,107,66,2,374.5,107,0,05030,3
259d3a3e5f8da1b0561d008cedca595a,56,55,2,196,56,0,01026,1
bf46ed17bd7054baf349d4f56afc3f7a,21,21,1,147,21,0,10200,1
739323b6f29ca7d03bbd4114994a9782,32,32,1,224,32,0,12410,1
b2555ebaab50466b02c8749010d9f74c,11,11,1,77,0,11,05030,1
fbe2f4e51b6073a7a7b86274c734ab63,84,58,2,294,84,0,10200,2
9b272ed96ae377dd81ee422df7a7bdeb,215,124,3,501.6666666666667,215,0,05040,4
9bb7f8f4565c6074b47f2fea70282fe7,96,68,1,672,96,0,01016,3
0f94b9695e681f5b3bbb8ce1540aff99,18,18,1,126,18,0,12410,1
4fcfae77204f201672ecfd5e72207146,66,45,1,462,0,66,01026,2
994929df138b03e7cb8f533df20c7767,21,21,1,147,21,0,01027,1
251415dfafce8d62fc81e91860572221,193,34,2,675.5,193,0,09030,3
dae78b03a0c7958916c937c8e2d1ad37,155,103,3,361.6666666666667,76,79,10200,3
56030cd6ca3b6346e89622fe31bb784c,123,89,2,430.5,37,86,05040,3
ec7e689c04bfd3bcddabf82d0c1b8f01,101,74,2,353.5,101,0,01012,3
8ea1a46cf1984254b03254ea06385ba5,138,120,2,483,55,83,01012,3
21388829c373444202c17097e5aab25b,52,44,1,364,0,52,01012,1
5a7310084dacf71ba0737bf5ff650a7d,29,29,1,203,29,0,09130,1
3ee9e06fb33930924df9a0631c362681,13,13,1,91,13,0,03050,1
ed21429d0006e88f6bab3cea805df2d2,119,67,4,208.25,91,28,01012,3
eb572bc830f00032ac7fdd9105bf1459,41,41,1,287,41,0,05040,1
9d94e2108e0ec0f640f2335076443d13,45,36,2,157.5,45,0,11100,1
10760eb40affdeee0a000298876d0786,457,100,2,1599.5,457,0,05040,4
83de327fc9920e3c1400d6530ac2104e,16,16,1,112,16,0,09170,1
69d790ee3094d74511d3d7684d6c7232,172,97,3,401.33333333333337,143,29,01013,3
888323da4fe45fe8a953a0f616d6dadc,18,18,1,126,18,0,01026,1
6277adf1b185eb6d3647c5e012ae4465,78,62,2,273,35,43,02754,2
1a645af4cb2980606b52cdfd252c5743,8,6,1,56,8,0,12501,1
6a973f2070bd3ca26c8ddb42134c39c2,6,6,1,42,6,0,02650,1
62880a93926e81dc52bfd7852f140295,43,39,2,150.5,43,0,09091,1
04942679c1134a40cbb5d885dc902b47,279,106,4,488.25,189,90,11140,4
be4c796ced63d3d4191154c559912b11,122,79,3,284.6666666666667,122,0,05040,3
dfc5b2090de73b212272bbf8dd95796b,4,4,1,28,4,0,12590,1
016461a2eb3ed80039cc549f0a68e9f7,61,48,1,427,61,0,05041,2
8a73bd0cd559b7e4e78548ed493a4a7c,29,29,1,203,29,0,01027,1
878ac592c98327505333bc75319337b7,33,21,2,115.5,33,0,08135,1
91d0db6338b0e7d330a2ecff896a018a,58,36,2,203,58,0,09090,1
49d7e6a3a36633a898959bcf59730463,288,134,4,504,204,84,01026,4
2af7819f9c66f491fd94b29308b25d14,78,66,3,182,78,0,05040,3
cb1cb0e6d860c19c8786063a1785ed96,30,30,1,210,30,0,08250,1
ac00a5a61c871ea2aff1f541bf9891a0,97,78,3,226.33333333333334,97,0,04020,3
d5aa5bb805b13dfd95ee7f6ec8b4a47c,22,22,1,154,22,0,11060,1
61c0fed13b316b5714c8647bd51b30dd,22,22,1,154,0,22,01012,1
a768ac6617d953c09a10913586349766,60,39,2,210,60,0,05040,1
9eed4cf0929fa8fe17f2d7996030cbe0,136,106,4,238,136,0,01085,3
f8b3fd877b8dee3e2807bfb49ef39f7c,12,12,1,84,12,0,01012,1
cec71df24adedfb7cceb1dac10d7cf36,58,58,1,406,58,0,11100,2
3e6d8a6d5ebeb9f250cedd6ef440e344,70,70,1,490,70,0,10200,2
4b087c842a854ffc471c9954d281b2ce,111,79,2,388.5,111,0,04060,3
ea814041e0cfc8fae1af8e32bf4c3b24,159,57,2,556.5,50,109,05040,3
36887576b0b38be7ce6425af8797e571,77,57,2,269.5,39,38,01012,2
6fd7ee222bb569f4fc651cd61a48e6fc,169,68,3,394.33333333333337,169,0,11040,3
4e04b824db13fe9a9b2f758ed2439f25,58,44,4,101.5,57,1,10200,2
d10f3efd1a795d4de8505d31c06babde,36,34,2,126,36,0,01026,1
9411a16d57a607c166c7813c3a4fb05a,60,43,3,140,60,0,11100,2
65af3a83ced6fea3cb2b2e5f18fd0744,31,31,1,217,31,0,01027,1
e2bcfb16926efac974e8157c16b8b463,609,141,5,852.6,609,0,12670,4
1b78ebf143ac440d18435c15dd2e53f7,161,107,3,375.6666666666667,108,53,01026,3
de623f04b73b80d38b0c5b88a22f335a,44,30,3,102.66666666666667,24,20,02690,1
9caa96a6fe9ba10881b15eeb30720ef2,23,23,1,161,23,0,10200,1
20f3f7b8c90da819f988bee0fe262760,11,11,1,77,11,0,08314,1
9c2384d5e64d92879f6795877e0e02f2,63,56,2,220.5,48,15,10200,2
02b67673cc4adfa24b2a834c660e821d,20,20,1,140,20,0,12590,1
178aceae16e5d1f7c6c04053dc1e388f,101,62,3,235.66666666666669,101,0,10101,3
6009a470d619683918b7fc622217dbbe,60,60,1,420,60,0,01027,2
4af6376656c671984e9f0e4184cfeb4b,297,131,4,519.75,297,0,05040,4
34d0322123fe02471544c32dfe403c46,202,142,2,707,53,149,05040,4
b5a5477f7f1738ad922de3f919033235,62,41,2,217,30,32,08230,1
bb216a9c70d87ae525311648867651f6,37,37,1,259,37,0,01026,1
9dfbc22c5e4dfc629492eeda0d4d17f5,94,54,2,329,94,0,05030,2
7d8326e386f020c08beac30479f5795f,158,93,3,368.6666666666667,158,0,10200,3
220a28b36a12426e10da80be85d95011,45,45,1,315,45,0,05100,1
79a1a12cb5ba34d708f412f08c95e4e4,38,38,2,133,23,15,01026,1
1578a8566e8b10f76a16a27d2ea673db,135,76,3,315,135,0,01013,3
428d8ea487099a5df3b1d8e97f61c3c1,431,157,5,603.4,405,26,01026,4
656ba68d8bc78fc3ef571aea64e9c926,53,53,1,371,53,0,10240,1
cc900311cdc093fced378e44a2d6d6ad,35,33,2,122.5,35,0,10028,1
18220cb5da6c7578fd939ac58d9a44b3,24,24,1,168,24,0,08010,1
25d730966d7f9b290813be81fc6fcba6,355,95,4,621.25,327,28,05100,4
2c4d0dc5db430aad4b06c4ed7fa66fc1,150,75,3,350,150,0,05040,3
fb41670a135f1c1689bf293ddcadbd05,70,62,1,490,70,0,01026,2
071c64f49d9c881cfaa94ec3adbc373a,41,37,1,287,41,0,09010,1
f38e85d0eb96b6d3cb714e8a4fe1000d,34,27,2,119,27,7,01012,1
8f7cd62d3709fd72938b603f4fb7e0ae,113,84,2,395.5,113,0,05041,3
02548ceef5d9eaca7455c99667aa1bb4,57,49,2,199.5,30,27,01013,1
e28f85f0d981b05d959f8e213607d568,38,33,2,133,38,0,10152,1
2259d803d41c069666be318b4551c81a,283,114,2,990.5,196,87,01026,4
2a9b0f351e1e5e6acb90fb92899aa7cd,45,29,2,157.5,45,0,10080,1
f09b1374c732e2cdf1a285261b405ff1,163,72,2,570.5,163,0,05040,3
6faa2d9f8c998f60fa086a9227f7bb57,36,33,2,126,10,26,11100,1
482308083310961627aac57b20f9e33d,95,84,2,332.5,52,43,01026,3
50038fe5cb777c716afd97cc6b748b63,69,53,2,241.5,69,0,10220,2
7b84595c323d42931549ea082ba33ea8,16,16,1,112,16,0,03033,1
4506d2547dc9dc29c30bfcf51a1ff0ac,37,31,1,259,37,0,10200,1
acc6cd73a84067d04192b79c0f2974ff,16,16,1,112,16,0,05040,1
69c8a636dc1194781cdd07b88469fd99,139,81,1,973,139,0,05030,3
2d3c8c8405bf0839502dd760e326349a,44,37,2,154,44,0,01013,1
58b70de9896d80745385c54269a7a78b,45,41,2,157.5,29,16,06100,1
39f4c7337aeb0d56c2d58396406d4f54,348,180,6,406,233,115,01026,4
6774ae92629fdaa7ccd188988f5b21ec,48,48,1,336,0,48,10200,1
e06004990a4ce0ee1846a2f8e019726d,31,30,2,108.5,31,0,01085,1
00e84ba77f3674f02d3a9cc4ff16df0e,36,35,2,126,36,0,12570,1
6a3f24cab1b2f0a4f026d0e97683be18,127,103,2,444.5,127,0,05040,3
8f68362ba7f7a2a953481770fd15a53a,20,20,1,140,20,0,01012,1
3b50f2639479301ecfa0c08f1b929205,18,18,1,126,18,0,05040,1
33a291bed5078f0db918d320207b2985,41,21,4,71.75,34,7,12500,1
4261e52fb78c3eda23475282f3b10339,523,128,3,1220.3333333333335,490,33,05040,4
82a32da00c0b52caf9440b0ce8034c8d,202,121,4,353.5,202,0,01026,4
297094f0349dd9a212992a9ae5727c0c,19,19,1,133,19,0,01026,1
f81a43037adaa061eec453de7f2c2996,112,64,2,392,112,0,10200,3
f2280d083a2f4e6244fef6c508d51def,28,28,1,196,28,0,08312,1
db976ee97c3b112e9707637de6a162a8,185,108,4,323.75,185,0,04020,4
f8e3feb6788016cb54835e83dac64e73,36,29,1,252,0,36,05040,1
0deb7fe7bafd6d94707dd9943f45858e,23,13,3,53.66666666666667,18,5,11100,1
ed01fb4419faa3a0704a465941e213b0,22,22,2,77,2,20,09010,1
c91e685dd4f4a32455f7d306f5637568,34,34,1,238,34,0,09030,1
1ad0a6a16b54c6582e5f6ae213066c30,90,68,4,157.5,80,10,05030,3
a191e9c3130487bf2702b125f1dc8206,19,16,3,44.333333333333336,19,0,10200,1
cbc4a528d4f9e2031fd75cd84a4ebefb,37,34,2,129.5,37,0,07131,1
61841ad849fd0218508361577255b40f,16,16,1,112,16,0,08100,1
84e075c15c090fc8de3e8fd1e66ea124,37,37,1,259,37,0,09090,1
f08808c2cf55e8d73076ce4278c9a423,88,71,1,616,88,0,01027,3
9a4390c5554c99ed7170d97a481c003c,108,81,2,378,41,67,10240,3
638851ed0516907cc1e372e40cff340e,172,124,3,401.33333333333337,172,0,05040,3
c6f078b69b89d4412da02f092ca4466d,420,93,5,588,420,0,01026,4
66fecd47e044aa7505973a1318c2b16a,103,80,3,240.33333333333334,66,37,08314,3
7498198975932b0f031ebe5a03aaabab,34,34,1,238,0,34,01027,1
9bb62426e9600c5dc3c924ff67d784ec,49,49,1,343,49,0,01026,1
69ff328cf52442e99b0e2e2ff194a8c7,53,53,1,371,53,0,01026,1
36006117cb2713a1bfe69006fb583f4a,41,41,1,287,41,0,05040,1
84b5ab95f3a0a58b4b3318a9177004b2,41,23,3,95.66666666666667,28,13,09010,1
39e640d8f0df7487814af75818f21f2d,14,14,1,98,14,0,05040,1
275f6f57a490ccf77dd47bf789ca6424,7,7,1,49,7,0,09130,1
f7ec1827dfd77df25a9012368809e98b,157,105,2,549.5,157,0,01026,3
9c4ef8fdb1458ca143d2367a5ebeee6c,182,94,4,318.5,182,0,01013,3
ec23e7ddbb8044906fdaf795c8a934ba,23,22,2,80.5,23,0,05030,1
9572467bd1de7800578cf3ad07df40e8,33,33,1,231,33,0,05040,1
5d4f046a921452d1d7dfbf30777a7f51,35,35,1,245,35,0,01013,1
0230dcbdb6e7d3a49dcc8a3b9d209678,37,37,1,259,0,37,01026,1
ccb3db94a804e8c43269d29f85cb3df0,143,76,4,250.25,124,19,08051,3
58e01e2b8b9c4d831bc8ed89ad4be644,81,75,2,283.5,81,0,09130,3
ee522769d7586079c1fae62f60192aca,138,57,6,161,97,41,05040,3
ca6fd521c2ab8b5364c67cc637756750,16,16,1,112,16,0,05040,1
bad5997d45eec1c7b037b3053702f8d4,129,53,6,150.5,111,18,11080,3
e9df4763a8866f48e2dd12b556dd900f,56,28,3,130.66666666666669,56,0,10080,1
587b445ca81528e74a907c15ccfbf08e,438,103,6,511,353,85,10200,4
cd04a929cbd9e906ab5edde1a7ed96e4,109,80,2,381.5,109,0,02751,3
92b1c87d48f36999c97f2b2172242c2a,204,106,2,714,204,0,03070,4
a8d137b5f09324e01b330a79b3062bff,129,92,1,903,129,0,05030,3
1ea7d38dc946491f2e859f56ec685373,40,24,3,93.33333333333334,40,0,01012,1
e988eb211377c67ad7ec64d2d8e32791,58,49,2,203,58,0,05040,1
51a576423a1c29399a3831bd6657a4a5,36,26,1,252,36,0,01012,1
8151066bef741040d11c113283f23a9b,80,39,2,280,53,27,04060,2
d876c1a45a88e5b7097591d57c6f27ea,35,35,1,245,35,0,03070,1
179a8e1b5a4c21ccf68021e8aa88cab2,110,73,3,256.6666666666667,110,0,10080,3
2d336a39cfe980017fc9b5384f83f682,169,82,3,394.33333333333337,169,0,05030,3
0be1c5407398568554d9c7df2ff574ab,33,33,1,231,0,33,10200,1
72cd80a1b055871bdb0ed5c8a29ba9d0,133,85,4,232.75,133,0,05100,3
e4a7a532770ca46cb5c72e28cad6af7b,46,37,3,107.33333333333334,46,0,05030,1
bdb5ed668099f337908c5f485889a185,64,64,1,448,64,0,01026,2
4af9f666814e97bd11b1bc1f3ee2ce53,156,88,3,364,47,109,05030,3
39bcb98595c4a84f36968f6e83956f05,254,128,4,444.5,181,73,05040,4
5c6575d89ef01489ea26ec24a956c61f,69,59,2,241.5,69,0,01027,2
20c8e334d74f76bdf21616bcb5e2bc80,33,30,2,115.5,33,0,05030,1
50318b96630caac52b5610ec88257a6e,12,12,1,84,12,0,08090,1
f667c0089996705dc51313ba0af8e638,24,16,3,56,14,10,01027,1
9c4d5cae40223e6d6cc4e7b761506942,150,113,2,525,150,0,05040,3
6ce11d60227099eeb9791f81d8a5e935,17,13,1,119,17,0,08452,1
b34b4e8288457a5f3f4760c03585b2db,323,140,3,753.6666666666667,323,0,01012,4
d53da382cd2c2d7bddb93ff939b07f72,17,17,1,119,17,0,05100,1
b62246a7c87b17cbcaa1ac66764aba34,242,99,4,423.5,225,17,08170,4
3fb4777bf841b6033809f995e954f78f,18,7,5,25.2,14,4,11100,1
7a7a95a6e7c52a272e243975693c174c,117,69,2,409.5,81,36,01085,3
5d611bad2af32a3b7705e6eff3fababd,83,65,2,290.5,52,31,01012,2
d701b2e67bbaea82b295fd93b67f9cf3,428,144,5,599.1999999999999,428,0,04201,4
9dad30cf288e067326b4b60ee66dba25,377,82,1,2639,377,0,10028,4
e218b861b3f3b2b743f5c8a547ab10d0,5,5,1,35,5,0,05030,1
0b63d77404eaa0737c12a75b904c6260,3,3,1,21,3,0,11140,1
861fef500dd9905e1d7bcc8e2e8524e7,38,30,1,266,38,0,11140,1
ef54f7a969486f6a1dd84b241231de30,235,136,4,411.25,163,72,05040,4
9abfc9fa1d90e4898ec0f56c3adca8ad,190,91,2,665,190,0,01026,3
54faa3491f479498a1d5c7a390966b50,20,20,1,140,20,0,09010,1
0b9ca379438db4c4d3664650ec9a5a3e,56,46,1,392,0,56,13953,1
90aa21b3d5a8a629abec27db114a9412,51,51,1,357,51,0,05040,1
471cc2b0c7df8bf24e297337a6ff0035,232,91,4,406,172,60,05040,4
b790729b178606ba45d242fa5c240581,66,55,2,231,34,32,05040,2
d896ea0173de51ad8aca9c6161e9499d,123,80,2,430.5,123,0,01012,3
b5a036ef0588e9a6996d3b97a8a542b1,45,45,1,315,45,0,10200,1
e32538b34fd9cdff28159a6ec5be2087,203,85,3,473.6666666666667,203,0,05040,3
67cc51d2469d036d083342c118c3e8df,25,25,1,175,25,0,09130,1
960597d4f43f9cebd9fdb1bb52d8314d,41,41,1,287,0,41,01026,1
7bb6705302024b0b0f439c669470771b,241,145,3,562.3333333333334,241,0,01027,4
643dfc684e182cc838dd996c84c86bf2,358,149,4,626.5,321,37,01027,4
4ad5e3ae49275da8787d5478f76983df,131,105,5,183.4,120,11,10200,3
b0b4b9826cce99bee6d0279a747c44f2,129,97,2,451.5,129,0,10200,3
da80ea30500ccfa7531e7da7d6231744,22,22,1,154,22,0,09130,1
a75e3caefe9f2d0453cafcd6f11473d8,49,49,1,343,49,0,01012,1
ff230a5192f572ec8aff19c9eecb0bdd,49,49,1,343,49,0,05100,1
28571b1e0a1b1d17d784aae3fc86d9a7,58,44,2,203,58,0,05030,1
7ccea4b9904274dcd3c94fe5d3f3508f,30,30,1,210,30,0,05200,1
cf417575f1623efcd156553adfa74575,212,131,2,742,212,0,08314,4
e82e360c2c79fa0b9c121313a49245a0,3,3,1,21,3,0,01026,1
41ba13ae3919c15952c39b7134361c3c,73,42,2,255.5,24,49,08031,2
db56cb19d08e1efa61984ac884f0451a,27,27,1,189,27,0,05040,1
2ffe91d4ff8de9d45b4c0689c0f0d190,25,25,1,175,0,25,05040,1
704b5adaef259f4ddc3a8c83bb6d26a9,24,24,1,168,24,0,12410,1
2dcec0dfe0791159921c6596dfc41979,21,21,1,147,21,0,04201,1
c323df9975f3c7566f31b4b9127af01f,47,47,1,329,0,47,12590,1
291237b86d37104b4769054b4be54100,40,40,1,280,40,0,04032,1
7c86b8709dec176e1200926886be46dc,231,100,4,404.25,217,14,01026,4
bcd6617ea3d7446c1c1f5f7d8f484157,81,47,1,567,81,0,05041,2
09ef5538961decf0be2c425fcd1bc0a5,98,74,2,343,98,0,02690,3
6bd1414cce6b96dfa3ede456c2bfd6a9,122,63,4,213.5,122,0,05040,3
7d435aebefeb77f5d72c26db02e5ad9e,25,25,1,175,25,0,01026,1
f7e80f16bd3cba4e824a5b7e0d6890e3,163,93,3,380.33333333333337,129,34,01026,3
2460c04f45dc84d64b641f824ce470a2,34,34,1,238,34,0,09010,1
e6325d10ab388a041c32c6337d3c6ef8,13,13,2,45.5,13,0,11100,1
7c503b18d6793edef1367c90d3a79b01,620,135,6,723.3333333333334,486,134,05040,4
17cf5fee30d9dfd037491c63204586cc,24,24,1,168,0,24,01085,1
24188cb644e06a3dbcedae4c10e844ca,174,106,5,243.6,156,18,05040,4
822af36eafa696f13935bc8d751ff610,45,36,2,157.5,23,22,01026,1
16f85f38b2a57f0023cca007b7133d50,9,9,1,63,0,9,10200,1
57ab3749afeb0187ad931688b9c19ebe,265,105,3,618.3333333333334,265,0,05040,4
07a3dbe263cf6b20de4584108c1fbf1a,11,11,1,77,11,0,02650,1
d2031fd5499a251021be6101b0597352,53,49,2,185.5,53,0,01013,1
5493d1353cabb0ac3d34708a86e217fb,27,27,1,189,27,0,03070,1
4af4e1ca8064e12205fef36796251f12,177,74,2,619.5,177,0,05040,3
2bd6638220f463fca6b0d90c212a660d,34,27,2,119,16,18,13877,1
23934f77311795ba48f3794c3ef7d25a,34,34,1,238,34,0,10028,1
19e399e6780e991c2742fa3b065821fc,34,34,1,238,34,0,01201,1
94359c0968977213b4e602b5659fe7e6,22,22,1,154,22,0,12570,1
e19ffece086f2df96c6c3130911f445b,36,36,1,252,36,0,03090,1
dd7bcc7b1fb85844d1310cf3487fac59,65,65,1,455,65,0,01027,2
eb797ff21ff493ca45b47cc85ba50a96,31,31,1,217,0,31,05040,1
f3c478cb6072d6e2422cdbb95aa7d9fa,34,34,1,238,34,0,01027,1
e75dfff91851c444205ac9eeb4047e73,19,19,1,133,19,0,10200,1
1950270a7ac43a21162be4aed41c2989,20,20,1,140,20,0,05100,1
d43c987b5e24e2a61fc29485bcecbcc5,149,88,3,347.6666666666667,91,58,05040,3
15890d67472ea284f0a75bc897cf64c2,186,87,3,434,186,0,09130,3
fbc0782d565d3c8d5a6ebe89d383afce,13,13,1,91,13,0,01013,1
122d09ec3799d28b4e20813fec02aa7f,28,22,2,98,28,0,01013,1
1a516f4875eabdf0ed73457241dc5269,262,132,4,458.5,219,43,01026,4
2769f1ded0f6e99541eafe9ec9782a8f,25,25,1,175,25,0,01012,1
b9f56c411bfe960bb4dbf6e15604b5ea,3,3,1,21,3,0,05140,1
926cc852c3c6fbfe893d1cab88cde79c,95,54,3,221.66666666666669,50,45,05040,3
9fc818ade00962f0162d9f198e64e902,54,54,1,378,0,54,13490,2
83f4f7b527e95740e9af5fae73d38f9b,28,28,1,196,0,28,05030,1
8356385d0cf7f61bea8473bba43f9b22,9,6,2,31.5,9,0,01027,1
5dc0bfd8a2c00637e2fdc03eba3da842,81,66,1,567,81,0,09090,3
967e3afe0ee11f0fb01baccfea3946aa,1,1,1,7,1,0,12410,1
2e16d019712cafa6f1e067f1b7783118,66,57,2,231,66,0,05030,2
d838196818a8eb233a6a1ef72d20f52a,13,13,1,91,0,13,11100,1
2f0a55d4cb881bc77e64a81e58966877,38,30,2,133,17,21,12710,1
0ff1481f66e0ac2e8b063bb01de7d188,189,107,2,661.5,62,127,08052,4
9fa90546419676fd6dffe0c3676acc87,17,17,1,119,0,17,08230,1
f65378e562ee6e520b393ee2cfdb1131,52,48,1,364,52,0,01012,1
684189dd6ba71750a8ecf9fe0e05dbcf,41,35,2,143.5,41,0,01012,1
9f795c7ae192c5dbcee3c14a3dfbacd2,165,93,3,385,78,87,10240,3
80947ef94147d041cda323386bbccb5c,31,31,3,72.33333333333334,21,10,01026,1
22bb018accc9a33405747e2d34e5a187,18,18,1,126,18,0,10160,1
20cf38a57a3ef00428b9088a4716ffce,26,26,1,182,26,0,05030,1
19de6b1745d01cf5f59f0842a43cf1b4,17,16,2,59.5,17,0,02751,1
da788cdc7dfa4af03d798a5c82df3600,51,39,1,357,51,0,11140,1
b847c3f6116eb95d54aa27cffee42e9e,87,56,3,203,52,35,05030,3
df4a016673c7130f00a5a8fc034cf6da,60,50,1,420,60,0,01026,2
192faaadd659091b17d430967605da67,40,35,2,140,40,0,11140,1
f1f11bca7c9b4bb89f752596f6428831,41,41,1,287,41,0,05040,1
54e674c6235200f5842898f9be0ab37e,26,25,2,91,26,0,09010,1
d56461afa6e60a4e20085909b9282b81,218,68,1,1526,218,0,01026,4
56becd0bc4a6fd66cc60cdede5523978,64,60,2,224,64,0,05040,2
0941856c961856fd701a452ee1a5829f,385,113,6,449.1666666666667,341,44,05040,4
a907d0a0666aeb8267fa4ebaa85b9f6b,18,18,1,126,18,0,05030,1
5b045492d3f9a6536421bbe93bc394a5,173,68,2,605.5,146,27,01016,3
2e0ba53b6268cd0a98d7ca7838999def,18,18,1,126,18,0,08452,1
447cacaa5ee363fbe11cd92678f4ca65,7,7,1,49,7,0,02691,1
36b0e674925e9ec966e9e931ff62ae16,186,86,4,325.5,144,42,05030,3
3d30cd4490920c9a97dc04c0c60c9cec,59,55,1,413,59,0,05040,2
f033ead63f8a623efa6ec26f0aa93308,35,35,1,245,0,35,05040,1
f337af93c1b2872087cf490f008a7775,75,62,3,175,75,0,01027,2
b20247653ad48e06dd0ead6e0d5d25ee,196,87,5,274.4,196,0,01012,4
383923a59a9df9c2783d8b43a75b8e7f,48,42,2,168,48,0,01026,1
693831b1685ce5b6905378a75bc0631c,362,174,4,633.5,164,198,01085,4
f5fe47d34a624e30dd4145aa23dabec2,52,42,2,182,52,0,01012,1
ea1722bd9564561d01a99414fa8a8547,61,53,2,213.5,61,0,01026,2
7f614a492c0113e7fad90bc780795b98,74,56,2,259,40,34,05200,2
beae55f7b8e52873b6973fe4aaa005b6,41,39,2,143.5,41,0,05040,1
db3d9b8cb9d7804a5d5a9c97d5eb3e21,5,5,1,35,5,0,11140,1
65661db9dd6d51603b171a4ca76089cc,5,5,1,35,5,0,12570,1
6d1f7a638f3f80ea40bc432f3e7eaf76,35,35,1,245,35,0,09150,1
c5820b0f4af18b1f57d0eac962bdbd1f,35,35,1,245,35,0,05040,1
a6556dc1a52d7de2585e97d2475900ab,19,15,2,66.5,12,7,05030,1
9224d8fc8c4a14fb9bc14c4f4da0a035,58,49,2,203,58,0,04020,1
a97104960c3c654180fe362899c529fe,13,13,1,91,13,0,10200,1
acc1e1a4bde8310710f1eb19249abde0,51,51,1,357,51,0,01012,1
09e98d1d2eee1281efe22ca4263be8e3,95,65,2,332.5,68,27,05030,3
a5fac428254d35f74be922e89551d37e,71,47,3,165.66666666666669,71,0,02650,2
52eb8a5552490f32b84c0d42e92e3adb,355,77,1,2485,355,0,05030,4
8fc18f26f3155e722b51540c5df36b58,91,78,2,318.5,66,25,08313,3
32ebeeca27c67e9faa284aa028dd6cca,32,32,1,224,0,32,05040,1
524a0d9907377647ae694a0432966572,30,30,1,210,30,0,11100,1
729c76f4e3a05e09ce5e43f31683fabc,58,58,1,406,0,58,08010,2
5a1620c37072d6a199b0cd5cf2fe840d,26,26,1,182,26,0,05030,1
d0e86f0684e063f94f8574ea35c173b0,13,13,1,91,13,0,10200,1
d51b3de854703be20f5a574a91b860a1,396,107,6,462,349,47,08010,4
5976a848fa244db1242c987fb5f27ecb,53,49,2,185.5,53,0,01012,1
311a91067f2f7a9d8c4098f450c82c5d,38,30,2,133,38,0,08230,1
1b0ac13aac7b1d5677a98036d1edb4ae,167,90,1,1169,0,167,01012,4
fbbb07453e0506501e42fb4d2b42bdf4,29,29,1,203,29,0,09150,1
d19fe0055c5c10a1f336c5ab4f9ad54b,103,67,3,240.33333333333334,103,0,11080,3
ed218347d213eb2c708fffa1e1d7dce3,18,18,1,126,18,0,08010,1
3c37736bb133022444fd048afb6cc0d1,47,42,1,329,47,0,03050,1
688c6861aa2167080c3af9c65d49e84e,22,22,1,154,22,0,01012,1
56dcd538845c2ff7ef687f3c8c245066,14,14,1,98,14,0,08010,1
128a5956cbbe028bcb5309cc1fb4e3d5,135,92,3,315,135,0,01026,3
7de00f562d90e383637d0af9ec09453d,222,119,3,518,179,43,01026,4
303a1d0a084bf0bc25e3f042c31ac212,122,75,4,213.5,78,44,12670,3
1e2a71dc449448d9fa33ed4ae354c330,35,35,1,245,35,0,01026,1
a6deca10c1d977589636312d4cb59908,50,45,2,175,50,0,10200,1
62a01265f868cdf9b1f0bdb242b04e29,110,73,3,256.6666666666667,72,38,09130,3
bd88b64b0547f30013709f36c41a3fc6,24,24,1,168,24,0,01012,1
0f24c828b7533b8249aec5aa608b7dfa,116,63,3,270.6666666666667,116,0,05100,3
978f45b056eb5632380a96f6cd7bbacd,37,32,2,129.5,37,0,02751,1
b890e780de456cd0088d85938561162f,97,67,2,339.5,70,27,04020,3
a0b11dcc658a49f2493d01d582e1d11c,6,6,1,42,6,0,01012,1
28deeebd20e5bcf0dc6baafa4e9420f1,194,88,3,452.6666666666667,194,0,10200,3
5a728a00a494c9267d21d9bd5838619b,96,75,3,224,96,0,05040,3
e92f376b95e9110580bc207ba4bc80ef,69,48,2,241.5,69,0,09130,2
d135cd7a9a756609aab39a9146a38b32,21,21,1,147,21,0,02650,1
b54a1b7c0aefee1053f1507883041e0d,32,32,1,224,32,0,05040,1
ff3814cce94faddf8477c5df7792fdf3,88,74,2,308,88,0,01026,3
177ade6d6d8bf99d68d270294273c78b,419,178,5,586.6,333,86,01026,4
f0b009be165eb723ee17d68df6fa6e3b,25,25,1,175,25,0,04060,1
d173d6d03ca43b351009d193599c8bcc,18,18,1,126,18,0,10080,1
fc3acef5d739e31c9c14ca6ce7ded908,18,18,1,126,0,18,05030,1
a4eed3374f2b8cf62fcab939c8403583,242,90,4,423.5,210,32,01012,4
d8fc99c2d6414e957b47a36c39e8d05e,44,44,1,308,44,0,01026,1
5fe7daa4d93ea3c614717c4b570b5f62,130,96,3,303.33333333333337,130,0,01085,3
1ae22fd0fbc6415ae2cd9cd6e078f163,29,29,1,203,29,0,01027,1
fe188a3a9ede8ac3913077ffe27c959e,61,61,1,427,61,0,01013,2
c01124699470a7271c0468e1076f59f4,120,79,3,280,120,0,05030,3
b4caf60d5580ebc15fc13f7a7ecbf725,8,8,1,56,8,0,09010,1
cbe509420b869060808df15195d9cdba,58,43,2,203,58,0,09030,1
8069c876cfcbaf871205d60345e7be6c,225,143,5,315,150,75,10200,4
6d686342aed0906783bf0d339c5df099,15,15,1,105,15,0,05030,1
40b663eecc79c4f38fdf85e032af19a1,136,114,1,952,136,0,05040,3
fff0d23c2c485a854a7f6461e5212a46,68,49,4,119,68,0,01012,2
0394cb2ca1e0623a0b4babc7c08879c9,76,62,2,266,76,0,10240,2
f863e2a3fb4eeb9aa85166daf1f1871b,6,6,1,42,6,0,03070,1
8ddf73dae3cc79261b14e0543efd20ee,88,70,3,205.33333333333334,69,19,11100,3
457fa7a97d615aa6445c7635b9e32aab,457,147,3,1066.3333333333335,207,250,01013,4
0554f0f75be2df53c75d85b7f2815023,440,176,1,3080,440,0,01013,4
d888a6d8cbc667685607af557190f0fd,18,18,1,126,18,0,01026,1
36880eac2f7252e978fa228b1f0c2bba,123,91,3,287,123,0,11080,3
518f75e2b2b5770c4cdfcce1ed49db93,45,45,1,315,45,0,01026,1
c84f22d064d18974736264ef530fcd7c,20,20,1,140,20,0,09130,1
435eb1d5e44286eab0990d05641063b3,286,135,3,667.3333333333334,231,55,05100,4
36c9df6597f51f043502bafc731afa80,177,104,4,309.75,177,0,03090,3
81a3e076a477e4d7edc100dd20b42cf7,181,112,4,316.75,137,44,05040,4
8b8323bd04f9f79c8218c53737834500,18,18,1,126,18,0,01012,1
1fd480b3dc27ae695f3c668752d19b57,128,86,5,179.2,59,69,01012,3
ab1636a422d14743ed738a2c54999171,41,37,2,143.5,41,0,01016,1
2ea949d57e05c9d28823039bd3eb4125,34,34,1,238,34,0,01027,1
e75b983c2bc4684e3f94ba966279a1d0,130,84,2,455,62,68,01026,3
90fa001050625353584f4e65f04635af,44,44,1,308,44,0,06100,1
93a62a02ae5609da00464aa666c3079b,42,42,1,294,0,42,01026,1
bcce2397cccb14e1d7675e85ad63d822,20,20,1,140,20,0,01085,1
e579c2fdc5cfdc0aa26d7facfa346cd2,104,73,2,364,59,45,01027,3
73c37b80ee254a70c97c540d2eb564f6,102,66,2,357,102,0,10200,3
7d25ef67a929ab1b9f1a5b108dea8be2,29,19,2,101.5,29,0,05030,1
bfc1989050382def1c39c99f57edc31b,63,47,2,220.5,45,18,05040,2
c0616d42fa9adad77019e4588936853c,28,28,1,196,28,0,01012,1
f1c18ee044ee2375c2ec4232e76adeb1,75,68,2,262.5,32,43,01026,2
7f83313bf121fb4a2f788ace76324f4d,30,30,1,210,30,0,10152,1
e7768f008eaa2350d8613436c660ec24,66,50,2,231,42,24,05030,2
710d50d4fb08c49663b10fb7b2073f8b,22,22,1,154,0,22,01028,1
35331a1af82f3696347099b08fbc39af,20,20,1,140,20,0,08051,1
027338b970b312651e08244a3ae0b6ec,27,27,1,189,0,27,07141,1
19f508d8012e5fe7bead3a2dffa11b7c,14,14,1,98,14,0,13490,1
c8941803311fa2a6ab7cd5ad7026886c,18,18,1,126,18,0,09050,1
a1d10af2427843e2a8290f66e2247949,21,9,3,49,21,0,11080,1
52c4c1aa1d794cc07c1f08c4ce569981,18,18,1,126,0,18,04020,1
5d323cf089a843fbc274b4db38846b4f,123,51,1,861,0,123,05040,3
e1a5ab52b4c1d435b9187ef3861e7aae,27,27,1,189,27,0,13830,1
c73ee071495eaf91600051e00d4a8ef4,17,17,1,119,17,0,01012,1
c1c638bc64e2f7b8011b22432f2f2c19,166,116,4,290.5,166,0,02650,3
f71b17d2f19bba340425bbb5897daf7a,87,64,4,152.25,65,22,01026,3
f5fe04bdf03fd057a04c493e9bc9d643,28,26,3,65.33333333333334,15,13,05200,1
d422017dee58a3522ee856febfbeb388,22,17,3,51.333333333333336,18,4,11080,1
513ce71ceaf1d59a89f9200d539d5194,51,51,1,357,51,0,01026,1
099f633b765e0a62cb53c4567f429746,102,50,5,142.79999999999998,82,20,11080,3
23c53d6f1b03d0c95c1a94d9fb2cae1f,62,62,1,434,62,0,11100,2
34f0d7786ddc5c8f7996a09913861a36,32,23,2,112,22,10,11100,1
5178524b6dfbb379b604009f96b6de98,110,76,2,385,38,72,08230,3
da463c7cd0976c8a16358b5a8cf6999d,12,10,2,42,12,0,11100,1
2e853b33a18431353704f38bc3248562,104,64,4,182,77,27,08314,3
82250c2f577e8fdb68d050d07fd84713,12,3,2,42,12,0,05030,1
574d3bb656e83efdb2466deca201493a,50,42,2,175,31,19,10153,1
df66eb420a2be1a99d01e703f81dbde9,49,49,1,343,49,0,09170,1
dae04bab1f67814f8fa81154cc5e3a56,16,16,1,112,16,0,09111,1
62810d58472bb3e973638bbbf764f960,263,118,2,920.5,263,0,05100,4
dd22f0c2485e3152a74f1417c3585762,43,43,1,301,43,0,05030,1
759082d71a1dedbb85d8856f4e2d7682,8,8,1,56,8,0,09110,1
aa306ea0fb866e88213701f1c5f31d38,228,157,4,399,228,0,12500,4
9ed595f114ee34692da04e8076edb546,169,140,3,394.33333333333337,127,42,10200,4
9de82028b62a7b233c393d4c4885872a,60,60,1,420,60,0,04201,2
6b0821bad9b332bebbc262388358cff4,44,44,1,308,44,0,01027,1
8a277f92484a44def0f19051ad921508,275,181,2,962.5,275,0,05040,4
8c78789093919e2252a0a23c9c47203c,58,42,3,135.33333333333334,29,29,01012,2
5523e773ced2f370213ca4932dd12989,8,8,1,56,8,0,05040,1
0220e3b87adea7a9d74c0e5765aeae12,300,126,2,1050,269,31,01012,4
ab429292c8c2c47dec0035afa104eaef,11,11,1,77,11,0,09010,1
ffcc4a3ea52ad0acea723cd4d7c15166,49,49,1,343,49,0,05040,1
168e179cb6ff7dccc2ebd013872b7ff6,92,73,3,214.66666666666669,92,0,05040,3
0d2aa7cdbe1f9d2775f994a9f2d0a2a5,1,1,1,7,1,0,11040,1
285baeb7d684dd766b1bccc3b4be3e61,64,38,3,149.33333333333334,64,0,11140,2
0b901c95c5e9e55ec36b825d25fdd995,53,41,2,185.5,53,0,01027,1
7330cb5af9bd28b976fe7dce162d548c,37,37,1,259,37,0,01012,1
9b9cf5d5b42e1d77ee23cd10c0180293,52,52,1,364,0,52,05040,1
d60a7a38ea7d322a27e112c9e75ac247,38,38,1,266,0,38,01026,1
834ca4ee8dcea5b445586acc10327346,75,63,2,262.5,75,0,10200,2
239e2974be748c75e5be5fc8a43be12b,51,44,2,178.5,51,0,01012,1
eeb6e9433ed3973499b1205a08fe5bd8,51,51,1,357,51,0,04201,1
0c778b88cff2baf1ccfef622f5fb1574,24,24,1,168,24,0,02690,1
7dd5b5c972ada4b8a4832831c60af9c0,35,31,2,122.5,35,0,05030,1
2f186e17a013d0f5f05e6719962e941e,19,19,1,133,19,0,05041,1
d4d523e15248a95761bab148785a7efa,3,3,1,21,3,0,11040,1
be936f5d392ba14866ce5bbb5b426d85,65,53,2,227.5,65,0,05040,2
11add00bfec5eaed79b9879219fce399,67,55,2,234.5,37,30,11100,2
f3d1090c8f27626ec13149ff1ab88d3a,109,72,3,254.33333333333334,61,48,11100,3
705d6808b1cc4882d3b8b5793c3cdf66,14,14,1,98,14,0,05030,1
17f9a643376df9769170cf973fbc5a43,26,22,2,91,26,0,01026,1
d40780da16369d40be77174a629c30df,12,7,3,28,12,0,11040,1
b26fd42a2362a1232be7d1352137c917,89,54,2,311.5,63,26,09130,2
c43515f5a1632ca58bdfd539717b0e3e,153,79,2,535.5,153,0,03070,3
6eea2ee5c127894f080608f09a20cc6c,9,9,1,63,9,0,01085,1
02d9a9314ed6d68d3fd76c6d53cb4ab2,53,43,2,185.5,53,0,10141,1
46fa27356c1fa39a64a138bfeaa831e1,66,55,2,231,30,36,11040,2
f30557fc46bad132dadf755c0db00c2c,228,137,4,399,166,62,04060,4
acda2c056a69eb0cb73436607d35af08,144,115,2,504,144,0,10240,3
6308d5e9549a20bd34dfa54eda5275e2,41,30,2,143.5,41,0,11040,1
231aa08a5c9c5703a7aaf86bde4738ff,171,122,3,399,109,62,05040,4
e5377b87f44f406c3e9bc242d508cf42,37,32,2,129.5,37,0,08150,1
31f713bb38a991e6ecd10e8909ef5bbc,5,3,2,17.5,5,0,11080,1
4de1762d5bc767e33a466b63583c5afa,39,39,1,273,39,0,04020,1
fc295a33ae98470c2faecfb91d918370,211,121,3,492.33333333333337,155,56,05040,4
20958ac6f22f1434cd92a88cf647cb06,30,17,1,210,30,0,08090,1
daa85479fa680e3d1d962b09cdb7af35,85,66,1,595,85,0,10080,3
fdd660a98f4ee2ec1ca157d459bb9fef,61,61,1,427,61,0,01026,2
d3f014a441599043dde0b0c037e8091d,65,57,1,455,65,0,09030,2
caa981597686ae94f31067b4fcf0eabb,34,34,1,238,34,0,08313,1
50dc4ed738dd56a2ad112b62b6d630ea,23,23,1,161,0,23,01026,1
4b0ad9f7e87a16e178448e25faedfa1a,99,63,4,173.25,99,0,01027,3
defe8f05a5d1947c4e00fd31434d229b,31,31,1,217,31,0,01026,1
1454bdcd5b4772168a9c99d0c5575b23,52,45,2,182,52,0,05040,1
5b2d346ea96e26e8e6a5a686d6bc424c,50,43,1,350,50,0,01085,1
411285bb7ce80897739243b839c437b7,22,22,1,154,22,0,01028,1
3d92d48b61cf493cb53e359ed5d5303b,102,51,2,357,102,0,05040,3
285ea9dc18cd46f7649bf39b756a4816,14,14,1,98,14,0,11080,1
953b2a085bafe4dbe4568f0959b09d07,52,38,3,121.33333333333334,36,16,01026,1
c741fd88684959719b21a9103d7c0cac,77,63,2,269.5,77,0,08010,2
cf14bdcdd8add907644ec98fe27a263c,72,59,2,252,72,0,01026,2
36e7fc8dc6d39f67237ae615714367c8,28,28,1,196,28,0,08100,1
8f58aae51d0cb19dc9e9e011d231eafc,34,34,1,238,0,34,05040,1
0f281c614d5da38b069eb613ac6cc2f1,21,21,1,147,21,0,08010,1
cad48e72abba75c3419f81d4d561e4c2,57,49,2,199.5,57,0,05040,1
e79e9927b0e3469fc20b651a7d2ef003,41,41,1,287,41,0,01027,1
8193ee39697efca98b1846d685de5c10,27,27,1,189,27,0,01012,1
936a5ff1ecb3c78498c3aa821938ca7d,39,30,2,136.5,39,0,13930,1
669795e8c391e1b0a5c30c6944e61b96,36,36,1,252,36,0,07131,1
155400ccd3d44d1c5aa5b5c58fd4652b,104,86,1,728,104,0,05040,3
0d70246311cd643127dba090f368a74f,23,23,1,161,23,0,01012,1
15e0a9b7b0c2b5c0b758f693667116d5,22,22,1,154,22,0,05030,1
7da433b9cdf28bfd87195633ea19e8bb,82,58,3,191.33333333333334,43,39,02650,3
87887a172e2e6f42b112f01b85ef32e2,9,7,2,31.5,5,4,05030,1
e868e7aef5130b9c83a477b303229cdb,17,17,1,119,17,0,01026,1
dade69f0ae73888084e28383c81881a0,12,12,1,84,12,0,05100,1
846836494ed99c1c4ec8dc4f11b515f7,43,43,1,301,43,0,04060,1
7451b6e2a9061155972c5098ffaabc21,440,123,4,770,440,0,01026,4
b9a9b70575d50b9732154b4c7994081e,105,71,4,183.75,79,26,04020,3
d1eb8f26f100a8d124c1b054578b70a7,213,96,3,497,213,0,06100,4
608961c71f3191016dfdca353ae0f52b,9,9,1,63,9,0,11140,1
68bac89146e3482f377a1ae099d7f677,52,40,2,182,26,26,05100,1
82dcf07fb555278919e836e6555c1138,90,73,3,210,53,37,05040,3
5c82f53ddccd75c8a429d5de464d0cf6,5,5,1,35,5,0,11040,1
787ed9d8345fba1c56f31a1c58869d27,48,48,1,336,0,48,09190,1
b5d918dc056f512b0cade1b4018c3dd1,42,42,1,294,42,0,01026,1
d05c95c9d18904aafb73b153fb73028c,83,66,3,193.66666666666669,47,36,05040,3
3c5ab28b89cf4579fddb53018e29965c,114,90,2,399,114,0,06100,3
346da5eaace919e9d5158d04b27a2b9f,9,9,1,63,9,0,01012,1
49e35d8e9e5f68e7511adfe057a09e93,109,49,4,190.75,109,0,11080,3
937481f9be228d06166abfb8b93a91ca,38,38,1,266,38,0,09130,1
4e11c15a449967a5a1a4de4c5a4e9c70,174,153,2,609,174,0,05100,4
52cfbefd79c07db22cfde54dfd2e2f05,94,59,3,219.33333333333334,94,0,11100,3
87c28d62f9575e4980db1da2eca94af4,29,29,1,203,29,0,01026,1
2e50e5935338d58b9c735f791a6a1c2b,346,174,2,1211,346,0,05040,4
37c61e6676199164c098e4728cde076d,20,20,1,140,0,20,01013,1
f36ab3c756ba007e7a88d3ed00b37887,68,56,3,158.66666666666669,68,0,01026,2
14b1c56ce07ee06710d0f2bb497ed9f9,752,203,2,2632,752,0,11140,4
4b50ca19c7d6cf1d7f81382205364da9,78,59,2,273,78,0,05030,2
01461fb2e92672094bde96174899dd1e,24,24,1,168,24,0,01013,1
b36da1eb71cd982f0e0b0084dcdd3ea6,279,137,4,488.25,175,104,04060,4
4de9e6182df2b7ffa9eeee5d453daecd,17,17,1,119,17,0,01027,1
94fb2a2a46a8c0dc5a12a513589ef83b,102,72,4,178.5,87,15,01013,3
626bbb6f511b54b6bb65c634e20ebab0,24,24,1,168,24,0,02750,1
c69203cff3b2ded1083c142fa1263904,16,16,1,112,16,0,09071,1
6f39b751ed03030eba42ee0e037f4f00,52,52,1,364,52,0,10028,1
78e308695bbf1337150ba57f14cc1c20,19,19,1,133,19,0,04200,1
43d2ba1b58a6336095f88a4a651b57c2,35,27,2,122.5,12,23,10080,1
3804d1c0135c41b9ddd11bb82f5d024c,21,21,1,147,21,0,02620,1
28b7047adeca83f724f36148eeebecf7,81,68,2,283.5,51,30,05030,2
f5593359cccf85746a5e1fa2be37bb37,80,59,2,280,37,43,05040,2
8666047c7d7ab64a9f36565a5beaf5e0,28,28,1,196,0,28,13830,1
48c8f5e06306ffde52c210f7e37d984d,28,18,2,98,28,0,01012,1
4a4816a56f38a66fb9472384b6c72534,172,109,2,602,62,110,05040,3
4fb66d9559ba24eefe0edb49ead38705,79,56,2,276.5,51,28,01026,2
f47d5f89af1f5d8f448b2a7fd90a4880,74,58,2,259,74,0,09130,2
3fea903803948877cd86c1b5fdcf8cc8,161,104,4,281.75,123,38,04060,3
8a5477323e2e532b66ffffafef18224b,67,63,2,234.5,67,0,05040,2
d6ea4da2869604f434c2ff54ea81bb88,65,47,2,227.5,65,0,04032,2
4084702644fceebfd22d3dacad6b7754,167,125,3,389.6666666666667,89,78,03090,4
34aee5b193a9836d72fef5f9654cfc4d,15,15,1,105,15,0,04060,1
bfd7299381516b2fa14d18ea22d5657b,107,79,2,374.5,107,0,10028,3
17c9298740e650e67d766953dfaa175f,124,77,3,289.33333333333337,71,53,11060,3
c948480c51ae45cf8cff46977ca028ff,138,110,3,322,106,32,02690,3
9cc4e4ed83fd0cedd72125b16b282141,27,27,1,189,27,0,01012,1
b6af9e247c71cb15166f26db1436c325,24,24,1,168,24,0,11140,1
fbbf55c4c310843f2d0d787a67bf6e17,21,21,1,147,21,0,01201,1
611f8929ae5b3e69a79088c144ca73c3,9,9,1,63,9,0,11040,1
185d6727d9e5746c273d9224fa03c929,97,76,3,226.33333333333334,64,33,01012,3
19235ca4998903704689e0cf8bec15f3,245,113,3,571.6666666666667,245,0,01012,4
760a4187a6efd97591c0cd7613223126,135,90,4,236.25,107,28,04032,3
a0b8ada1b2b26629d0009c27eab119c7,77,77,1,539,0,77,04060,3
1fc30c71f29f3c3a9665196123fa7b6d,29,29,1,203,29,0,12710,1
b15faac4c0f8dd3872032cbf38e61c2d,116,88,2,406,116,0,08010,3
3049f9db73136610fd66dfc2102b00ed,198,97,2,693,93,105,01027,4
cd3c54cc12732924b2e60aa1e19168cc,137,72,3,319.6666666666667,65,72,11040,3
d9314b353d86ac3d7bb5d0b286117bbb,194,103,4,339.5,194,0,09130,4
16696c99b26546f83b7234cec3d6be3f,87,87,1,609,87,0,01026,3
fdf12d575689cc9001ca1cb778b39b7f,257,93,5,359.8,235,22,11100,4
df24662fca326339379de5008c9e8ec7,127,62,2,444.5,127,0,10240,3
75cb250e5171cc7edbdd174a4eb9a66d,70,52,2,245,70,0,05100,2
098977117f5ef02444e1a2285ca1b26b,23,23,1,161,23,0,08031,1
63ba70e3edf50ca55c76601f1fd087e3,12,12,1,84,12,0,04130,1
cefc1946d12ef8f689fcd98970a9c9c1,66,60,1,462,0,66,04032,2
e47bc7f0b88a5fd89ced885efb788d92,12,12,1,84,12,0,04201,1
9144dbc58f12d447e9b3435ebce23159,110,76,4,192.5,87,23,01201,3
7dd102e5ab11b081f95f0ab8c6a99da1,143,104,1,1001,0,143,05040,3
aae936c7ab6d604a71bac0f12893be8a,40,37,2,140,15,25,04060,1
1079003f6fb596554dec93a8c4bb9e73,4,4,1,28,4,0,05040,1
d251a9889a14c21973a31dddf47c4f7e,34,34,1,238,34,0,02650,1
f1dfbcb06fed9de28b0d2adadd9e7245,17,17,1,119,17,0,01085,1
66ae30d738a0893dccad6a54ed62dea4,263,143,3,613.6666666666667,235,28,03050,4
b4fdfe16399e36315b0d2e429365f010,109,46,2,381.5,109,0,01026,3
e30a8acf0d9d47116ea78330e5be8464,48,42,2,168,48,0,05041,1
f010e363fd4a2e4b1ebdb82b0d1deffa,152,96,4,266,152,0,01027,3
7aea69e830fd8b4875039534e2c635e3,38,38,1,266,0,38,01013,1
28a0d8ed9b20bd6fc9ace17728341a74,38,38,1,266,38,0,11040,1
88aa9896814b321e2a801e5c5d73465a,31,31,1,217,0,31,01026,1
7bc981a405bc370da345e5824300096d,36,36,1,252,36,0,03070,1
0540e7e2c14fd16b36824c1c1b20a07f,23,23,1,161,0,23,01012,1
a45a2d290729bea08a5c96dfa9e22366,158,71,2,553,158,0,08132,3
89bf07f0d9433397327f6bc227f6711c,149,82,3,347.6666666666667,80,69,11140,3
6141f147da51a7b132a89f1e95f921e2,18,18,1,126,18,0,09010,1
df1f1da5ba7c61d8000f00d5a3bf3d2f,16,16,1,112,16,0,08131,1
e325f12e253d9000061331a14093d289,11,11,1,77,11,0,12591,1
29d0c54aefa683185294295bccc54b2f,166,80,2,581,166,0,05040,3
adbaccce3af675c9037f1dce7a0df571,52,44,2,182,52,0,05040,1
6dc7ce4f4bab2110f9e94e4b110c3343,38,31,2,133,15,23,11100,1
6ca7008499f726f87b3024d2820fcd99,53,46,2,185.5,53,0,05040,1
df8053b09f361febc22d6246ab1602af,22,21,2,77,22,0,01012,1
0a45664d19b109416f0c1b965ab1fef9,320,106,3,746.6666666666667,131,189,01027,4
da4e45fcd2a0e450d48c02d462e0e5c0,90,66,2,315,90,0,04020,3
c46635c213c0101d8d54c95236e15fc7,112,91,4,196,26,86,08010,3
9f2f09cb55d1d4592c32d1555ead7908,184,111,3,429.33333333333337,123,61,01027,4
64c9bc8d7844023638c0b1e87d2769d9,21,21,1,147,21,0,05040,1
abdfc1d0227b72d804e63504db1cbdc2,76,49,3,177.33333333333334,76,0,11080,2
2bc1255fe283f6062780ab8b22009a5b,30,26,1,210,0,30,01085,1
d72d165efa4e2528fc401802e6326bf9,4,4,1,28,4,0,05030,1
648a176999e9ef8f3cf9b92258d6df1d,14,14,1,98,14,0,05040,1
6142caf2777a7019461c099d85d5266a,265,117,3,618.3333333333334,265,0,01026,4
8357e6ce15bafe2bc1591099ff19f0e4,37,32,2,129.5,37,0,11080,1
5798e7ee6c35a645e6a7edd8734dfb6f,184,112,3,429.33333333333337,117,67,01026,4
340eb9901b611d63bdcb8462db6b6770,105,88,2,367.5,105,0,01027,3
e6b312240bd5c65b3b23c92aff76628d,62,51,2,217,62,0,08312,2
5d66a3ea7f45c659fd1bd883b468807f,319,159,4,558.25,319,0,08230,4
90a29df299b2c656dc41f5512280658f,45,45,1,315,45,0,02690,1
28385d1ffe15bd21a9b7b2938e3da035,128,83,3,298.6666666666667,105,23,04060,3
0c9734d96513162d1a571782ea240c0e,98,53,2,343,98,0,04020,3
8d6f420783b9bf8fd66e07377417fcd5,9,3,3,21,9,0,11040,1
4873e0fa3e2663f796ca08dbd5268f06,36,34,2,126,36,0,01026,1
dbc192eebaadc2671279f7e2725e4f84,10,10,1,70,10,0,12470,1
a015d6babafcc2d19002382ccac96714,43,38,2,150.5,13,30,01013,1
70aa618ca06263ba329c68c6009557e1,80,46,1,560,0,80,11040,2
6224833108f766335d5bed071ea22a69,27,27,1,189,27,0,04020,1
be428fe52863aef5fc28e3deedb6c27f,27,27,1,189,27,0,05040,1
fd793eaa93c46ffdbdb1288bb1ec2c73,14,14,2,49,14,0,09130,1
ad962e878b91cdc95eda2102f66e7357,34,34,1,238,34,0,05040,1
f2ae5c3a98fd92d624f01476b3b6a29b,117,81,3,273,117,0,05100,3
48464df4757535d5a5f350c8a4f2515d,22,22,1,154,22,0,10200,1
707d777d4aceb34f07469a6d59e59069,31,31,1,217,0,31,04020,1
b74eac2e77d77f0a02b6f751a7593847,22,22,1,154,22,0,08010,1
926d85cf4f3d4e5d11dafb203d475589,55,47,2,192.5,27,28,10200,1
125de604b5a28280c0c0c40a0c83f63e,45,40,2,157.5,45,0,01012,1
331eefb3f01c5b6e268e88b9ba6d9220,121,73,3,282.33333333333337,82,39,01027,3
aaf17af8fd0552400138a9b5cd5ff8cd,146,89,2,511,146,0,05040,3
c06c7158c3651f4fba3972e5907b6675,26,26,1,182,26,0,05040,1
20b385c8c89dc178b9bd9a87b8f65d80,12,8,3,28,6,6,09010,1
5d3e85ad13af51cb0a90a7a9a86f7c92,58,58,1,406,0,58,03070,2
dca0ef29c7babff71669e6a9fb8f6d07,322,125,2,1127,322,0,09130,4
68cb86c0009a9ef6185f400b1f990bbb,35,33,2,122.5,35,0,09010,1
6f79ee6f3ec73443d5f30a0909f3ce90,42,25,2,147,22,20,04130,1
a1602b355b3829a5d8ccae481afd00ca,18,18,1,126,18,0,08314,1
fab2df2e9e2546989a9613031186d90f,60,60,1,420,60,0,03050,2
362dbb84bf7e3dcb8d3a256dafa10032,244,111,3,569.3333333333334,213,31,01026,4
0166bc5e93e3e140d071fdcb4b7a1e03,32,32,1,224,0,32,05100,1
af3364d3f914b77f86e5ae37b43408fa,18,18,1,126,18,0,03070,1
a6d8ed14d3b4ba410100a0509cf310f5,160,84,5,224,124,36,01026,3
eecba8c5729ed318c226e042f0b174ea,39,39,1,273,39,0,01027,1
0ff8c7ed1ab6f547aefa85147033c17d,14,14,1,98,14,0,13641,1
010a078f0f7cc2665c8979267d8f3298,35,35,1,245,35,0,01027,1
9f79e355efda40f68ec37fa2cb4a5fd7,326,133,5,456.4,298,28,01026,4
2a714318aa7dc20cb2183f865d00e855,165,124,2,577.5,165,0,04032,3
aecea7dec89405ccae7296d8ac21f376,93,61,2,325.5,44,49,05030,3
e30f8707c684e6cdf943335e43606878,336,142,4,588,233,103,05040,4
b83633750b81e1bd08f1ce3f420dbefb,19,17,1,133,19,0,05030,1
ea5490057a99d3a0b386bf705202a535,83,68,2,290.5,83,0,10200,2
80b4820f0178fafaedf6f64971933e6e,26,26,1,182,26,0,10200,1
d15b43b5546618f1fcf48590997e2fbc,4,4,1,28,0,4,05030,1
5e1117002c251a8de2751b99d0c3703e,152,84,2,532,152,0,01027,3
658d5c46e73449d4aabc0ee70f44f2bb,2,1,1,14,2,0,10026,1
0585d084da5c75f33d959fd6b0656d80,103,58,3,240.33333333333334,103,0,03050,3
0681e101eed13150d8a90ccbc141b884,146,88,3,340.6666666666667,146,0,05040,3
ab12eac53e42f3564ff9d1f342a6a8b3,406,89,3,947.3333333333334,373,33,01027,4
7c36b69ac8c7b79397c1a60d5106c7bc,79,65,2,276.5,26,53,01012,2
08b559766bbe3cb37a620ba6d010393b,21,21,1,147,21,0,02751,1
b1328ca14e63b123270c571d34eec15f,164,104,3,382.6666666666667,164,0,08051,3
0ef49a27c3ba8e412f63dfe06c7e45b5,410,164,4,717.5,349,61,05040,4
082d6f5927b5cde6594ba93789592816,46,40,1,322,46,0,05030,1
0f0f0cb94584cb8dd1fa9fc8b6d2a2d5,51,51,1,357,51,0,01026,1
36d73743463e57fdc5cebe008249f4d1,60,43,3,140,60,0,08230,2
1c43c4ed5e5073b1518629f57c99554f,160,122,2,560,160,0,01026,3
5de189c23eed1b684da9b383e31063d2,686,178,2,2401,573,113,05100,4
7f567e559a11a94d90a6cbba349518db,50,50,1,350,50,0,10200,1
0a0c3adec91c5f1206a5be780a0c76bb,99,69,2,346.5,99,0,13953,3
c78b5cdafa7e14d8cf69abd80fe93eaf,113,81,3,263.6666666666667,87,26,08312,3
b9205f0fc4d882bfa351a93785e89769,26,20,3,60.66666666666667,26,0,11100,1
b283cd3969ffc49c781a7b635355c64c,24,24,1,168,24,0,04060,1
2ba1bf6e5053e1f7206246b4db42e4e3,33,29,2,115.5,26,7,01013,1
7799034592248347cb86964f8320eeb1,82,54,2,287,82,0,10200,2
b977a1db319b547cc2e1a18356689da9,182,107,5,254.79999999999998,122,60,05030,4
10b309143237e2b776c18dfea231b22e,36,35,2,126,12,24,05030,1
c55ca23c1dc4a160966a2da303853f0e,69,40,2,241.5,69,0,05100,2
94e58a16c0ba2005a819c9c218047bd7,255,158,3,595,255,0,05040,4
63dc36aa0d866a3b99e13f7891db4d80,48,45,2,168,48,0,01012,1
a61193c6d19964c61473332d2b22cb69,7,7,1,49,7,0,11040,1
b54856f8ca67a690af7405e08f97539b,16,16,1,112,16,0,11100,1
7c820cab6203a19f0646f2b85a2af1a8,47,47,1,329,47,0,06120,1
b50351166658ebbe8210fef99d71dc67,166,54,4,290.5,39,127,05040,3
e2a8708079410657b323e9406689f6bb,322,166,5,450.8,280,42,10200,4
db68f8e31c56acad3163dc1fb70d9561,42,31,2,147,42,0,05030,1
53aa4186e5c15c2c51e48eb5a402a95a,180,90,2,630,148,32,05040,3
ab3d7b5a1d7cc37bd1f5b268497e86d0,50,50,1,350,50,0,04201,1
aa3ac028b54ef39fdd4e487dc3bc1fdc,27,27,1,189,27,0,05030,1
54bccc6b552584ec00b962551114ba81,4,4,1,28,4,0,05030,1
4cee80be9b979357f65921a9a62dd1b8,43,39,3,100.33333333333334,43,0,09010,1
7d2672eed6289edbaf3fd4f40ac058d4,43,38,2,150.5,43,0,08231,1
13a56e9f1bc71a5c31c6a40159b9b595,59,51,2,206.5,35,24,05040,2
e6e1094d6204041e84e0dbd4e0f37e3c,237,187,6,276.5,216,21,04020,4
1a80fe419e018fc957b2b8ab39b81f1e,124,69,2,434,124,0,08150,3
6b0f0e1adbaf7bd9baa093d51023b44d,55,42,2,192.5,55,0,01026,1
ec1ae9959a401726b9fdf45d744c5d48,31,31,1,217,31,0,05040,1
ece50816d619624d03d0f0b9d722cfcb,21,21,1,147,21,0,02651,1
2da3f7eb3854231edae891623cf97786,4,4,1,28,4,0,05030,1
384ae17e16c0888fd94929b81809f1f9,174,122,2,609,77,97,05040,4
eeaa189399d98761c8a1006f616f9da4,72,51,2,252,72,0,02690,2
1a1ff5830a72b7f8ff54def77b9f1561,110,61,3,256.6666666666667,110,0,05030,3
b83be7b9679dba6e9df1b5d1b8de9535,35,35,1,245,0,35,08010,1
ad199b596c572cbc714b06aebb930477,29,27,1,203,29,0,05030,1
24a0e63840eb7362c6b1aa96fac12dc7,69,55,3,161,43,26,01028,2
b3f6e0702ecc4dd393ea4499a8bed728,63,63,1,441,0,63,05040,2
38bb0fa7850c738902a7fc42fbe0a2a5,130,79,4,227.5,130,0,05040,3
c67770b85a3dab439469b69513ff4369,96,70,2,336,96,0,05100,3
41c5d7191831339dad2bde6c762b7e51,41,41,1,287,41,0,05040,1
d2d3f231640c7ca001c7345c46f464ad,28,28,1,196,28,0,08231,1
e143f42f950ce8f8152d72943e8d13ea,123,104,1,861,123,0,01026,3
3f1f137a9c3278a54a5ef14d612273fa,44,44,1,308,44,0,01085,1
dc7122fa1130d2cd019c9fbdff4d323f,29,18,2,101.5,29,0,11040,1
74c251c02803cf64697bd72f98fd97d0,27,24,3,63,18,9,03090,1
be47ee977584a1a67a37ad5034a8b44c,250,151,5,350,160,90,01026,4
9feddcbde0df6e6a3673aa12559b4e16,228,120,4,399,149,79,01012,4
bf39f8629c2eb6e689190e29a2a2f5b6,179,114,3,417.6666666666667,179,0,05040,3
a51813ae642fbdb7a66969cec893fa73,16,16,1,112,16,0,10220,1
07c0bbb7b0f095ad4479c72c463d0de1,151,100,1,1057,151,0,01012,3
c45b14a5a64d608732e4f110bb714039,33,33,1,231,33,0,05030,1
2fe217e888875b9ce743c0eb4f707149,15,15,1,105,15,0,01012,1
6f143d64fe7a6b817b6e4eb4137fcbcf,93,77,1,651,0,93,01012,3
be027796f6f1cb4d8f665485c674ee81,83,50,3,193.66666666666669,61,22,09130,2
381508dc2131138a56b21c5b15177c4b,58,58,1,406,58,0,09130,2
9bec56d0055a505d75bc33efaf68bc81,115,56,3,268.33333333333337,115,0,04060,3
319dea9bff1dc91e90e77dfb0b869de5,120,81,2,420,120,0,04032,3
968c73e23c51fae83f212a0d45ebff52,48,48,1,336,48,0,12590,1
ae73f7c7f5bcd6a4fcac4012f5ab6a93,578,203,6,674.3333333333334,535,43,10028,4
e59f82ccb2e2b2e211ebf22396a3bcb7,42,37,2,147,14,28,01026,1
ecf2c8e9d455bef01ca3bfd5cfb2d851,102,67,4,178.5,102,0,04080,3
f798c02f8b726114764e339ba60ea1fe,80,52,3,186.66666666666669,43,37,01026,2
f88213fe485e439875696c6937340fa8,27,27,1,189,27,0,04080,1
f4e1d5ed94f542e8dd18bec736343ab5,6,6,1,42,6,0,05030,1
db318f3282bdf297054fd801610a190c,68,59,3,158.66666666666669,42,26,05040,2
92d56a8df532c679cd70e8e1f5988f0c,52,32,2,182,52,0,05030,1
deeb26f8aabda002e6b5266a25e70c33,121,51,5,169.4,121,0,11040,3
8e74e0c83c1d33add4c10c86a141250d,157,77,2,549.5,157,0,10200,3
68ca508355fb1332f9c975e0d9d87496,50,29,2,175,50,0,01026,1
9d11aca8e85fa0e8a29cf461b96f3150,209,108,4,365.75,209,0,05040,4
b1cf8ffb893300df14453f675ddeb0ba,39,39,1,273,0,39,01013,1
677a6ccc9c3d6542638d2d6523b422b6,35,35,1,245,35,0,01013,1
87a9156ca8cc39e2bfaa91f35bab83f9,24,24,1,168,24,0,01012,1
fea97331b593f0cb886bfa599f2d358f,65,44,1,455,65,0,01012,2
a6cc5206dc3865f8beb214a7768772f8,42,42,1,294,0,42,01026,1
efdf1f0aa1b3e4d8332ec9b4dfbad5b1,38,38,1,266,38,0,09090,1
a2008c6dee772e253d5ca07b0d3d4527,106,72,1,742,106,0,08032,3
959d1ff30a4c017f66f3a8a30c3dae99,122,76,2,427,70,52,01012,3
50249c59dacdfa0b0c95194605e75ba8,9,9,1,63,9,0,10220,1
86917116d42c092a391882900789c0c8,142,85,3,331.33333333333337,77,65,11080,3
1775a6baff537a5cc41ea0e735c62913,219,102,5,306.59999999999997,173,46,01026,4
4a17613a599dfc0f26d084ea2244d066,157,117,2,549.5,157,0,05040,3
0229a45f44ab0c7c137c32c27138c415,12,9,2,42,5,7,08314,1
19a8a604ca691b0f7a164aa88b197573,14,14,1,98,14,0,05040,1
af6fba88b32b1fef9c545cab89aaf853,30,30,1,210,30,0,13953,1
c691c3918cb4c02da3f2d13c49f56fac,34,34,1,238,34,0,02650,1
f2015998dd9eaf24f1ec6e908a50604c,629,195,1,4403,0,629,08230,4
ab09f10aff7783684b876125d5dc935b,20,20,1,140,20,0,01027,1
2facfdd5cd44a0044b8e890646d32a2a,44,44,1,308,44,0,09130,1
5588a0439f9d9bd8cc1cc50de072d3fc,103,66,2,360.5,103,0,09090,3
6720300df07acaa373b4be1b3a7a3264,151,79,4,264.25,151,0,08052,3
eeb28fbe2ad62f3f170f9954226ad420,12,12,1,84,12,0,05030,1
00f4f0c3fabb488e8ff013e087242e34,24,24,1,168,0,24,05040,1
48d5ee8302cef2db491100c3c33f6c4f,43,35,1,301,43,0,04020,1
99dc4fb6f774095cff70285cd22815e7,201,96,5,281.4,136,65,01013,4
b39223f5803951805780e5390c8891a8,209,91,3,487.6666666666667,209,0,01012,4
525ddfa9d46fe68ae459cdc0ede49561,23,23,1,161,23,0,09090,1
7d11a1146b9ec06480be320ee9dcf38c,30,30,1,210,30,0,04080,1
354119a728e53c67f9adffc7b24019a0,54,45,2,189,54,0,08230,1
55300ed108f3418345b7bc99a3a2bbe3,364,124,5,509.59999999999997,266,98,05040,4
04f4876dd210d9e13d1e962eec1b7f2e,85,85,1,595,85,0,02620,3
307934c63dd1d23af60506edf19271dc,18,18,1,126,18,0,01013,1
2969175afbe0774e5d8f0103373b722f,83,63,2,290.5,83,0,10200,2
04a032898e8f218a8cc0a72c1b54801c,119,67,3,277.6666666666667,119,0,01085,3
84c45d3884346ef78f92eacd665931fd,22,22,1,154,22,0,12742,1
90c20154bff5f8f4170b74c63c2d86c1,50,35,2,175,26,24,09070,1
38a0f880bff3459bc21abeae8902956b,49,49,1,343,49,0,12570,1
7bc2fc0dbc1524f1f0e0916b5d59b05f,48,48,1,336,48,0,02650,1
adf85efc87c1eab154b4bcd210bff626,15,13,2,52.5,15,0,11040,1
abd72eff4fe7eca529700ad8969f450c,50,40,2,175,22,28,09170,1
ea111fd22de3c7735fedce8b0dd66a7a,117,76,3,273,71,46,10200,3
857803ea133a401a590af4f562627842,40,40,1,280,40,0,08052,1
d8f274cd0aba8f767574b7182e9549b2,160,90,4,280,160,0,14261,3
4d97e8f3e6e3608f51c24644f96c4f58,58,58,1,406,58,0,05040,2
240903a260fbd3a72efe845fec195326,240,125,2,840,240,0,11080,4
c20432a930ecd34d46220bc48c3c7cbf,15,15,1,105,15,0,05040,1
05687e8221eb504fee12b481f1a7d252,27,27,1,189,27,0,08052,1
40ea955bdbcee02308798a3273efd615,628,207,5,879.1999999999999,628,0,01012,4
134c63db67aa5b3caca0888fc069d7ff,14,14,1,98,14,0,12742,1
0e69fac646b0e35c075b789ea7e456bb,17,17,1,119,0,17,02650,1
fd2238292d2505799c13347ccf2fa9da,135,76,3,315,135,0,05030,3
f086d7f062c53fbe9b4365961f022dc5,26,26,1,182,26,0,05030,1
8090cd40caf85005025e5c5b112e3d02,24,21,1,168,24,0,11180,1
84e07aea8a99ac5d85260821ed46f230,188,75,4,329,188,0,08314,3
b46fa5e186acff4d82ccd68d690b1d6c,332,174,3,774.6666666666667,332,0,05040,4
60f55121d711c8eaded33a397be5a327,252,115,3,588,214,38,10281,4
71d950756f43fa92af26969656ef2181,211,114,4,369.25,123,88,02650,4
2cb148848a00f844cdcf6dc477fd96d3,1,1,1,7,1,0,11060,1
9fede8b27775a83d84234c8d852586b1,52,47,2,182,52,0,11100,1
eeebe142804e5c121419c8c4d4d3021a,53,45,2,185.5,19,34,01026,1
ef0483ecaaa04992c623d3f77b049857,6,6,1,42,0,6,01027,1
7c9ee172d8308947c53248411cfb0387,93,69,1,651,93,0,09130,3
f0a68275b85d55ab74370b7df4fc1731,91,48,3,212.33333333333334,91,0,11040,2
f80e5613e7378c49c30f9f748f140e5e,37,37,1,259,37,0,02620,1
933970e6aca68af2f347790e9773ca40,25,25,1,175,25,0,08390,1
f30d00fe14247cf342c96cebc8527742,24,24,1,168,24,0,05040,1
439e76a07dae1a82304ffc1fa3228c28,34,29,2,119,34,0,08190,1
ba4b839ad4fbcfe1fddabdd0dcd24792,29,29,1,203,29,0,01027,1
63b1b14bc3ebcc493a5fefe976f3b5c3,112,60,2,392,87,25,01012,3
10a00da58a7f0ef4875bb5be17c27ac5,107,38,3,249.66666666666669,107,0,08230,3
3ab6ab173f1b4eb69217b515aa050fa4,223,115,3,520.3333333333334,223,0,05100,4
017da4b4f9f783557aa4e33b7cbe8783,40,34,2,140,40,0,14301,1
90e0d094f59774b898babbf34d04c595,69,60,2,241.5,36,33,01012,2
06c78b3bba74a7465609c6af179f289d,20,15,2,70,20,0,11040,1
0b93fa18a490ab13943eb075af067a02,25,25,1,175,25,0,08250,1
19f9bd018a4f683db69faab812bdc15b,153,125,2,535.5,153,0,10200,3
dbdaafdcb7bc7e093763b24e02fc57e9,48,44,2,168,48,0,01012,1
b4adb9af9bccadaba11c3318453120d0,29,29,1,203,29,0,08051,1
3ace7a4b25bc6bbb6eb1ad67cf6b71fc,29,29,1,203,29,0,01026,1
07858d3c85804b3ae617975fd0f5956e,117,80,2,409.5,117,0,01027,3
ca9502c8b4ea5eb39c413d4edcfafa43,49,46,2,171.5,49,0,05200,1
a203ca0c78e2047a186fc928f886ec81,125,86,4,218.75,125,0,04020,3
93aa1057d500b1a21b08ababfd5e813c,23,20,1,161,23,0,09150,1
d4ea8e3aaaa760781dd0af4f7e1ff05b,36,31,2,126,14,22,05040,1
b7340be919f3f984cdec5fc94c8361eb,177,93,4,309.75,177,0,04060,3
55ecab5e61cba35dd544866436ada823,64,52,2,224,64,0,13830,2
0d5c730ba8b052ac0fba1404ace85a4f,75,56,3,175,75,0,05040,2
f164aafeaee75b3a0c2a4fd0fc1d9857,32,32,1,224,32,0,01085,1
38a7583aaf779c1e58dbc465832e4e42,293,117,3,683.6666666666667,293,0,14301,4
320829b2f438751c8a98dab1f5edfded,55,47,1,385,55,0,05100,1
df7bbb012deab661640fe3d505d5a281,21,21,1,147,21,0,05030,1
a25ed1f4a70627c898cf73e5582c14a0,129,93,3,301,129,0,01027,3
3e1592d21d2bff8d1175680f801e7b3d,111,96,3,259,91,20,05040,3
54969def3e2f98092018299ad72f249d,36,29,2,126,36,0,02650,1
bf3862c31721cf7b0a21171f89fd11dc,13,13,1,91,13,0,01012,1
c64485e8a82cccd0232ece930bc04f68,16,16,1,112,16,0,01026,1
66c81f613cdd9a1804885a60341a00f1,47,47,1,329,47,0,08231,1
94469255053b425342ad91e7f9883f96,173,75,4,302.75,141,32,01013,3
d14a1d5ac6672fd4ea3433b145b4d2c6,118,79,3,275.33333333333337,62,56,01026,3
a594d926bf0b03b902dc9c32ae3eeb3a,27,27,1,189,27,0,10200,1
02a3c1461203a33dc6a9f7d18517d279,91,63,1,637,91,0,05100,3
cd513e0140160a75a2d62724e56133d4,24,24,1,168,24,0,01012,1
5f29eeabb5da06daffec8b83e7ebc5fa,124,82,2,434,124,0,14301,3
76af4b4230389daa41cecb966a1ff0f2,95,67,3,221.66666666666669,95,0,05040,3
abe81c7c0ae7b97c7c39df8ff42e9a54,48,33,3,112,48,0,08052,1
fc2966f04af15ec0f07c92a3db6ffbec,154,99,2,539,43,111,05100,3
be298dcb3ee2ce77915b1f2e8eec2e63,240,93,4,420,210,30,02690,4
0a06991c08c19ca9ba90fe3a06506fdc,61,34,2,213.5,61,0,05040,1
16fb959f9267a4b7d14a5c75d2390056,40,40,1,280,40,0,01012,1
4dc71a02a64d9a99da59d5f0b8286ddb,82,70,3,191.33333333333334,82,0,01013,3
0acbfec737b13b9c67404c4a63070e21,24,24,1,168,24,0,04032,1
f6f21cc91af08f058a9441809877d890,134,94,4,234.5,112,22,05040,3
0209a173a5032a016de658b78bebe1ff,17,17,1,119,0,17,05030,1
1d2f8246b5e63557d42026d13eab82d5,43,29,2,150.5,43,0,08032,1
adb835a0500c8a6c351c06892a5a7f3e,307,120,5,429.8,228,79,05040,4
bafb669a18560f3c40e72cd92affb54d,17,17,1,119,17,0,08100,1
a4077844c34f3f9a2fc0f3c038a891bf,38,35,1,266,0,38,05040,1
12ed0aa67c8ba37be477363b28429107,112,56,3,261.33333333333337,76,36,01026,3
1771a67d55fe9ee46c700c455d6dfdec,16,14,2,56,16,0,05030,1
347bfd4198c9042de949fc13b3fcd67b,20,20,1,140,20,0,05040,1
db4d2256f38a871cae9e720dcc581090,226,133,1,1582,0,226,12500,4
d05c69cb43b8f39ddaa6b6870bfd0a4a,156,78,5,218.4,156,0,05040,3
ece0d391591165291418d6bc0caba170,21,21,1,147,21,0,05030,1
468041873bf044ff52f81aa5f34cc218,158,41,2,553,39,119,06100,3
d4bfcf299eac883bf38753495531b134,276,84,2,966,118,158,10200,4
a27c9d065c520889448020ac444b5c91,98,77,3,228.66666666666669,98,0,10200,3
df2eb272f67c2e1a908012db9b3aba63,310,122,4,542.5,248,62,05040,4
af6cc6f2ddd58fc79524c1dec9cc4227,83,58,2,290.5,83,0,01026,2
449db1aa2b9178c770b0122c71619f04,144,60,3,336,144,0,01012,3
e923d9e001a027375c2246b79843952f,25,22,1,175,25,0,11140,1
af36c275bb507e9d7315e93a7a973a5b,166,78,3,387.33333333333337,166,0,05030,3
133b7c0ceaeabc4c8fe0a1bfbbe7d866,60,60,1,420,0,60,12500,2
01736df0d7b0897565ba955362ddabf4,276,97,2,966,276,0,03050,4
047f47cafaab13fc858cf3c8ce0a470c,33,33,1,231,0,33,10200,1
11fdf63047bb0fb07250d9b0fd99bbfd,44,33,3,102.66666666666667,44,0,11040,1
7606cb5608b2ce9ddf23eaee07a33493,21,21,1,147,21,0,01026,1
4df15b3ee6314477f5b060eacf9b824a,120,93,2,420,120,0,06100,3
c2a2d4e5c5ee0955db431e45ef2b9ca7,22,22,1,154,0,22,09010,1
89f55db86b26f9842128913d6ec71edc,26,26,1,182,26,0,08010,1
5dde6a771376ee0aede132c094850cc2,13,13,1,91,13,0,05040,1
47169da22a8c9a1a88e6e4be10704559,160,84,3,373.33333333333337,160,0,01013,3
fd04ef799974fa144081aade79051123,18,18,1,126,18,0,01085,1
9ac580da2b8738310548fe2ed936cc80,10,10,1,70,0,10,01027,1
de723677ed6e4a10d730de59a82cbe29,1,1,1,7,0,1,05030,1
d456d094626c92cf427cb04a0325f775,78,54,2,273,51,27,04201,2
ef61309bd52e631acb6376282ba8eb0f,145,101,2,507.5,104,41,01026,3
63f82278f84a1bfaf5d0e61592942a42,101,64,2,353.5,101,0,08100,3
f95770d2c908cc27afd1c845615017e9,422,185,5,590.8,258,164,01085,4
81d793dd7864e362c4d216868300e475,15,15,1,105,15,0,01012,1
87c0a301beab6c6c1d2d8ffbf90e652d,353,127,5,494.2,217,136,05040,4
971fa88cb5982f63db1f6bca11e09970,26,26,1,182,26,0,01026,1
0b09a9f87a4c992cadaa63e64b1ab029,164,94,3,382.6666666666667,95,69,10200,3
855653a9799f689ea5575bd5a8368c23,82,60,2,287,82,0,04060,2
c1198fdc197ff8c8f44c22e27d47ea5e,125,59,2,437.5,106,19,09150,3
97e31dadb897a9ec651491202ece19c3,10,10,1,70,10,0,01012,1
37ad4f6c6f4623fa1ee7d4925b95fece,31,31,1,217,31,0,03070,1
a45321fcd4944dccdc76e1538c0c09c2,54,54,1,378,0,54,03070,2
e46203ec985df2fef59bb1f0cc69eb66,30,30,1,210,0,30,01013,1
2053b269b2624dcb639b4394ae4fe17a,81,67,3,189,81,0,11080,3
d4379de123561ff3427d0c31166e47ba,16,16,1,112,16,0,09030,1
6d0a5929310acc61f3fbaa4bc292b609,29,29,1,203,29,0,10200,1
e99840df2004e4644f0ca5a45c4ef80f,64,53,1,448,0,64,02750,2
73110aa038677c1fa9ac215d545de304,64,55,2,224,64,0,05040,2
3ece5da73173e2792739a43029f597f6,129,75,3,301,129,0,01026,3
150de33377767498409ac0c451bd59e1,26,26,1,182,26,0,04060,1
35ddc29917a8748331591ad7972358cd,67,49,2,234.5,35,32,01013,2
e10651d4a864c590a6a92beb50dc9ab9,69,55,4,120.75,69,0,11040,2
45cc5dcae9f32e2f052b092eddff8137,343,104,5,480.2,306,37,05040,4
70ff733f30b270290e1de9d896b206c8,152,95,3,354.6666666666667,152,0,10200,3
f89150e31f0467cdd15c08de26451c0d,255,143,1,1785,0,255,10200,4
37728f91b97d4284eea5e203dcc91bf3,116,70,3,270.6666666666667,116,0,01085,3
07477223dda2ea4c554526e9c897407a,47,26,1,329,47,0,08100,1
65e4e41d2d6f2384c88bb850cd663bac,73,49,2,255.5,1,72,10028,2
aca5d2b7a6fb1c8fb88fc3e98406ea45,49,43,2,171.5,49,0,05030,1
97df47f10da7cbc7b2397604602e1c83,65,57,3,151.66666666666669,65,0,13530,2
a0f85a9b09b5128a3c988894eb40af04,17,17,1,119,17,0,08051,1
886047d28b03be979a5853079e0cfc95,95,72,2,332.5,95,0,03090,3
c4bf3a5e3f5ac2d74a95159d3532328f,82,52,4,143.5,82,0,01026,3
124f9892fa8079ddf4bc861c318c3a8d,70,42,1,490,0,70,11181,2
ad0dd16e4c80f26a5324ebe319bd5218,157,70,4,274.75,157,0,05041,3
a57938025d714b65612bf2cfde12136d,70,54,2,245,26,44,04032,2
785974880cee3e185876339e0756e8da,72,72,1,504,72,0,05040,2
43f9c6b4a74dce24ca454b8d523f9b02,40,34,2,140,12,28,01012,1
4020df8df028fb58167d5a7c4ca810cc,48,48,1,336,48,0,10200,1
b6bed4cda6c98377d04bce5ced7ef916,31,31,2,108.5,8,23,01012,1
052f80e7522d819ae1ede6f2e2842b6c,18,18,1,126,18,0,04080,1
041959735614fe208776f8e1a71709df,121,80,2,423.5,121,0,05030,3
d112e854011fa2edfe3ae31f6c20a93b,140,86,2,490,84,56,05040,3
6b3b7943cc546c22839c5d3452cf23ff,90,90,1,630,90,0,13953,3
9fecfea6c61869e44a7844e25a76904b,86,34,3,200.66666666666669,73,13,05040,2
865f4728af21a337642860d989d5f172,32,32,1,224,32,0,09090,1
93dc1d142c9b39b98c5f556453f8e81c,317,101,4,554.75,124,193,05160,4
9674fa17f4f154088ef1f739822a0e39,145,91,3,338.33333333333337,145,0,09010,3
418db8ab884a4cac19d68176db11eff1,12,12,1,84,0,12,01012,1
57b27219d46bf2f913cbb5656a039886,1,1,1,7,1,0,09010,1
fca0b89006d2d77e953263fead6ffbc5,22,22,1,154,22,0,05040,1
9813dddf87db2414228e471291642346,20,20,1,140,20,0,08210,1
306513344b518cc7d12dd34af3d5025a,48,38,1,336,0,48,04020,1
74a45d6c4954a57d4277f3380ff32fd8,95,72,2,332.5,95,0,01026,3
63471f2dd94c4e4b7584bb3d5a298c2d,147,112,3,343,74,73,05100,3
9c193bdb79e11bf99c6aec18860e279a,3,1,3,7,2,1,04020,1
ef81270e42e1fdd3b4708210ae9aa664,72,50,3,168,66,6,02690,2
b0016c26b9dc8d69cdcf2cff2d53626d,322,146,3,751.3333333333334,255,67,01012,4
4a942ea4106beec2244025f1d64df4f6,11,11,2,38.5,11,0,08150,1
48410b15adb46dab9a4b5e31f37ea6af,332,148,2,1162,235,97,10240,4
1d96fea366e7d9ac833fa1a3758bca35,62,62,1,434,0,62,05100,2
dd46bfd498e2db2ae8e60606aba8f134,20,20,1,140,20,0,05040,1
eacc25acb6d22f9fbcc0be6bd82f3d84,30,30,1,210,30,0,05040,1
2fd899158f235ec6c6f7980fabb6d191,3,2,2,10.5,3,0,11040,1
f2bb25cae63388873d0dc6ad782ac769,92,63,3,214.66666666666669,92,0,01013,3
9438d47b074fe592a04d76b583bd2d87,293,135,5,410.2,247,46,01012,4
4a7f23293d33ab43bca83a205173b487,50,38,1,350,50,0,05040,1
cab93bb0eaa68d259d1449e3b7a5182e,11,8,3,25.666666666666668,11,0,05030,1
6f37dcb8c74dbcbdbd4c09fb85591ca3,200,80,3,466.6666666666667,200,0,05040,3
1708874713036106b879595c7ad5b22e,34,29,2,119,34,0,05030,1
4c91f848a871177946fa823b6ce38782,115,92,1,805,115,0,05100,3
e0b2d425daa197b3f4b0e7afb478d949,24,24,1,168,24,0,09130,1
7463b446371e066e8e7b61dd6fba8be7,30,30,1,210,30,0,01012,1
492d80a94161ed2fadcf5a1e1d947585,30,25,2,105,16,14,09130,1
14e3d6fc722595976aac1493b75b084b,380,130,4,665,380,0,01026,4
f2c10dd6e5ddb6402e881bff42eec0ae,15,15,1,105,15,0,03090,1
b155b6afc099bf28dfd2bb1ebc48cb99,21,21,1,147,21,0,08010,1
ccc2539ff579510e01b9d21c5f57dc51,37,37,1,259,37,0,05040,1
c6e87ce654d4c83ce36a29cb558f49f8,12,12,1,84,12,0,05030,1
54eec3b04d86bdf3b2b4b1879c6103db,26,26,1,182,26,0,05041,1
037ff11d73cccb487ee1a1eaa3170486,84,39,2,294,57,27,01013,2
a2bc0f3f195c85355c5d5faae3d047c0,196,95,3,457.33333333333337,196,0,10200,3
94b16aaba5584c8cd56d871101f35710,166,99,4,290.5,145,21,01012,3
ae58928a470a4163a9187fe3ac4c22cc,140,104,2,490,52,88,10200,3
5b3a0dc85205f006d9f92230c8b4ac6c,33,33,1,231,0,33,05100,1
9d117032d33525b399b9d69f08d7d3e3,29,27,2,101.5,29,0,05100,1
24679669f131326afa1e1d536b704860,4,2,2,14,4,0,10281,1
fc53966a0f92cfcf56be0af45309b51f,13,9,2,45.5,6,7,11040,1
d93f86ccd9e173d0e8ddd90e7c9e4b22,23,23,1,161,23,0,01026,1
69cf43125b460d7fe175537ce8bc3fe6,5,4,2,17.5,5,0,05030,1
6cf05464083bbaf5adbdd4c37feb390e,91,71,3,212.33333333333334,91,0,10200,3
49d548921429cdd58fdf3be1bbda5e11,177,142,2,619.5,75,102,01012,4
275409070f9114a08ff615d35b521279,20,20,1,140,20,0,10080,1
c72d6de91aaa1cb95f8d307739942d91,12,12,1,84,12,0,05030,1
f777307b846f029165b77d904acf6ec9,8,4,2,28,8,0,05030,1
048d2a9a7efefcffa40790ab84c4f25a,1,1,1,7,1,0,11160,1
8934d11bda7713a4e9532f5c8e89d3f7,31,31,1,217,0,31,05040,1
2a353895cce5ac58600588e164643112,13,8,3,30.333333333333336,10,3,11040,1
5ad1f252fe5c9ecb9714538ebbc53451,133,61,4,232.75,105,28,01013,3
c83f53fcb307e9708e363bfc0aa16873,233,115,3,543.6666666666667,233,0,10220,4
d8fc85e198ea8aee0754865a7feb85d1,52,52,1,364,52,0,10200,1
cf68c29cc6b0c81ac86813508821e7d2,56,41,3,130.66666666666669,56,0,11040,2
991b7c9a0aba045c7fb8757ae2bcd70c,316,163,3,737.3333333333334,239,77,05040,4
aaf29c3aee76963cd0ce4696aaa6c832,23,22,2,80.5,23,0,04060,1
d11a464caf1a6f061981deb315726887,364,129,4,637,324,40,05100,4
06f48c66500a00b521f6e3ca0cc2cd23,408,198,5,571.1999999999999,359,49,01026,4
35728c529b17dde9b118988e907fc995,173,92,5,242.2,173,0,05100,3
6100805bc3f12569bc6c118f1d949eaf,89,64,2,311.5,89,0,08090,3
0df42559dfb77db3176d745de81b1b1a,180,97,4,315,158,22,02650,3
f4655940ae52f85e6009fcd33baefecf,6,6,1,42,6,0,12742,1
3ee468078d88d605966241d22edc45d3,36,36,1,252,36,0,03050,1
fb017dc03648245c9886fb676ae8cb6c,521,200,4,911.75,521,0,01026,4
0c777374b7e01820e965b944f9e28a1b,52,27,5,72.8,52,0,01027,2
755bf2f665701cb3be89627865db2936,18,18,1,126,18,0,10040,1
ec26dd62947d23586626ae05cfe41c5a,18,13,2,63,18,0,11100,1
6c3bb7703635c4e5975995a974c58016,24,24,1,168,24,0,12570,1
78c042f6e8431ee6afe1c5d21604e9b2,15,15,1,105,15,0,01026,1
6623166b52863d6d47de822831828d30,121,57,2,423.5,61,60,05040,3
e6e72e38347bf5a89a0c6b1d67832298,49,23,3,114.33333333333334,49,0,10200,1
4518bd2b99e98e4c371b9c45a5f6da10,86,52,3,200.66666666666669,49,37,05030,3
586e569330fe0ed8d72dffb7ed087f0b,41,37,1,287,41,0,13930,1
1908d1176c37175fc42c606940b3afd9,13,13,1,91,13,0,05040,1
e20bd555037ba2e60279c6f7fe9003df,124,65,4,217,80,44,09130,3
3dcc7229e540f0d1d229da9aa276a994,13,13,1,91,13,0,05030,1
df06f4f0cb5c88c7dfcbeca7afb47f11,163,93,4,285.25,163,0,05040,3
4b32b1b56b6f334d75bf69895c92329b,53,40,1,371,53,0,13877,1
9294e9e46051fd4bbabc5ea41ed8f2c0,16,16,1,112,16,0,08090,1
e2020a7e31bdfda5bd1fb1f157221331,150,82,5,210,98,52,11100,3
29b4f0faabd72dab306bb42b1a0d5ee0,5,5,1,35,5,0,12501,1
b6cc480eb0e00fe249c97903e418269b,57,57,1,399,57,0,01016,2
16aab73cfaca0193c769808f91ca68ae,52,48,2,182,52,0,01085,1
a0c7af8da87785be3eff900956443494,29,19,4,50.75,18,11,05030,1
fb716bcfef823474c04cdf2d277c1b26,33,31,2,115.5,33,0,02691,1
d4e8c728f8d96aed4708ebb634567679,48,20,3,112,48,0,05030,1
b7f4ab525cdfed0cf4cb2db766ae1840,28,28,1,196,0,28,01026,1
517e676099a3a78f764eb1076a42d5d7,16,16,1,112,16,0,01012,1
8c6c0bf1fee7829e5647e581c86c2d22,32,16,4,56,32,0,05030,1
e6c87e287b37894951b407335725e999,14,14,1,98,14,0,05040,1
78a8851b644d621f68f813bfb6b228fc,39,39,1,273,39,0,01026,1
9d90f9ff77f0466ee188e3f669efee05,144,90,3,336,144,0,02650,3
1f0f16c7867255c78628918204b09b29,15,15,1,105,15,0,12742,1
d18582e36d6abd65cecc11c7b514ebdf,42,42,1,294,42,0,05100,1
80359d45686aa7a0781853427dcd09f2,18,9,2,63,18,0,05030,1
0d793e271087bc7a5fa687488adeedb5,92,77,3,214.66666666666669,92,0,01027,3
be9007f3b3b8b58d7950ecf1e6c65a0f,294,125,3,686,251,43,01026,4
31cf76367f31db00aa47398f5be92801,84,64,5,117.6,70,14,01012,3
b71ee14afe88b5d8bcf9233144eb48c4,159,105,3,371,159,0,08100,3
0394195a79230114861d85d45574291b,4,4,1,28,4,0,05030,1
e1de8e5c02b221420859c39f3dcebb70,414,187,4,724.5,365,49,05040,4
515c4e8243cef9090b7eee2f08e40a40,76,57,2,266,55,21,05040,2
4ac9352e8ac3c7b48b23529ebb15ad42,21,20,1,147,21,0,05030,1
ddf7f2431ff248ecb4c728a9acd82a03,24,21,2,84,15,9,01027,1
d977f665d79bd9bc1fa9086ce3a1e4bc,10,10,1,70,10,0,08314,1
04ebc65667a797ed01efabc8546f8ca4,6,6,1,42,6,0,10220,1
37aedff243268eab48577c56ae87720c,201,158,2,703.5,65,136,09350,4
973922562a12ee3fc272254c0530167d,36,32,2,126,36,0,04201,1
73aad8bb73601e3cf20c68508ad9deea,43,36,1,301,43,0,01012,1
f15018651cc978d3a9a4c966bf2337ca,207,85,3,483,207,0,09150,3
6815960e0186aa59ebed4ce292898472,31,31,1,217,31,0,05100,1
30cfa3e40bc41474c56beb68cd600abb,153,102,2,535.5,153,0,05040,3
24f49dc80a1805e4c964ccc0a8cbc25f,19,15,2,66.5,19,0,09021,1
f4d64420390dd009c1febc9689ed15e9,48,38,3,112,48,0,02650,1
5781c2e3eb271863103c8fb6653436c5,201,105,3,469,201,0,05041,4
a74065c167cf3a4f8e8621ba36659d39,23,23,1,161,23,0,09030,1
f2e44c366624f131d0116e6467be30a6,178,47,2,623,178,0,09010,3
b5408a8053a0a4224c1677e49392abcb,28,28,1,196,28,0,01013,1
5957335bb6a6c312d8d94a3582513ff6,46,46,1,322,46,0,05040,1
ada726ce516272229f485432351a86c6,226,136,5,316.4,226,0,08031,4
ba3dc4b30f2acc49bae3eb149e80fdf9,49,43,2,171.5,29,20,08052,1
cfa980f692bd44b1a35060acc0d9b07c,34,34,1,238,34,0,09010,1
7f58d4e05908db131ebaa3deabee666b,188,107,1,1316,188,0,01012,4
0ae012ea656a4cc22de02dd0f8cd846a,52,42,3,121.33333333333334,32,20,08452,1
5bc5a3359a840d8b95cdeb3e0a5122f4,50,35,4,87.5,50,0,11060,2
6b9e638b2b3d944a7551b0e973dd0c10,28,23,1,196,28,0,01012,1
43a0820a7f9ba6270ae9643fda995ce6,41,41,1,287,41,0,02756,1
048fdbbf4398fd120fa284ec9b4e8131,77,54,2,269.5,77,0,13490,2
45a90e7a5afc56384382ce841b0e93a7,123,82,2,430.5,123,0,05040,3
4ac14f649135da02eeda55f51f0a4c04,42,34,1,294,42,0,02691,1
3f96c1603640702737cf45f0bcff90a8,66,37,1,462,66,0,05041,1
fe5a2cb46c404879ec19bf3751aa21bd,45,38,2,157.5,45,0,02650,1
f7628c6f77cfcb5bc01159f1dd6e0710,104,86,2,364,104,0,05100,3
7dff523b73f6a5d87683db8306b8ead1,108,71,2,378,54,54,01085,3
1191015346a62d017e753bf2d5cb414b,65,54,3,151.66666666666669,46,19,08052,2
c6d8d0b35a806155361470270ea487bb,47,47,1,329,47,0,05040,1
0ba0a575a95e4c66fcac76f96201e1e1,14,14,1,98,14,0,09090,1
855fc225695e0b7f5877d2b0d3da7705,5,3,1,35,5,0,11040,1
df194eb96b2dc939e1d1b4cf30d275bd,16,16,1,112,0,16,05040,1
f802aee8fd260abe801e992f2a90f52b,97,63,4,169.75,97,0,01027,3
8dfaf263f39b869226f16d72bca8a5c4,98,66,3,228.66666666666669,98,0,01026,3
5db09537def995f395c4153115bbf3d0,11,11,1,77,11,0,04032,1
521fb88df2a1c41c5fcc95b11dbf3bc6,118,97,1,826,118,0,09130,3
1a5c710b9e721b8efa0f04794fd27e61,146,94,3,340.6666666666667,146,0,08132,3
352009064e54a563bd7735499ea7caa2,8,8,1,56,8,0,12670,1
1c5ecdac496ffd772f98d0b1c6876c02,80,64,2,280,80,0,10220,2
52f2609640fc7a55783c3c33991ac39e,135,91,4,236.25,104,31,01013,3
ffd1aa2826d7677163758c30a314697a,195,86,3,455,195,0,03070,3
2d90b04579285a9c692408c969680d5f,50,26,2,175,18,32,11040,1
ac932454a4f044405152f6e2a8ab8c45,15,15,1,105,0,15,05040,1
07684c4c0d0e553666eb9f64a0226fea,32,32,1,224,32,0,05030,1
dca0428baa6a31f404502cb1b428bca6,53,37,2,185.5,25,28,05030,1
d9a76f9a83f22c943e704b5ef6e3fbe7,109,70,2,381.5,109,0,10141,3
35181ee2a53ec4080e2cfc38df72bb86,26,26,1,182,26,0,08150,1
eed7caefbb2fbf629a905b16ea45ab67,34,30,2,119,27,7,01027,1
978a42621e5f34f8ad30b4b2d41a43ee,149,88,4,260.75,104,45,01013,3
cc01c77330b824d4c0bbc735cc8d41a3,11,11,1,77,11,0,04020,1
89d01bab01a1c81cbe447b9ef5c48193,608,198,5,851.1999999999999,276,332,01026,4
d4f72ce93fdb26483f86cca939a960f0,52,35,1,364,52,0,09010,1
7bc7298f02d12551d61488d72d65c056,185,55,4,323.75,134,51,01026,3
b979dd32b12eedb6eafb17411f0f0b4b,105,81,4,183.75,94,11,08314,3
83a662dde4c73b913600a1e13919022b,3,3,1,21,3,0,11080,1
aa503f9a903542d7e944378ef1030f50,48,48,1,336,48,0,05040,1
b38aca116732e88441d5ab8a97e2dec5,120,75,2,420,120,0,08010,3
27562f9364caf5330c1602f9e93fdde3,81,57,2,283.5,81,0,05040,2
8e9ab05e81e9416d19c77afc6ca71436,50,46,2,175,50,0,11080,1
596485b9b0aa9700c2dac27f43580092,60,53,2,210,60,0,06100,2
32bfed8a40075b4a167c0ba99fa94476,23,23,1,161,23,0,04130,1
b83a23c98f051538ca0a620d4f142311,20,20,1,140,20,0,01013,1
62d6c5e318d78fae48660231ff86e922,61,39,2,213.5,34,27,08100,1
9eedfbabb65d7ef0c8981e9579d568c3,76,57,1,532,76,0,04080,2
1f414d39b12ff64627956ca2fb46b912,121,61,3,282.33333333333337,121,0,05040,3
79c0b4ba4fac346d8d48fc74814e6dff,83,64,3,193.66666666666669,83,0,01012,3
06b5b23ad93204f136bb4608f77d114f,284,157,3,662.6666666666667,205,79,05040,4
af64c566d81a7797db9b35b5e88a2c2b,262,106,4,458.5,162,100,01026,4
3dd066cdd1b19ad56703dca3637c17de,23,23,1,161,23,0,03050,1
db5fd7946066c7b08421f2180c621b06,389,120,4,680.75,349,40,05040,4
458ff77e457c9f62cdb592349566f18c,37,28,1,259,37,0,10080,1
d824135738144d8f1fd2157fe8f402b6,36,23,3,84,36,0,09110,1
eac3b03a535095d022cfb754766b306d,18,18,1,126,18,0,01012,1
fe0cf6eac48ba1b584b4eb244d7c69c9,151,98,4,264.25,121,30,05040,3
adb77396a2b4069b6aea8b32a4b983a7,36,36,1,252,36,0,05100,1
f8c8ed7072dfe988a69951004c11d9e2,92,64,3,214.66666666666669,63,29,01012,3
8baf538a4e3cd8d62a07c9dd19c20965,28,28,1,196,28,0,02650,1
c17a68ab7cc0ab8e85931509006095ad,40,40,1,280,40,0,01027,1
dfb84c02795bc06fca9b419ad07753b9,61,50,2,213.5,61,0,01026,2
f197415a77955a809872f20e62656066,279,115,4,488.25,225,54,10200,4
af4261434c48311eaaf2eaa19327758d,113,85,3,263.6666666666667,68,45,05100,3
955e6e2af593e3ef0aa9c316563962cd,15,10,2,52.5,15,0,11040,1
65b3eb3a0a5c8dec1c52eb7e18f18189,53,32,2,185.5,53,0,01026,1
9b169dd28bb2b30503d2df9f41a804a6,15,15,1,105,15,0,01027,1
6a24da5380963100057a1cac99e41022,31,28,2,108.5,31,0,01012,1
a9c4cb40efff89f5f690fa31337af97a,132,82,3,308,79,53,14301,3
38989a7a3c7551dfbc03fb4907ac6ed6,455,153,3,1061.6666666666667,312,143,10260,4
10efa8a941f01e721e43428889efbe16,26,12,3,60.66666666666667,26,0,05030,1
82c2d979e725a7a1f4bf11450c16c0dd,28,28,1,196,28,0,05041,1
b0eb97a945dd15039eb2bcebe9283398,34,32,3,79.33333333333334,12,22,01027,1
3e385b1a92c3dc4bff2fd38f153ac7ce,32,32,1,224,32,0,05030,1
9c87ef20e9b032b0b4e50fabba43ef04,43,24,2,150.5,43,0,09090,1
321d2e94db0952295f1c711ed0e3b0ab,35,35,1,245,35,0,09130,1
fd0dcb49425e909864f2e5e649e38bd1,30,24,1,210,0,30,12570,1
0396dcb3278fa405d6022ee33999fb3d,57,50,2,199.5,57,0,08452,1
daa074965ff3aaeb7d9868a5dba8d759,84,60,3,196,84,0,01026,3
ae8bb6ac8583c4327fe1d020f89b0d4a,15,15,1,105,0,15,11100,1
6db927c1da61b3d6ad2a9cf2c0ae18d5,28,26,2,98,28,0,05030,1
0a7bbcf151d1535335c84ef4418d682f,110,88,2,385,110,0,07144,3
7ad6bc47eb224c7b7d1c90ec60b5df81,238,94,3,555.3333333333334,238,0,05030,4
3985029ada80208593ab4aefa6b6ea01,79,56,4,138.25,41,38,01085,3
c6d5d163878faa8f39cf90f9c283c820,95,69,2,332.5,95,0,01012,3
ac3e8ce8cb2df6343b1a0627aefe6582,122,77,2,427,122,0,12501,3
f282c509718e08632247e3364e0a06ae,37,37,1,259,37,0,09130,1
0d89d2bd0939d19d83f00c9f15a48954,73,50,2,255.5,73,0,10200,2
8ddf041e8cc569e61b329b54571fdb38,16,16,1,112,16,0,11100,1
9e07cbd78419518e4c9e0e3d49e1744a,66,66,1,462,66,0,05040,2
dbd9c1d589b4ece2ce78a0c7199e3835,72,68,3,168,72,0,03070,2
f362f34b08bd5e4648d7abef13950cc3,27,27,1,189,27,0,10220,1
42568df2d654ef844c1d15d8c84abdf6,50,33,2,175,50,0,05030,1
09ddd43d0185e580c3796fd4fb1772ea,26,26,1,182,26,0,04031,1
067cb2ecad80b3b7ada426f02aec87b0,39,39,1,273,39,0,01026,1
b133c6d755ba149a52b00991bc907a43,177,86,4,309.75,177,0,01026,3
b3af68ea7407222bdc197b491b0c6ffb,81,47,2,283.5,81,0,09111,2
a8c4242d7b7f0afcc6137aef30dba072,141,97,2,493.5,141,0,01012,3
16d062095eed1a459c8596a79f2454c2,236,121,4,413,236,0,01012,4
8d8d2ae4a8af2592ad6197d4d3ecf0b1,237,94,4,414.75,196,41,05100,4
3c4231cd3767dbb6abd61ec2635df80f,45,39,1,315,45,0,13930,1
15950197664c8c6312e4bd1fd531296a,37,36,2,129.5,37,0,09150,1
c6f9b5b0a234ac3b93bcc1c6596a8d15,28,28,1,196,0,28,01013,1
633e3aa766232d1924893f5584c0442b,47,47,1,329,47,0,05040,1
adcb15c764e2b564f8160f238c72d943,205,108,2,717.5,205,0,05040,4
ebd555293bc2a45bee504421401f49f5,200,80,3,466.6666666666667,200,0,05100,3
cc982155972a657414b71b4b25ee52b9,36,34,2,126,28,8,05030,1
5e7c4643c63fbc547ff1384e9be84034,6,6,1,42,6,0,11040,1
56dc8c6d81f96858dec7986c94cd1d41,25,25,1,175,25,0,09010,1
2b11ded996440af4f893c68999e7271a,23,23,1,161,23,0,04020,1
4896ddfcea8482cceeb1b8db123ca7bd,13,13,1,91,0,13,09010,1
bd6a7e504d7b836955e2243af1f21ae3,86,65,3,200.66666666666669,86,0,05040,3
5f592fe421059b2cc39fe763b31a52b9,26,26,1,182,0,26,01013,1
1bcbfc9a6bafa6e50dcd007f91b7a446,88,64,3,205.33333333333334,23,65,05030,3
6cb47cdd92e0024883609a29eece7d63,55,48,1,385,55,0,10040,1
e42ffcbb3eb35abf777dbfc7851cfc10,29,29,1,203,29,0,01012,1
6053f4409962ae501887fe7beb1182de,11,11,1,77,11,0,09010,1
601fd67ae4048874227a37a436f8df23,19,19,1,133,0,19,05030,1
889f8fbd4518ea307675b3dfcbaf5525,4,4,1,28,4,0,09190,1
ee78c5c26b2b8c4cbe77aac8bfb42dab,60,50,2,210,60,0,05040,1
87556594fbe59f8468f92861162f8f64,271,95,4,474.25,240,31,01027,4
b4fe2ffdeb06492469d211c2f98d8f12,11,11,1,77,11,0,11100,1
00c2654ac35c0a30532ce55e02fa00f4,221,127,2,773.5,155,66,05040,4
105159a3eaeeab618a1df9d8c197493d,286,110,4,500.5,232,54,04060,4
147d4cc7f9c14051fd1a00e0cfc4c6bd,65,58,2,227.5,65,0,02650,2
86ca0a1a54d7f2e055ede3f5ad36e10f,235,54,3,548.3333333333334,235,0,09010,3
6e5447ff10336584dfeaf4338645d6b0,257,116,6,299.83333333333337,227,30,11060,4
13e6647cf8be32500ab3e27eb6e1a23b,4,4,1,28,0,4,03070,1
b55f646b7c5bc3dcfe594df3112a0509,90,68,2,315,20,70,05040,3
39c83ee1496925cb632d4b26f05dc1d6,12,12,1,84,12,0,08231,1
b319e6c4f4551f02a70651dc7d8fe1a9,160,83,5,224,131,29,05040,3
cc71701d14541a80993f82e7d6677ede,91,61,3,212.33333333333334,74,17,04032,3
b5aefe4f005a6fa941699a59b53a03a8,61,49,3,142.33333333333334,61,0,14351,2
cb75590a9934f8f7301a2c1a5404e698,9,9,1,63,0,9,11080,1
1dbefa763afdef9c768cdcf9566ed41f,260,144,4,455,218,42,08032,4
6cfcc8db2e5a13a87839152dcda6fb7b,34,34,1,238,0,34,08231,1
388e33ffcf09de7e471229212dedab17,128,88,4,224,82,46,10153,3
8011c20b8234052ae38d45706b3b53d1,27,24,2,94.5,27,0,02620,1
f61bcac6eca717592f3d586f14976d20,41,41,1,287,41,0,05030,1
e7899db61688234c931a402650882823,53,43,3,123.66666666666667,53,0,05100,1
b0d21eaeea23d7d2d2f43c8076472afa,22,22,1,154,22,0,01085,1
6a6f148767e7c35c6c38cf8ee8b96b29,24,23,2,84,19,5,08390,1
9df6c7be1db8edbfc8afe04bb4714662,25,25,1,175,25,0,01026,1
fe52021eac363e9c1dc5883dca7b18a4,14,14,1,98,14,0,01201,1
51bba507d128973189a51cf9906b4845,10,10,1,70,10,0,12650,1
ae1444bc8a4b62b9a7ff6b4ccfc2356b,97,75,2,339.5,97,0,03050,3
9ba08ee6597df6e027b7ee3b5d194eaa,90,57,3,210,90,0,05030,3
ba2749d78bf4b6c8c727c9cb46151695,37,27,2,129.5,11,26,11100,1
3895cfe4c4f598092c2cd03a10a40fd0,1,1,1,7,1,0,05030,1
e0fd06411e505b1e736cf5e2d28210a7,18,18,1,126,0,18,05040,1
d774e14085dd9fcb81dbcb91fbcb1843,151,108,3,352.33333333333337,151,0,09150,3
0f35c3135980ee81bdd3b2689b550683,88,73,2,308,88,0,05040,3
ec5221d7833dce7562743bf3a5b2278c,140,57,2,490,140,0,08090,3
80b1f00a7042cf664a7c19f60e1cb935,67,59,2,234.5,67,0,11080,2
31af560d2931608ee73279bb8748273a,124,73,3,289.33333333333337,124,0,01016,3
0219648b555ead892fc43d0255696d76,111,77,4,194.25,68,43,04020,3
474b2800d73b957a3784f24890eeefbb,66,47,4,115.5,59,7,05030,2
e8444ea70758e47df061ac49c38f310a,53,37,2,185.5,1,52,11140,1
787f5971c3accb768b58c55d95da09cb,39,39,1,273,39,0,05030,1
e71d8e8f72d1e2a2311a6a4025eaa87f,37,34,2,129.5,37,0,05030,1
7ff2293e61b285c41d8311e59c4321c6,24,24,1,168,24,0,01026,1
4900df952ab2c7f21c76dc670f913a78,115,98,1,805,115,0,10200,3
4d64e4a14291e5adeb29e9b6731be94b,198,139,5,277.2,179,19,10200,4
93dd6760a9d7deb3559e43d192e70191,21,15,2,73.5,9,12,08314,1
9d3b5a4c2a15b80ead06cbd1b93d6af9,29,29,1,203,29,0,09150,1
27a9e54891e2cb180ce9a7ec51fa9f79,30,30,1,210,0,30,10220,1
f38a23bc846064ac720f03da0ee1b0ec,373,175,5,522.1999999999999,182,191,06120,4
636bba160f26affa226713ec8a93c571,441,176,2,1543.5,100,341,05040,4
d898bdf03c6e695d148b43bcdfd37041,23,10,3,53.66666666666667,23,0,09190,1
197fb2ac0de2dfb961eae37d3c349f5b,26,26,1,182,26,0,03033,1
fc76c211745a3977c89060e27d1c9b35,90,45,2,315,90,0,10040,2
772685230a349835345c7ed243560e27,32,32,1,224,32,0,08452,1
25c10f9c9253c8e7c544a7c4a4b52873,44,44,1,308,44,0,01012,1
41b4ade40abbca84b0e20c145507a2cc,79,44,2,276.5,31,48,01026,2
a122c1567da0825426103334e1312191,93,66,2,325.5,93,0,05100,3
9ce2d88f08a5951a2faa7282a7a8f6b6,33,33,1,231,33,0,10200,1
a6ce19be33e152aa1e27144de4fe38ab,428,171,5,599.1999999999999,386,42,01026,4
217b4c09bcebaa90b8a787c70934a10b,108,67,4,189,49,59,10200,3
fac60c252483d57f10474f093e7bd80e,144,48,4,252,70,74,01012,3
ddf1092dcebafb8c436511e4f7e94080,109,78,1,763,0,109,08090,3
94aa821cb40f65120950f37b2c3690db,166,109,5,232.4,123,43,05030,4
e97f970e14b23a168959087ae0d96c59,148,68,2,518,148,0,05040,3
5c92346a8d86e0dd78fe9afbf0b36402,98,61,4,171.5,42,56,04012,3
208a1631fa20f8220fe9bb23c4aaef23,45,45,1,315,45,0,01201,1
277539007eee5922d8ba513e032b3389,32,32,1,224,32,0,05040,1
673ccd56434cb171d1ee095b0b356dcd,164,124,3,382.6666666666667,164,0,01027,3
3deb76f7b6500d2dbfafa9c59e2814cf,77,70,2,269.5,38,39,11080,2
c25908777c054d551dc4328f3afc681f,43,43,1,301,43,0,13877,1
f10e40dd535cebc05547c1795163b18c,39,30,1,273,39,0,08100,1
077c5e47c69e4eaeab55e14527eca7f6,47,41,2,164.5,47,0,03050,1
4a4456dc0e8a0d21c978afa1073ae817,143,127,3,333.6666666666667,143,0,04020,3
aa89c287f708c6937062e6a6dbe37d8f,50,44,2,175,50,0,01012,1
525254677a262621f138e884ab80bc53,17,14,2,59.5,17,0,08052,1
93ce837098147d77a6a87da929fc217b,56,46,2,196,56,0,05040,1
328123fc55963a306c7965f0bc1c4607,37,29,2,129.5,37,0,01013,1
3ea1923618906549441497b3027f47d3,23,23,1,161,23,0,05040,1
a9b881412792c54d66baa40d98bf46a4,65,53,2,227.5,65,0,09130,2
a3bc0829bca4818a4accc24750da00ce,92,47,3,214.66666666666669,92,0,01012,2
2d24acd4690aaac4b3491144e28c3cb6,19,19,1,133,19,0,03033,1
8ba1f24a93db1f85702430f2f47c9be7,45,45,1,315,45,0,08052,1
9e502cb1e75fb71318d45c37f1704aaa,118,69,3,275.33333333333337,41,77,11100,3
0eeeebda46546272da0b822de0b5dd9d,22,22,1,154,22,0,12570,1
4682483d9c5b07576960d0d6a2804141,308,70,1,2156,308,0,01012,4
4282dd11180423e67b56023a05673238,327,137,5,457.8,327,0,01013,4
72ba498e64729f04d5ce397a8ca290f2,19,19,1,133,19,0,08230,1
2dc75a465a0d0d187d81acd017efddfc,33,33,1,231,33,0,05100,1
6266af3993ae84ca5dede3a27cab1c04,111,58,3,259,111,0,01012,3
8b4f9aaf1f97263bf9a02f1c77c6db3d,12,12,1,84,12,0,11100,1
faaa8797dcb75f388ee6b30bbe2ef779,43,43,1,301,0,43,09130,1
de1846b5c8d93a50e644b985eb02a859,81,49,2,283.5,81,0,08032,2
539b7236c1a2cf5983bc29fc4bf80f2d,3,3,1,21,3,0,09170,1
d060d33924f290e02acfaca10d739d60,234,125,5,327.59999999999997,164,70,10200,4
8d263a836375f6ba4d1bd941011439c5,38,32,2,133,38,0,05041,1
889ae5e1bcabcce444cdab419a2f5f81,59,41,2,206.5,59,0,09010,1
892d9ec84fd364610ee592c81cf972b2,204,96,3,476,166,38,01026,4
2af0c558a372cdcee95ac887265db47d,100,76,1,700,100,0,07131,3
5fcefeac778fb5d4d5645eb5f459b1b3,40,31,2,140,40,0,05030,1
8e7b1fff8dc7aa9fb74501ebd7d1c16a,28,28,1,196,28,0,01201,1
270ffcfd5538442198f30b9584d3d6ab,81,61,3,189,53,28,01026,3
a459ea652c039673dddaf9f9a47c9a5a,179,86,5,250.6,179,0,01026,3
016381714f92f72c74c616b02c3b6c4b,20,20,1,140,20,0,05100,1
8f38681ddf05c5f4e0559f4c45c089f8,17,17,1,119,17,0,05200,1
40e489030924845e36f541091f24490f,348,137,3,812,325,23,01026,4
cf1b2d817be76d800229e788f2ed1251,35,31,1,245,35,0,01012,1
e9d4725d9f1a6b26c5f508b24ba9fce9,39,34,3,91,27,12,09010,1
9ccf2abb1169d2e587eeedf1f6fb7707,27,27,1,189,27,0,01027,1
fe70af09246725a7ab51a195794d1650,36,26,2,126,36,0,03070,1
80bf0e59887bd6ffcb518697fbcf9138,9,6,2,31.5,3,6,05030,1
2d66c170cc3c197aac62d8876795b563,21,21,1,147,21,0,11140,1
0eb5c62c3779221240eb15d6b82e6375,167,116,3,389.6666666666667,167,0,01026,3
856747694a3b8f82294da6f23a426ee2,66,59,3,154,66,0,09130,2
d7fa2fe776491a768b3c18abf534ed5e,155,79,5,217,155,0,11040,3
d7ada5d794b39b55de06ba83da21badb,65,55,1,455,65,0,01026,2
50cbd93b510e3ceec50b67f580b76ae2,109,81,3,254.33333333333334,109,0,04060,3
4c3feded919d1aa244b0cabb201e8fa8,73,53,2,255.5,41,32,08051,2
0e91851835ae1de6dff61245e7fbe60c,14,14,1,98,14,0,09030,1
2eba13eac040f7ee803434afb29021c5,15,15,1,105,15,0,11100,1
735f6337c5c6e76c75b287ef2cf3ba6b,43,41,3,100.33333333333334,24,19,07144,1
5a1352569fe2d61584ec4c5f28e6c415,103,66,5,144.2,103,0,14351,3
4c24ead46719617bd7bfe6117510ed16,52,52,1,364,52,0,01026,1
51586a8fc81cfea56ae5bdb35075cf09,62,39,3,144.66666666666669,62,0,05040,2
a27be0ad8ea1a96352ce6ba24d1bfe1e,21,14,4,36.75,21,0,05030,1
07010903a9c7319b1096aa240b7fc79e,286,172,4,500.5,226,60,09030,4
51b8e82390c0074dd1e87ba397f4db72,31,22,2,108.5,31,0,02691,1
e7083e3fa27748fb2b0f4915e9cd2495,59,38,2,206.5,59,0,10200,1
e51bdced400ba65498076bf75ff05cc8,44,43,2,154,44,0,03070,1
62877f317ca304bd1bcdc5adb57f4d09,36,22,1,252,36,0,11040,1
f1cffd5f5da9089cc92a6c650830ca3a,93,69,2,325.5,52,41,01201,3
54478c2dc25d2f1bf791d223b3d5ac62,42,42,1,294,42,0,09351,1
e9b5ab5cced28b7b2657244e3cfc4efd,12,12,1,84,12,0,08010,1
e1e38378b5ca3fc2ca0cbf535329aa60,12,12,1,84,12,0,02751,1
caa72ce5ca496a7cd353bd81675d7dd6,344,119,5,481.59999999999997,314,30,01012,4
5103ebd14c6cf2eb29feca8fd0db29e9,112,79,2,392,112,0,09150,3
a9686267788ad7bc86a61470fe572ffe,131,79,2,458.5,131,0,10200,3
6bc0e9c0fed827b130581c02a9a51b90,524,216,2,1834,112,412,04020,4
1e15bc72f589ef4eec019f35641f82c7,7,7,1,49,7,0,11140,1
61ed434d9b3df1984f24547eab8b16fd,89,84,2,311.5,89,0,11100,3
c929ce30481aa9743bdf38c22561cf20,100,75,2,350,54,46,05040,3
d8befe90e66ee416c7f91cf410fba846,80,62,1,560,0,80,01012,3
eb83ca9e85254e1e990b1e70617d6148,57,40,2,199.5,57,0,05030,1
e03b52c39952c08b484106ee7c107b43,14,12,2,49,14,0,09021,1
a23b80efe336c37da38a955d9af28a9a,16,16,1,112,16,0,09112,1
6786c13da0f6d352b8bf0cc46ab7fb37,227,74,4,397.25,204,23,01026,4
dc1690722dede64fff80f3a7563b3ea9,48,39,2,168,48,0,11080,1
a08e14b36b591f488d8bb9a4bd138ebf,200,89,3,466.6666666666667,200,0,01027,3
4139b807b614c31fe972ad25883c1790,43,28,2,150.5,43,0,05030,1
82b81d263a1345dc63ea5edd7d7795d1,39,39,1,273,39,0,03050,1
0491b331dcc0f6a42c2903dde72d0e3e,29,29,1,203,29,0,01012,1
e94c2fcd60fd98d88d757265088261ce,27,25,2,94.5,13,14,12742,1
f810134b99bf38efdc693e47c868a687,61,61,1,427,61,0,05040,2
4eb5b6fa8597d88d15e128c257bf7220,172,99,3,401.33333333333337,172,0,01012,3
0e375b955cba048f33991fe8923bacea,112,86,3,261.33333333333337,75,37,11040,3
6745b0e47ca8c008e6cd2caa232c280c,418,176,4,731.5,258,160,01026,4
d0f2baa98d10a09d03c55cdd49e789ab,137,77,4,239.75,137,0,01026,3
7450a221f619e7a2f44f5bb206df6406,175,120,5,245,107,68,01012,4
d2f01a072eef4b64a02ba55c521e1fba,37,32,2,129.5,37,0,05030,1
86fd7366ab745105e3186747440e8700,79,66,3,184.33333333333334,79,0,01026,3
5e2a332731354f5e128f168da8cfb30c,203,119,2,710.5,203,0,05040,4
ba2c95892b48bd441b65e9cda7679c5a,66,27,2,231,66,0,01012,1
3313b42393deafde774759ae910d11f0,6,5,2,21,6,0,10152,1
e5549a6e23c540fdbb899382a7d597fe,46,46,1,322,46,0,09010,1
e6af054af1c8e05f359d3ebfe8e56d74,164,113,3,382.6666666666667,138,26,01012,3
6d4d6998f143810a460c23750ac085fc,893,240,6,1041.8333333333335,798,95,05040,4
6858701ffdf5bc96d149423d342ce656,56,56,1,392,56,0,09130,2
d4883d497835a071a00c211e0c76aab7,124,82,4,217,124,0,05100,3
4aacf3844b7462e554614b6d7b5c686b,367,122,2,1284.5,231,136,11100,4
2443c899c104ba33ce86e5b440b3df64,115,83,2,402.5,49,66,10200,3
0cca472641dd2dab5468f82012699095,14,14,1,98,14,0,01028,1
9fa97c506d49530abb02f94ce83f1274,34,29,1,238,34,0,10200,1
069f3e08949af89320fdb4538bc28827,54,34,3,126,54,0,11040,1
90d00333400ffdcd6c1be118c474b9b3,43,43,1,301,43,0,04060,1
c1f6b62f372778c79ac68d0e8692de56,65,51,2,227.5,32,33,05030,2
cb70ad42386796a934fb555c6342b1b9,92,58,4,161,63,29,05040,3
b8f9aa1954650cbe261ab3bac07dea0a,53,53,1,371,53,0,01012,1
a19315099938308bb4e65a1e8bb2fb9e,87,70,1,609,87,0,05040,3
3c55e75bf884707814b1f42a668db5ad,109,87,2,381.5,109,0,01026,3
40da7991d8c6abf168fae5aba471a692,368,81,3,858.6666666666667,3,365,12590,4
854834e1ab19050e9b99556ebbb73d5a,59,48,1,413,59,0,08032,1
c3b88b8fdbccd5b8cecdc7c0c600836f,24,24,1,168,24,0,10153,1
bc519eb94da3d4b7573a6774287fbdcb,12,12,1,84,12,0,09090,1
29c2f5a25343c99ee9473855f723733d,144,107,5,201.6,116,28,05040,3
9fe371b99464cde495e746d998229005,165,68,1,1155,165,0,01012,3
4b66adeae1abd47040e8b1d3ed60ca8d,47,47,1,329,47,0,09130,1
c9c4adb2949b20deb6e293399bd164cb,2,2,1,14,2,0,12410,1
eba1b87c42139fe2c880367d9f991855,269,89,1,1883,269,0,04060,4
57c1bdd98f0d56cee58f212012757af5,71,61,1,497,71,0,04060,2
aae00e6ea62fd2bb55010afd577a6054,305,108,3,711.6666666666667,305,0,05040,4
e403a51533e5058b0683cd34a9167a18,114,81,3,266,58,56,03050,3
19ef23fff948db578fb1c0b5d6110ec1,72,59,1,504,72,0,03050,2
a4a43d8ad0a174f0a21bd04b871ea8f1,112,87,3,261.33333333333337,112,0,08032,3
0d0bafd56f2694c3503819774040b044,216,111,4,378,176,40,01027,4
ce649970b7752da245d64cbbc3d9684c,99,90,2,346.5,99,0,01012,3
9b4cf50f636a181ebf04fafb13f26e16,24,24,1,168,0,24,01026,1
ebd8a9b83b9c4facec0de4b68dab3b17,26,26,1,182,26,0,04020,1
739328d4a0cd7df18089e99aceb09e1e,122,85,3,284.6666666666667,94,28,02751,3
89ef2495fa174d2042a6f3fb4511c631,26,26,1,182,26,0,12670,1
6aa7ac1a0e94f4717995f9ae1f44d001,230,101,2,805,230,0,10240,4
6eed03d63f7e7888850e4aa42a667eed,25,25,1,175,25,0,01026,1
b1a635cef5e8948230a00db307eb23b1,103,80,2,360.5,103,0,01016,3
eae1f1e93c38a5ea51d462ce3a626271,124,48,3,289.33333333333337,83,41,05040,3
be7d923ef224ef3dd43b55cb08cea665,74,50,2,259,74,0,10028,2
0d7f4d517d6fb2cad4def0c6912e789f,42,31,2,147,42,0,12501,1
7037794a35c1ea6fd47003a56e43e12c,136,87,2,476,57,79,01027,3
33280b56d7fc59a7d1cd067958cea772,31,31,1,217,31,0,01012,1
3442c95211e33c4553cf2610d9703f67,47,40,1,329,0,47,01027,1
d536582fddeffbf8bf98f1705b7b3bc8,366,158,3,854,333,33,05040,4
22485b12e4ff8e91f47e3062d1d4af61,114,75,4,199.5,114,0,05040,3
bf5fd7ba6eb26d0005577da16eab2dd7,72,64,2,252,72,0,01027,2
e612d153f506d42a304bb0beb2dfe522,27,27,1,189,27,0,08314,1
2d667dad60564b073c989ca5294f4a68,78,57,3,182,63,15,03050,2
b4325072e20bf1997c4c08c59fc35119,424,119,2,1484,424,0,05040,4
4d7bd24d91e387b70de7d42085395210,333,128,4,582.75,246,87,05040,4
5263bf7e88a4dcb1ea24b8dbaccaf3ff,17,16,2,59.5,17,0,05250,1
93e9f18aea70b9fef31e9e05cab00907,6,6,1,42,6,0,04032,1
c6f770e1a1e2770951b7fd143c919744,198,109,4,346.5,167,31,05040,4
57ce135145fdb395250f09bcd5530a07,248,122,3,578.6666666666667,248,0,10200,4
053888931e912a44b6ad2fcbaed8b1a4,129,88,2,451.5,129,0,01013,3
4b24ac6681d085cec6ee3beeb8f033dd,12,12,1,84,0,12,02651,1
a41bf1e4db29149afa768d26fc446d83,34,34,1,238,34,0,08010,1
15642f006dc8594577778484d0490d43,21,9,3,49,15,6,05030,1
e5da676f6668d435ed8ff2a9858703ab,28,28,1,196,0,28,05040,1
a58aa95a3c2d77f5a276524d456f5dfa,43,40,2,150.5,43,0,05200,1
42f8ee289ace3643f0aa494af9d620f8,82,75,2,287,82,0,05100,3
b55afa0f103d7191c7ef797981d36de9,337,116,4,589.75,166,171,01026,4
490bcdfcd791169a159ad293f661550a,30,27,2,105,17,13,11100,1
4e7006db9af4a329cbb0dbcc47b17cfd,44,44,1,308,44,0,04020,1
6e32e29235c7a99aebae903a900bfb3e,63,44,2,220.5,63,0,01026,1
e98813a4be5f27f427a57cab5ff21488,108,63,3,252,108,0,05100,3
f954f66f239da4f67dd0679ae05e3c05,31,31,1,217,31,0,05040,1
2db385a9ec74d289b88cc2eeb55429cc,17,17,1,119,0,17,02691,1
3f94646932d99bfa5d0f68cfbf7c0c79,322,120,4,563.5,295,27,06120,4
018491d3892ac934e57db1cfc884227e,163,84,3,380.33333333333337,116,47,05030,3
84c3095dfc87cc857f47d2799edd00f4,47,40,2,164.5,47,0,08314,1
0c8195f26ea5c3b5516eab48977e0546,21,21,1,147,21,0,03050,1
506fd8f856304b4e9ad0f4f587d6c450,23,13,3,53.66666666666667,9,14,11141,1
1ccd30848b4bdbc93a13e6276f6a513d,132,88,2,462,132,0,12570,3
ac821cd67fd60a9df21c8ca6a7678776,45,45,1,315,0,45,01026,1
62a9c1d078aa4d676836f67b1ebfd5d8,332,143,3,774.6666666666667,332,0,08313,4
743d0e2f6aeae79757dc5b7de9276c04,42,40,3,98,42,0,01016,1
0e5d60de8a2543bba8f68ea348bfc77e,102,74,2,357,102,0,01026,3
1dbf4e79b89c259534dcf6edac71e7c5,73,49,4,127.75,73,0,05030,2
8822bdd16c1da3876927e669643666a9,139,82,4,243.25,105,34,05040,3
1cf8b4640637c8c474015e3a83aa7e80,30,30,1,210,30,0,01012,1
bb7bacea668913666d4c3a440cfe6858,215,132,4,376.25,124,91,01026,4
88906236d173a7015140933a00d88a8f,219,144,3,511,219,0,08132,4
bcaaaee258747ae9fb7c1d17068ea5fd,269,109,4,470.75,269,0,01026,4
c4a2c7a2e5e07814d79a07789ef3bb5b,2,2,2,7,2,0,05030,1
acec3d7de665722e7605e56ab4eb1cd4,16,16,1,112,16,0,01012,1
8be2384067c9941edea634bc033abdeb,70,51,2,245,70,0,10200,2
b8af1e76384c88dd8151cdd8fcc58a1e,43,43,1,301,43,0,10040,1
1a31dc875d63e560713f252ff3a9b89a,37,28,2,129.5,16,21,11100,1
896aad9b98f20141ff4b00cb06504589,489,161,5,684.6,391,98,01027,4
bc825a0818a1a641bfca75e9a95089f0,128,82,4,224,128,0,10200,3
8cb8f5df423d14658d04d3cf0d28fae7,130,79,3,303.33333333333337,92,38,01085,3
a2e69aa0a2646049cb387757d3e53ade,299,133,4,523.25,250,49,10200,4
2d7b4320c2e414d711ac78e5668ebae8,159,80,3,371,124,35,03050,3
7d9fa31b79f1b39b660e305d307dcf86,164,124,2,574,46,118,05040,4
2c4083404039be74c396a3fe4247f9f1,94,69,3,219.33333333333334,81,13,05040,3
d2363cda49c7a2333e10ffe8512ef358,28,28,1,196,28,0,01012,1
970317dd5b88d3cfbdbeefdb092308ee,173,77,3,403.6666666666667,104,69,05040,3
efd01846eae545c633e4bed7d4ab680c,16,9,2,56,16,0,11040,1
00322c1d439808b60d1e5717956afa8e,27,27,1,189,0,27,05040,1
b6bab05d60db37fe64d3ebcb65ab01a1,320,158,6,373.33333333333337,283,37,01027,4
751748356293cde5e8f78d233afb696d,51,45,2,178.5,30,21,01012,1
c0444471f741ab40224d5f6381a319bd,153,121,4,267.75,131,22,11080,3
b3fadb5400c072e7787fc9b33e5840a8,36,36,1,252,36,0,03050,1
8981f200386f7bea6f4b5d3e2e40d4a9,13,13,1,91,13,0,05040,1
9c9e5100662238166e0bb8cb950d8c27,265,126,4,463.75,140,125,05040,4
ee288cb905af00289b39d976447f0a09,114,76,4,199.5,114,0,01027,3
b0666325bb6ed02e4ef31147bfceb1c0,11,6,2,38.5,11,0,05030,1
2aded0e49b9a42211d0dda443eb0e398,30,22,3,70,12,18,05041,1
ac9f6bd566f390413a45df866e9298df,465,107,4,813.75,243,222,01012,4
445f77c429d9c4762baf67976d162d1a,39,39,3,91,39,0,04020,1
90b7c53b46bbf461a25aae347c567a64,535,179,5,749,403,132,05040,4
e465248994fe05d7bd29333d2acf7ff2,169,93,4,295.75,123,46,01027,3
19899a6c661e2b6a3c7e2db5d7631b72,42,42,1,294,42,0,03070,1
f4a73267cfe2b7da0067e6b203b03aca,297,151,3,693,297,0,04060,4
91dd00f9dead2bf04338bc9d488c2577,15,15,1,105,0,15,05030,1
403a6422fd1054b86f1a8f3387e0fa08,23,23,1,161,23,0,05040,1
a5246f2e63e3601d005e75f679bdfdf6,83,52,5,116.2,71,12,01013,3
53daedfc998131848831419fa2c0bd90,170,128,2,595,170,0,01026,4
217d59da45834d7f0454c4a2ce19ca17,15,15,1,105,0,15,03090,1
598fb85e7638ab9210f8e384b44e071b,2,2,1,14,2,0,11040,1
38cef1a3a08006fdceeccba66f795c0d,48,48,1,336,48,0,05040,1
2385dba4f1b0ef3c18a12af5c42bac63,32,32,1,224,32,0,12590,1
ee974f938c16468a84cfeadb71261932,81,47,3,189,81,0,04060,2
636ce57ae5fee08037f0892ee4d6d0c7,33,33,1,231,33,0,05040,1
68f67f96dbbdf456284ad753134a9406,150,34,3,350,138,12,09090,3
8601a91abc80e0285dfb6662bc8a2692,67,67,2,234.5,67,0,03050,2
4cc50b05524c68566b63c1223e83c455,392,163,3,914.6666666666667,392,0,05040,4
6c035568c654826800ed583feee83d01,172,92,3,401.33333333333337,172,0,10240,3
044cd6ea02665c8b56b00411bde8d91c,31,27,2,108.5,31,0,05040,1
911c243752679ee73a8dd5f43a991887,262,132,3,611.3333333333334,262,0,11100,4
04bc715957b26fd17165c3bf912bd687,16,16,1,112,16,0,01026,1
0514e36afcdd286385ac40ed0aae0f96,18,7,1,126,0,18,01201,1
e822912f94fc918af5b40ed587394885,111,41,3,259,111,0,01027,3
604b5bc8df08b0058b4c13190b32fc8a,115,88,1,805,115,0,03090,3
cbeaa2a9970db4bd12cab1fa67fe3240,32,29,2,112,32,0,01201,1
30f88efe5f3ffd20a26c574586f41594,9,9,1,63,9,0,11100,1
08685534a46bbd8ffd387b7a6f2d53b3,76,54,2,266,76,0,10153,2
a9e7c7273e4255a05c0f0d04a440f3b3,81,64,2,283.5,36,45,05040,2
9e672ebf022e440b37d5780719d98d54,72,62,3,168,72,0,05040,2
36f8707938b0e32ae682a8635a2fe814,144,69,4,252,104,40,11040,3
d089523f4a2b3ba2817cdee608f59e7e,34,34,1,238,34,0,01201,1
4a7b84d81208593350886838eb645231,103,69,2,360.5,103,0,05100,3
d9171d0c986a365a74d19c0456c2db27,52,52,1,364,52,0,13490,1
0e8149a37a2dacf8aca4a37abc143a8b,40,40,1,280,0,40,05040,1
f271c220c99902510e7470676c201db7,26,26,1,182,26,0,01012,1
f1eb8c36eb1de18eb91eb5506700cf54,20,20,1,140,20,0,09130,1
c0c03d30dc3e36ecb229458d4aff23be,26,24,2,91,26,0,11060,1
7a58f38180e8f908df51cd0c745b30cf,210,65,5,294,171,39,01085,4
19c993653ee2e3ba6df063a1420fa9c7,42,38,2,147,42,0,01012,1
bb69a4396975f4688bd2b20788b42053,209,116,4,365.75,134,75,01085,4
3ba34677f0397799a4d87cd9f899c738,41,41,1,287,0,41,05030,1
e764445e57fd0592fceb722f561e90bc,26,26,1,182,26,0,01012,1
eef36ff41c040d688441d88bb6f2b564,151,83,2,528.5,151,0,05040,3
0e1bc66620fb6ff2bac4a7e5fb96c8d2,212,112,5,296.8,177,35,10153,4
cc9c5df71e4892d94fec6971dff1f696,23,19,2,80.5,23,0,10200,1
d5ee4170123575d122b98bdb29b1694d,71,53,2,248.5,12,59,01012,2
d27bca7d96c6933ada1d89f5e6ed5241,13,13,1,91,13,0,05030,1
bdb243c1c8d553ef152ffaf8c7ecceb5,40,37,1,280,0,40,08313,1
00536f672ef77ce43cc3509ca672e0cd,22,22,1,154,22,0,05040,1
91bb0b9c657968c66537a8b29302b5e2,28,28,1,196,28,0,05040,1
fd0dcada72d7419cc81d20750619a68b,111,79,1,777,111,0,01012,3
f7e12c8ded9ccf5b689e01fbd900aa0a,20,13,2,70,9,11,12410,1
80202c911dfd59408520103254c295ee,68,66,2,238,68,0,03070,2
1e1708cb118db17123e90ced754e7bea,35,23,2,122.5,35,0,12470,1
90a9ceab9331719868efaa0f3db9e7f0,136,71,2,476,111,25,05041,3
7709a098afaf20544940fe1fece8891a,13,13,1,91,13,0,05040,1
35cd82acff4480ac2b3b9149b1b3675e,111,111,1,777,111,0,04060,3
915f89d0a921ce09217a2d9c64622771,18,18,1,126,18,0,01013,1
4a61fab38be3542db7c124b00bd9ac2c,32,32,1,224,32,0,01026,1
5d44b201530b47a1e53df0a54acdb532,3,3,1,21,3,0,05030,1
9eb5b984e73e274eb81bea3d6d6d9181,37,35,2,129.5,22,15,01027,1
245a3d8aee97443ecdac53d0ad00f419,20,20,1,140,20,0,01012,1
202ec6e9a6fd477ad14c350d354c8c50,26,26,1,182,0,26,12610,1
2a5a5f423c58960115535f6de8f74717,117,85,3,273,57,60,05040,3
3f08064c379830335c510e8156c04e3a,95,75,2,332.5,95,0,05040,3
24c6ef0d926161bc980f2f1906e94769,30,30,1,210,30,0,04020,1
aa6fbbb2c84f01cba935b013b849f7d4,27,25,2,94.5,27,0,02720,1
48ecca1627dcd09b70dfe1879d4124c8,19,19,1,133,19,0,01026,1
8c0b407fabb640124640af0c2bf0ced4,40,40,1,280,40,0,10200,1
0adaf6da0e3df1112b911f48a5d1ddff,65,46,3,151.66666666666669,40,25,10200,2
bf714f3f4f83bea8fe51fc6812d4c975,33,33,1,231,33,0,05040,1
302ad5871228077cfc488f6f1ff2fb42,78,78,1,546,78,0,05100,3
a6d45d5512cced87a51ed2bba9baf80f,103,72,3,240.33333333333334,42,61,01085,3
f38def8908cc85ab0715995ebeba2fcb,117,67,3,273,117,0,01026,3
60ee479657ba2a3d8c311bd69715e4f0,59,49,2,206.5,18,41,11040,2
eeeb370e30243df8c42438ecec95877c,186,51,5,260.4,172,14,05040,3
e2c3435daaabc9808a1bd4151b74d36e,66,51,2,231,66,0,05040,2
869360c7aabb1ed6d7b08da7b0e9fbd6,73,57,2,255.5,73,0,05100,2
dfad7163c46d04b31cc03ff188d2c56f,42,40,2,147,42,0,02690,1
41f756c80a95369d82a5bbc8fbcc9001,44,36,2,154,44,0,05030,1
dc28144e74b1c21ac6b64d86bc56c5a6,136,99,1,952,136,0,05040,3
f6521325742f2ad0e13db3feab0202e2,126,78,2,441,79,47,05040,3
a2bf2f7c1606b843701cf4706aeb0d2c,31,31,1,217,31,0,05040,1
4f2407416099016a55eb58cdee378d89,14,12,3,32.66666666666667,14,0,02691,1
7e50172db8a2542acb2e94e737c1f503,29,29,1,203,29,0,01026,1
cc4c9ff7645c02b034e7cf5ceb0d72fe,62,51,2,217,25,37,05040,2
43f6d323af9179f16595210fbbc236c6,41,33,2,143.5,41,0,08090,1
788512f1bf79ed76aed1d1f22bcdb6a9,56,44,3,130.66666666666669,48,8,05030,2
b998883d3af180852ac075fd66117e4f,27,27,1,189,27,0,08051,1
043843df0b0b3602d12db4a4e72d2499,282,142,1,1974,0,282,03050,4
e7e1385998433165ea0c2863a8e7ddf6,29,29,1,203,29,0,08090,1
2648c1725b69de9fcfeed940ef4ac170,50,42,2,175,19,31,04200,1
063a8ddb5dc4ba08128df57597575ee6,380,92,5,532,296,84,01026,4
2bd98c4c9ea3a247eee249755b812c09,42,42,1,294,42,0,01026,1
06a9cee6b1a2de69bf546db30e339399,31,31,1,217,31,0,08010,1
dc89831c818f442c4f0cf715d62a5e28,20,20,1,140,20,0,01013,1
9012b44ec08e2c6f2667e58ef2928011,39,29,1,273,39,0,09090,1
4bb466ce55ecf0b4ea15ba32adb68de1,136,91,2,476,136,0,05040,3
9700d45d43bb6821e3645ee575b5dfbb,22,22,1,154,22,0,10200,1
c6e3af07301a1f603f7585239bcb8b83,23,23,1,161,23,0,08010,1
7158364c5eaa5e0c49b53f17c57f586f,87,62,2,304.5,41,46,05040,3
c59b97b54452c35b741f7b504e8e29b1,48,48,1,336,48,0,04020,1
d4012a881483d822ab5fe76158463146,33,33,1,231,33,0,05040,1
7402de247138adcfe00b3a13127c2b8d,11,11,1,77,11,0,12501,1
3aa65a6f49bdeba23a11de749bae9ad0,87,68,2,304.5,87,0,11080,3
a4f0b6d773b9cba6be0eeab8ec8544d7,27,27,1,189,0,27,12500,1
fffe9d2f20500676c5f4f22ba7d482d8,236,64,2,826,236,0,01012,4
235650f697b595db210ac011b2c81276,79,69,2,276.5,79,0,14301,2
97327eee46c50c25af068731e3089215,50,50,1,350,50,0,05040,1
99c15f78d853ad41c945daf07cdf3b0a,65,40,1,455,65,0,09010,1
5623d492d8894dfa6def9e681d9da6fa,48,44,2,168,25,23,01012,1
e43bdfbc54de6890cbbc83b1f582e908,48,42,1,336,48,0,01026,1
cbf7c460b5807431b7c1d70ff542e93a,22,22,1,154,22,0,08230,1
0c327e5f0f4e79cf2e6deef2ffba9a0f,104,69,3,242.66666666666669,55,49,01027,3
bc43bfeb97f5a448a908eb5a26fc2fbb,26,26,1,182,26,0,05100,1
bce38c15fb32155eec0c730b4de86d09,247,122,4,432.25,155,92,01027,4
d586b235418a43f4028da3eff10acd80,60,60,1,420,60,0,02690,2
e1718fcfa631974f82479e53b8188909,39,39,1,273,39,0,09130,1
1e188e12fac1824c7a75d78a5858ea71,160,90,3,373.33333333333337,160,0,05040,3
d5d0509bd748203a8cab5b27fb65be5e,31,31,1,217,31,0,08100,1
0114f7935458391c5460e9509f86a494,32,21,2,112,32,0,12650,1
59707aea1b7c2446a190e754bf428d3f,28,28,1,196,28,0,12570,1
4066ab3c10471e75eb44c2d7887e6c32,23,18,2,80.5,23,0,05030,1
d63eb8fd75d024b629d1d6f62c73ccd6,57,57,1,399,57,0,04060,2
3a45264fd29b484d32fee92b73270610,148,100,4,259,89,59,05040,3
c7e02a6f4a0550ecae8652b3302b4985,125,59,3,291.6666666666667,80,45,05030,3
dd728a8439b11fd5998da6807937f15d,114,67,4,199.5,114,0,01013,3
7680920fb18bd311ea2d24d6b9d9d7e4,97,77,1,679,97,0,01012,3
40a9e39c1d44b8081c21776e5ace45e9,20,10,2,70,20,0,05030,1
8ac145ebb582d0d69a47c5dc34e23947,21,21,2,73.5,21,0,05100,1
f8da1a04758d9d6bc7638d80bbc43a35,70,58,2,245,70,0,01012,2
dd44cb5bd049ffa2dc5d169d8a5c7f28,32,32,1,224,32,0,03050,1
931aa04c4f3320178183c654da1c20aa,18,18,1,126,18,0,05040,1
90329b1bbb03155cb32fa575e8159e9c,25,15,3,58.333333333333336,25,0,10080,1
297e6455377a8bacba9c89088db2874c,11,11,1,77,0,11,09130,1
86cce222f88a2fb4cad0f2557befff02,106,76,1,742,106,0,01026,3
5b8cb7437b50cffd71e7075b5109dff8,52,48,2,182,17,35,05030,1
905c6c2d72d3a0ec8c613daffc863989,26,26,1,182,26,0,08100,1
ac7d29e3cf8430e748c823fa58812b65,36,36,1,252,36,0,03050,1
88549882d418b1060e595dc79cbe3015,70,43,3,163.33333333333334,50,20,05040,2
506983daec48699f6bfb16eb83e8f07d,61,42,2,213.5,61,0,11100,1
c305b04048428ff0f3cfcb3fca5a9fb9,148,98,3,345.33333333333337,148,0,05040,3
d32eb383989fc49ddb0d27e233c68d3e,18,18,1,126,18,0,05030,1
0a653383e675c43a4115352eef58b528,68,68,1,476,68,0,10240,2
9f661de6df6710b34066f908fdcc6fb5,10,10,1,70,10,0,10080,1
c6e753aa6a1f2011591d3cd2094a6aee,192,95,1,1344,0,192,05040,4
b3b6a41a80cec0e84e4e7e2aa06d0b9e,66,54,2,231,34,32,01026,2
ebd81681da066767facf3442889f7fc1,70,54,2,245,70,0,01013,2
31a54276088e037556e2e06d94f32a7e,70,54,3,163.33333333333334,70,0,03090,2
cfe75259378835891c06f8cfa6063985,124,77,2,434,124,0,09130,3
2be7fe4e13203190b6bc26b9ef62de12,204,74,2,714,204,0,01027,3
bd24cb55024b3f014596b16232a37c65,151,125,4,264.25,151,0,01027,3
32e24d1e104cbacc3bab4efba826517e,274,139,3,639.3333333333334,151,123,10200,4
22ab20f38bb9a9cf97fce1ed47850213,110,75,3,256.6666666666667,65,45,05040,3
245c906919794ebaadc0ff13e62cfc7f,61,47,4,106.75,55,6,04060,2
7afc596e7730e9f2dae2b871f70b3bda,76,49,5,106.39999999999999,76,0,05030,3
74312ab99e13409ad8ef5fab66424f66,93,66,1,651,0,93,01026,3
d6e59e20b4b200e67146709ff2244f14,62,62,1,434,62,0,08110,2
57776d286c08945f55ef554408265228,44,41,1,308,44,0,05040,1
9cc411b2e4cfbfafd0445280c872dace,72,60,3,168,49,23,01085,2
5aa1198ef6e89ed2236977a14d2c3bad,35,35,1,245,35,0,01085,1
0c8236b474a70d0b3608ed76e65c8708,30,30,1,210,0,30,08052,1
f94e7872d479ce781cc0f5dd915868c4,11,11,1,77,11,0,12501,1
e34532b58005db7c603f24db481a9714,39,39,2,136.5,39,0,05040,1
33eb9297aef7f3db564e0a26537d2f15,154,129,2,539,154,0,05040,3
62e9ea643fa1a4ad77f78b67b16a2ed9,16,16,1,112,16,0,04080,1
70111a3c210fbd4223c122153b8a3c4b,150,86,3,350,114,36,03070,3
5639d616174782b588d14e2467773681,121,90,2,423.5,65,56,03050,3
429220f144132f7e9518524b124a0d8c,178,77,3,415.33333333333337,98,80,05040,3
8e1ff698e2cb7bbbc725e9360dafb22c,261,137,4,456.75,184,77,04020,4
79cc51d050dcdbf460de185e80a7f109,40,40,1,280,40,0,09030,1
7b5f6333c9deef90f02dd7e9c24f321a,41,31,2,143.5,41,0,08090,1
a090c759188ce9b4cc9ece40eb0d32ca,226,119,6,263.6666666666667,214,12,01027,4
cb412a52f5c961e14a33874bbc739f79,32,32,1,224,0,32,01012,1
eea1aa45d07ebb9de9aad487cf53935e,17,17,1,119,17,0,09010,1
3fbfe98d50e58c43dc6fb82bcfc6ae95,60,26,2,210,60,0,11080,1
fcef0b01a67b2298b5cad37b098e0fa8,57,50,2,199.5,57,0,05030,1
1eba7067515236c17c610c27c8d18d26,91,76,2,318.5,91,0,05100,3
5a252d141b7b639158f12a481d318dc1,39,39,1,273,39,0,10200,1
bdf2b62a5464724391b0445c0c83b63a,29,29,1,203,29,0,08230,1
be79756fdb3a0b11ab02ecc2e331b68c,108,77,3,252,73,35,10200,3
ad34ce76c11f0faa64d9791f3423cae1,271,73,2,948.5,247,24,01012,4
97f3b62c38afb0127162909d0b3de0b1,57,52,2,199.5,57,0,11040,1
85b17b54d599de4a43d4d52258226016,38,24,3,88.66666666666667,38,0,05030,1
cf82387d066b2aa29a2bf13ed85de0c6,236,110,3,550.6666666666667,163,73,10200,4
7146b2e5b74b2691d5f897df1dcdf805,28,27,2,98,12,16,05040,1
0abbec5ccb155fb198163ca9496fb197,27,27,1,189,27,0,12710,1
f8b35570161d6bb3cc9a8b536c60cb23,51,42,2,178.5,51,0,08052,1
6a2b51033c42a7e2c1f7942a791433ee,88,64,1,616,88,0,05030,3
bf1329542e350fcc59ee2f4ba272683c,94,54,3,219.33333333333334,94,0,01026,3
c59a5c8df91e167ed5cde826fa362b44,78,50,2,273,24,54,01201,2
7ea125705b3eabe9ffeaa6b882bee51d,121,79,3,282.33333333333337,77,44,04060,3
819f5a863c031827257a3b6009e04ae0,68,68,1,476,68,0,01026,2
401610e6d2f2c551c8f0a9427e394e37,16,16,1,112,16,0,10200,1
d8a8a639788ce81563f16adaf00526eb,38,38,1,266,38,0,12410,1
35038549b976b55761b5c366efd4464c,101,63,2,353.5,101,0,03050,3
2b6139c1c237fa7c4e894f0fb03f95fd,156,103,3,364,104,52,01012,3
7ba1d64561efba6b006f70dad2b72bb8,34,34,1,238,34,0,09010,1
9b553b997413c79af959273fd5f8d9d2,186,110,3,434,186,0,10200,3
b98df0445dcfc9a150e120c3356bdd6e,312,134,5,436.8,312,0,05040,4
0c15df6eebade18f2bd5748d3784dde9,50,33,3,116.66666666666667,25,25,09130,1
7f0db151adfb4131a1711e6ba1ab85da,16,13,2,56,16,0,11040,1
0cfdb34fda839a4aa9eed4e20bc821d0,183,102,3,427,183,0,11100,3
d545571062a79107029f38bbb8ebc450,44,35,1,308,44,0,05100,1
ec4bf5f157e10a4f1bfe36595805fa27,30,30,1,210,30,0,10240,1
8ba5df966152f1665b3669bc9337673e,258,87,5,361.2,107,151,05040,4
6c62f6a6a2cd1c0504342c08fabaa186,63,53,2,220.5,36,27,05040,2
4ed50085f3839474e44f3aba209d1f1b,32,32,1,224,0,32,05040,1
f24872bc4e1e71c1a5bce40a676d57fa,4,4,1,28,4,0,02652,1
923da37747fc7b37553efe29ecd1921e,21,21,1,147,21,0,09030,1
1ab8c789a4d3a2fb1f4037b83afea01e,42,42,1,294,42,0,05040,1
5a81c477dcc164367b295a8e3ec80ea8,59,49,1,413,59,0,01026,1
8f669447b61c150f0208e8348c0e8d66,88,68,2,308,58,30,12670,3
25abcaf64f60d4bb5541dbc3166dc752,8,7,2,28,8,0,12610,1
4f62e9ea485e23100ddc9ff7096fa670,37,37,1,259,37,0,01026,1
ffb22fdfd60b89c96532b682a1ad2341,100,49,4,175,71,29,08100,3
7c42b841118850cb3287f056caecdf0d,43,34,3,100.33333333333334,43,0,05040,1
38554975693b3fcf64f9b59969d37263,10,10,1,70,0,10,12590,1
30e5b4e380283a8f844d6a118b9e6d83,71,41,4,124.25,52,19,11040,2
248e228740919e8d2609e531f7c00632,100,100,1,700,100,0,01026,3
9ff0634011c494d7a880b2f65d217fdf,235,138,3,548.3333333333334,132,103,04060,4
25746293fa87aa832f4a3b19969504b1,465,223,5,651,382,83,10200,4
7d4a34b64e0a492a838b250d20e3d18d,56,44,2,196,28,28,01013,1
521e2d234e2fd5f7f86e0ecc11464c13,45,33,2,157.5,45,0,05040,1
900026975779c98e523a4453e277776b,151,68,4,264.25,109,42,09010,3
9690a36019bc2539c41a502769cbc4bd,17,17,1,119,17,0,01013,1
705310c3e6b4028941a03935dd7a81fd,31,31,1,217,31,0,11040,1
ec96d15b0c96e1f16f5cfdb9ddb17e68,60,44,2,210,26,34,01026,1
98c633b6208f68cbbeb8ba940a3adc51,35,22,2,122.5,35,0,03033,1
b97b520007afa7a5367a3d1c073e89fa,112,76,2,392,112,0,05030,3
6b5b874aa8c85899111d3e7976d9713e,6,6,1,42,6,0,05030,1
ab3d71414d9c09a06b86f8737758dd39,41,40,2,143.5,41,0,08010,1
f1a2dd44f987b84ec91cace94a5a8ee4,41,37,2,143.5,41,0,11140,1
8c41fa8330d730c6e9c2ea2277e658b2,1,1,1,7,1,0,09010,1
858f861fd0a08ee255247f36acea0406,78,49,2,273,78,0,11100,2
55861a04a21ace9f5a06728ec9587975,142,66,4,248.5,142,0,05040,3
5ce12a06e32c33d08b11ae8f4673871b,27,26,2,94.5,15,12,05030,1
1120bfb3cef8c4c3c2b19589c1aff0ec,25,25,1,175,25,0,04130,1
a425128528e374920735ab38a0d19d4a,29,29,1,203,29,0,01013,1
bd04ec3b51a10f4cd360f494670293d6,115,94,2,402.5,115,0,01026,3
2b4de2332b4bc29178d62f23c9001c7a,15,15,1,105,15,0,05030,1
002227ce7dd91136617b2675cd2fa8ab,166,108,4,290.5,72,94,01012,3
dacb5057c3004c8b55573f5ccba7a722,52,47,3,121.33333333333334,36,16,11100,2
725adf99f84f044b11389a0e42e330c9,34,33,3,79.33333333333334,34,0,07143,1
fddd2cc3a480872f18c42391f7da1849,33,30,3,77,17,16,11140,1
c3b7e6d609ee24d8628001f4a2b1768a,168,104,2,588,153,15,10080,3
68c671381e577ec2bd67de0c653d4b7c,88,54,3,205.33333333333334,54,34,05030,3
4a3e349727ae0d0382a1c911a0c4dfa5,52,37,2,182,52,0,11140,1
24eeb05f106fa6e0a186cb3600bdb613,17,17,1,119,17,0,05030,1
0f65717b6f25d387e771e991fb1525e5,141,98,2,493.5,86,55,09150,3
be745ebc98c3aa18b444d7f95473d624,47,47,1,329,47,0,05030,1
58f6a5ae9af1411827a10dc02511aff0,17,17,1,119,0,17,01026,1
0b99e7d563bc17dc9042040bf9126cdb,90,75,2,315,90,0,01013,3
33123c14703f249a06a37bfa78df5060,43,35,2,150.5,43,0,05100,1
46c43ca0d9ad6ba03fd8eaa5c38a4318,87,65,3,203,78,9,10200,3
bfd5772f1d999f410acc5b6e3055147b,24,24,1,168,24,0,04020,1
68ed9cf483d80b7add4d06c5c1011503,68,68,1,476,68,0,05040,2
24c5ac1807ddba228448ff4b6d674c43,352,153,4,616,136,216,05100,4
d115ab52f5bc41aa66a265230b2e0b3d,16,16,1,112,16,0,10027,1
a9523b086e1beb32739b52e149b65784,43,38,2,150.5,21,22,01026,1
a3537f8b50b771eb228319aa24724ce0,26,26,1,182,26,0,05040,1
f9853d8527127e5b87fce896351006ef,73,49,3,170.33333333333334,41,32,11040,2
77eaeeef5b101d8930093c69bb6e104a,135,98,2,472.5,135,0,05100,3
f118764ca00fd906d73dbd4d3f63ea14,62,51,2,217,62,0,05030,2
12aac64a79bf0815c4c0454c6c9da451,26,26,1,182,26,0,09090,1
25e3d4ba9f741132529255db3608d075,1,1,1,7,1,0,14251,1
5b6ea7060c360094aa8feb7a697959d6,38,38,1,266,38,0,01012,1
6f19835e9ba61c30f3d63f14965824ca,89,62,3,207.66666666666669,89,0,04032,3
c4f72eb294c30e02ab034084f25037aa,118,73,2,413,118,0,08132,3
e115e07784b9b4a9c9a1f1c67a0467c9,47,47,1,329,47,0,03050,1
519d58a5acf6f033aa33abfbfb319506,97,77,3,226.33333333333334,97,0,05040,3
bfd9f9c8ce665c5393afbc9f67500783,439,138,6,512.1666666666667,355,84,05040,4
21bab2753844c5718f383bd0533c7421,183,135,4,320.25,114,69,05100,4
5e2339226c2da70523202797b41c3623,167,86,3,389.6666666666667,167,0,10200,3
9ffedd297dbf162017f8d3e1c5c59dba,31,31,1,217,31,0,01013,1
ff06fb4b08d30ced58b5ffa5a579d04e,121,92,3,282.33333333333337,58,63,09130,3
d360cbe350e119869f0227f34470dfea,44,29,2,154,44,0,05040,1
885778374252d9ed51eee92819b91947,147,80,4,257.25,147,0,02690,3
56508b03250e578b5482d8706e915e54,48,34,3,112,20,28,10200,1
88831dfb0f79a376b3914222cd2fdb7f,4,4,1,28,0,4,13930,1
38fe34e4693e93c367cb4e4c4b7f096a,109,31,4,190.75,109,0,01012,3
ecdf010a0123ce8f6470cbcfef1deafc,14,14,1,98,0,14,05030,1
550d92cabe9a9f178f882c77f5b7c3ab,5,5,1,35,5,0,04012,1
665b544fd9b0988755f17b2e40342543,27,21,1,189,0,27,05030,1
549984b5f6cb7dc8f7354935458a5583,18,18,1,126,18,0,05100,1
f273ff32144eec20d2c581c0c2426839,76,56,1,532,0,76,05040,2
70140cdf931ae0bf0c1a3fe7435cfc07,55,41,1,385,55,0,10027,1
e9c94af960632b9cd6774d7271d44bd3,12,12,1,84,12,0,01027,1
3f37102d66a1fdd3eec2c0fdc84f4427,67,46,3,156.33333333333334,66,1,08010,2
ae39707d16c07d8ad6d1d4bba67ec039,5,5,1,35,5,0,13930,1
83522ac06137fe16ed82bcf507980c10,132,76,3,308,91,41,05040,3
61c6c609ed051ca4d0de602cfa5ca31a,39,39,1,273,39,0,04060,1
c2f055a73afb6428c47e57e8237be036,52,44,2,182,28,24,01085,1
5ba7b8afb6b00576685b94615a197703,53,48,2,185.5,53,0,08052,1
e2d9680b479d5921c9da0d99151f7872,154,72,4,269.5,154,0,05040,3
a100244e7ba3abf3307a766d5dcc3597,237,64,3,553,237,0,05030,4
189d9dcc1f268265afdf44a544f363b6,33,33,1,231,0,33,01026,1
07cc586a05b39e5ca34f299c04f6aa3b,83,57,1,581,0,83,05040,3
74a564144b84d9e54dbaa3afc60ade46,119,107,1,833,119,0,01026,3
292aff3a5596a2337265af42a571468f,21,18,2,73.5,21,0,11100,1
e4e711d14408dbf844c67b36025f5d0b,43,43,1,301,43,0,12590,1
f1bbc24addd06a53236452cb9f4b249b,33,33,1,231,33,0,10240,1
2decddc5dd4357d52b5ce7eecc82e8c7,71,29,3,165.66666666666669,71,0,11040,2
5b547f56cd72a3f9bf12ec99db0a25cd,113,71,2,395.5,113,0,01012,3
a1ba196960df0cad9667d3f918832da0,63,52,2,220.5,63,0,05030,2
8c117e5be76f09cf4d1d3d6351d5fdf9,60,39,2,210,60,0,10261,1
48a0f24403c739d074df830ecc22575c,136,91,5,190.4,98,38,02691,3
17a06ab9e6aa37d2e11e7adafcfc2870,8,7,2,28,8,0,02650,1
b43dfa21ab85b52eb699f614ac4f5f9c,54,47,2,189,54,0,01027,1
2dc94eada6580b431674373235f8da2c,64,59,2,224,64,0,03050,2
17b4c3859262abfa8c668ab9ba5e3c3f,92,60,2,322,92,0,05100,3
a6e2a8a763326b7495f1dc5dd4916d28,236,113,3,550.6666666666667,236,0,01012,4
8b6aadf6edceaf67377af2a88d5627ce,75,59,2,262.5,75,0,02756,2
07a19d6b2feacc35189597da706f6bfd,10,10,1,70,10,0,02652,1
fdbee87770fc990df75a775892792696,76,62,1,532,76,0,10200,2
e493f4df42842936191cff5b93808f6e,51,51,1,357,51,0,08090,1
ad1710b6df454b1cdb13599401fd0df4,9,9,1,63,9,0,03050,1
14490d8e22b674f068d075bc8e3893a9,223,77,3,520.3333333333334,206,17,01201,4
4985794b69190a3f460fee0e164c8eb4,48,40,2,168,29,19,12430,1
947fc06aa5adf3f0ef6b16eb604c2025,27,27,1,189,27,0,11140,1
97d83f8a6e033353309547a81adacbaa,78,72,2,273,78,0,05040,2
0ad975b1df101c8099d9fbe15e160813,23,23,1,161,23,0,03070,1
ace885e58560cd85ad78d10a08afb744,170,94,2,595,170,0,01026,3
c7b9aa7c6f048f698374faa1066e0d5f,237,112,5,331.8,237,0,11103,4
a5def00dac54bef4217d34730f4320f1,184,105,3,429.33333333333337,157,27,01027,3
06af9784f7b18c8ddc7ba530f10c4505,13,13,1,91,13,0,01027,1
95505ed760fc98cb58f5a093e7291cea,107,90,2,374.5,107,0,01027,3
a32e5d89a2132f808142ca84e2de9d33,21,21,1,147,21,0,10028,1
2925d09d82f65be9d168107b70a959b5,71,54,3,165.66666666666669,48,23,05040,2
1ea7ba03f378968fc2ba06b699b7fe1f,13,13,1,91,13,0,05041,1
7cf40a51a6f1cda7b55ae71ff8c4279b,86,64,2,301,86,0,01012,2
e478be408468729d92172b6499771e04,275,132,6,320.83333333333337,248,27,05040,4
965f4484b47da8bbc7c2d12258834b8b,54,50,1,378,54,0,01027,1
d1366c71356d94a1dbeb302a9afb50e6,91,64,4,159.25,91,0,05030,3
ed94c1d3e230c1a6c87227bf293264f1,99,84,2,346.5,99,0,05040,3
7d43586b88575dcb3c2bc4e2a7419033,47,30,2,164.5,47,0,08032,1
9981049a20ab19d31d30b2b93110ccbe,201,115,1,1407,0,201,05040,4
70c811bc495d38c7ca8a8323f435d622,18,18,1,126,0,18,01012,1
7a95d1f5dbd40e5468b694a9d86122ec,37,37,1,259,37,0,03050,1
ed7c971c1e87018fd0a262cb5cdafc2a,55,47,3,128.33333333333334,55,0,05030,2
8822ba1994046d02e8eec71ada264e14,40,40,1,280,0,40,01013,1
bd9723327bf61fa6c9e1d9a83064d0ee,104,55,2,364,104,0,04060,3
1507b20e7b88a90878243645e34610ac,43,33,2,150.5,17,26,05040,1
50414d3bca00d3d6274e1d8816b8552e,31,31,1,217,31,0,05030,1
3d94ad1f033592ab5e6212088a7440f8,27,27,1,189,0,27,01013,1
8ac0968fac0f8eef798e9f5335ee0389,30,26,2,105,30,0,05040,1
fbd97c1debaa44b293199bbbf8548df0,48,35,2,168,27,21,05030,1
34d26e113fce71eb4b20e736ef6b8b7c,134,51,4,234.5,94,40,05030,3
83b6e92d61c434717d24a02b0cd6a61c,76,53,2,266,32,44,01012,2
ef2655b09132bf2720e5f9f40d805301,7,7,1,49,7,0,12470,1
58863369d1b444f65444c0b7f0b10b0a,83,49,3,193.66666666666669,83,0,05040,2
d2586423f348c95b3cda984197c7b4e1,73,58,1,511,73,0,05040,2
452a4b4869dfb5158cbee23a161c1197,84,70,2,294,84,0,01026,3
08cef18c677bf78c1be9e64ba67ffbdc,317,131,4,554.75,118,199,01012,4
be567288796bed0b95686361105ed880,234,126,3,546,77,157,01026,4
b40ec6efd92a2ee8bdf6baeb5a56b464,50,43,1,350,50,0,01026,1
13b84a066c35150d882e9061d669a32d,52,52,1,364,0,52,01026,1
6e07a61943dee3084fcdc651a5eab52f,50,50,1,350,50,0,05040,1
8650f3f401ed801853f9c595b987bfcb,32,32,1,224,32,0,03090,1
c64de7897faf7148b2c91e36ff145543,27,27,1,189,0,27,01014,1
1cf1abf45d102a22ec448cb372a4d9a0,75,58,2,262.5,75,0,08010,2
ba3604114e49fbc9c38f6f5503361c61,36,36,1,252,36,0,05040,1
6291c34c5cb1dfc160241ea2fb74774e,381,181,3,889,312,69,01026,4
5a3b91d7770bdba4d6337fa4973447e6,77,63,2,269.5,44,33,10200,2
fe19f9302d0897ca621ca96c2f07365c,45,31,2,157.5,45,0,09010,1
33906567f159d149b2575ddcc00f095f,314,117,5,439.59999999999997,314,0,01026,4
62b0bc9a154d7460d4c68e4d10b7324d,61,47,1,427,61,0,11040,2
9ff22b67b1856bb6ae38a73888d3c521,111,85,2,388.5,62,49,01026,3
d4252553fd2f3b7246e1ef02dc13c37c,26,26,1,182,0,26,10240,1
75baddb132f77beff96d1325c6acdd82,8,8,1,56,8,0,05030,1
4704c2a724ff9fbfbe970dc09200637f,20,20,1,140,0,20,11080,1
a0a46494ef74de4b51a4f39bed28efc3,39,32,2,136.5,39,0,01028,1
c06001e7c7a6628ad6204b160c871b2d,111,50,2,388.5,111,0,01012,3
336fc0f4fea121544fa1550eca209c9f,12,12,1,84,12,0,05030,1
e6545304770fd6593e30283ce3bba0d4,92,78,1,644,92,0,01012,3
ab8fc499e25846e982d13f0c196832a6,98,84,2,343,98,0,01026,3
f70007cf15bcfee56de63b78382fa108,21,21,1,147,21,0,01026,1
c1e614b30ea9aba3ec12b7569a14a7f5,4,4,1,28,4,0,08090,1
fa66346ed448d05695e18ea5734e2b74,69,56,2,241.5,69,0,01201,2
ced649186b9e4c757ae618e3c96cf6d2,73,48,3,170.33333333333334,73,0,03050,2
272086ad17787113e08515d290bb7889,35,31,2,122.5,35,0,12500,1
885ec6c07c8b519279162e8c379b62a9,28,26,3,65.33333333333334,14,14,05030,1
cdf5ec07a9880da94d437ba718ee7a71,2,2,2,7,2,0,12570,1
53f7194e8a37556e605220cf14074acc,6,6,1,42,0,6,05030,1
230d08ac6377c7947db5dde461b67cb2,179,99,4,313.25,113,66,04060,3
9e85121a37db1d68c1650de508315f62,24,24,1,168,24,0,05030,1
e290b16877f20c7eb0c262289b92482f,57,40,2,199.5,26,31,05040,1
b6b041172b5ff987df85dec89ea74788,24,24,1,168,24,0,01026,1
063e8296421e8da1a14c98f46c5d121a,33,33,1,231,33,0,05100,1
f414bc45cf748e6f7c7de70d5739612c,23,22,2,80.5,23,0,05030,1
9bd0f12c4e0478ac7bdbe7e9f8c9b228,266,106,3,620.6666666666667,191,75,01026,4
72ee6f7625f6b6d97f4457ec4d4f4f76,304,183,5,425.59999999999997,250,54,01027,4
9e305872d4b4d7a99c9af4f746d2ed09,23,23,1,161,23,0,08100,1
9ebe8330ffd103cb1f7ef925529f54fc,143,88,5,200.2,129,14,13930,3
072af65d00618d448b45117a9113e213,21,17,2,73.5,5,16,10028,1
a430b87bbe41b45c0a680b59e1585ab2,14,14,1,98,0,14,13490,1
d300dc1275913a002d9e8b6cd3e3a668,13,13,1,91,0,13,09090,1
b72526e19cdd23bb317491594eded780,63,45,2,220.5,63,0,08100,1
33757d2883deae98d10a091c1ad4db78,204,117,4,357,134,70,04060,4
467836a969c96186ad6cffbe07c3b375,9,5,2,31.5,9,0,01013,1
a25ebca7cbff3451541d6ffc3e8ce246,111,75,3,259,50,61,05040,3
916d117b073dfa0e3023a6dcf4a39614,14,14,1,98,14,0,01085,1
8ed8985917102419f36d8dcd19178e52,169,87,3,394.33333333333337,169,0,05040,3
788b35c2a07995c294c1c3a90021b0ce,116,91,2,406,116,0,10200,3
7649035fae9ac3c56443b766dd928ad3,25,25,1,175,25,0,01201,1
45d4c5fb8c453c29282b657bab02d7d8,36,36,1,252,36,0,03050,1
3339de0a59e3a619a9260b5f31da3cd5,106,69,2,371,106,0,01026,3
c1377cc40e772fb076ca938b48f4f88f,62,62,1,434,62,0,10200,2
4dee804aef94e0e1ea53e04dc2378437,73,55,2,255.5,73,0,03050,2
6a9c68127d66de0cc3682933faee8780,5,5,1,35,5,0,10040,1
27d7e2e7af65bba3ef711200ec1d60f6,66,38,3,154,50,16,01027,2
da9d193fa06d32ac1bc6ba54ba9f35b2,248,129,3,578.6666666666667,248,0,10240,4
3e394e8542777aa2e338658a197039dc,48,42,1,336,0,48,10028,1
b2da0ee44f52b2d7a4d32f1ab1b2bbe5,117,95,2,409.5,68,49,05041,3
ea860e6f09054a97e94107a755b8a562,206,106,4,360.5,206,0,05040,4
b350dece71e11ce41c8d52158fcd4758,7,5,2,24.5,7,0,11080,1
41016ab945ff383fb07bbf1b5100532d,54,43,1,378,0,54,05040,1
20a15a084b4a8849879f9999669b1613,51,51,1,357,51,0,09130,1
ec915b76b02f21d129edf4913ce13fab,4,4,1,28,4,0,11040,1
6a6cfcd79f39d4b6d0d8593d60159310,185,89,4,323.75,158,27,05040,3
4de181753c7c5199c7a4e24b4cecfb02,50,50,1,350,50,0,03050,1
dd70178d10717ba4f66a04f51dad4d3e,56,56,1,392,56,0,01085,2
6a0e12380fa0c2e54e2e9fa955950fa4,75,72,1,525,75,0,10040,3
dbc74169b4603691bab4672816201334,36,34,2,126,36,0,11100,1
fe703b94074b2ec78e7a9f114cce8e33,28,28,1,196,28,0,01013,1
f4c9ccf37f2f917a724c343ae4c8190e,27,27,1,189,27,0,05041,1
8289e7f51c1e182387ac8b24b9807632,30,30,1,210,30,0,08010,1
7c8979c2104f67d70ce133d9c93f9db6,78,54,2,273,30,48,12410,2
a09abec8e4c82965aa6c821f0165d181,64,60,2,224,64,0,13830,2
0eae8efe2c95992d4992c60cb17650cd,12,12,1,84,12,0,05040,1
a83f0646f3d6bce77f0826f897b13b04,3,3,1,21,3,0,05030,1
51dc5e814466752f7ae5bdc69a26310e,3,2,2,10.5,3,0,12670,1
0bdec880c76a78893607f9db59e23bee,275,110,4,481.25,275,0,05040,4
abd182678a2255f87e95ba1a15400d44,29,29,1,203,29,0,03070,1
cb4cbafbaabbb6595fb83972940b7827,155,104,3,361.6666666666667,155,0,01026,3
25aac8d1b9b70dbe7874d83a99570da4,106,56,2,371,106,0,10200,3
1989287178fff66ad3122d8d5a2c19bb,22,22,1,154,22,0,01026,1
5f2c9fcaf054e00368f45a974ac76950,180,86,5,252,180,0,01012,3
4cc2b1fc11ff492499836c1f903e4ef1,39,39,1,273,39,0,03050,1
1e05945f03a64cd5fd09608c7144826e,99,73,3,231,99,0,10200,3
c68936fd15a35b137489007cbae18057,25,25,1,175,0,25,01026,1
575f25ae10ceb95cc7d3fcc51f970aec,345,162,4,603.75,292,53,01026,4
563655ee1203faac79256da3faa1cfe7,51,51,1,357,51,0,05041,1
f4f3cf15985c0dc0b0358c112cc0395c,34,34,1,238,34,0,05100,1
822992284298431b1644682f9a7b44a5,72,51,2,252,72,0,05040,2
b63c1797d0fa7ddf0f042138d5c9a9c7,116,73,5,162.4,90,26,11080,3
8f3f3698ea1e46abcd787005447ed838,232,82,3,541.3333333333334,232,0,05030,4
9f0fba71f527db11a82faff1037c4f22,46,46,1,322,46,0,01026,1
0a61bee2c58d5c95d1744ebc8c7221e8,56,49,1,392,56,0,01013,1
836e9258c61bad221a5958359f058922,60,50,2,210,60,0,05040,1
e8ff144abbd403e94bbaeedfab4231d4,35,35,1,245,35,0,05030,1
c89c7da5422744f9b416517e9b560b7a,55,42,2,192.5,55,0,05030,1
f45b6bc52a95c4f0c2308b16767b1912,184,96,2,644,63,121,05040,4
8de4e91d18037c82aa01a0aa566df9c2,21,18,2,73.5,21,0,05030,1
4967e97b25336946b9381932348f4ae4,127,52,3,296.33333333333337,127,0,02691,3
2dbc2ae3965480c3b4b84175333be2ec,13,13,1,91,13,0,01085,1
64f65e867784832673d85293e629cb30,107,106,1,749,0,107,11100,3
d7d2d21f4a89a45e3088b40289202c45,60,48,2,210,60,0,05040,1
0d9a8ce6ba2116d6cd324a220a816b8b,28,28,1,196,28,0,01012,1
4851a4da05a6c0da440e48efdc9d391d,10,10,1,70,10,0,11040,1
99a1188990ce7359a1d65ff83a956800,38,38,1,266,38,0,02620,1
e45e80abf0afe64b37ef50bb9eb9bfd4,130,91,3,303.33333333333337,101,29,10200,3
19d119c895d7a257496c68d2cf779269,163,83,4,285.25,103,60,11040,3
89771a47df2ea54d32dfd72dd5c1bf0d,3,2,1,21,0,3,11040,1
aec94d9ce6d9f83ac4e32e8c74291cdd,20,20,1,140,0,20,09130,1
49ef8aeb539e97480950570cf15c7c52,256,196,3,597.3333333333334,256,0,10200,4
1da903f134d2a5545de8726e6fb424da,54,54,1,378,0,54,05040,2
6c42619d0eaa57687fa836e9ce434e59,24,24,1,168,24,0,05030,1
b4f96ae25883f182ac2197ad5457d823,26,18,1,182,26,0,09010,1
eee4e3020046063136ba725423a8c782,33,33,1,231,33,0,01012,1
ed550e96dfa0d41fb6883f7f63112186,20,20,1,140,20,0,05040,1
cba1b2e972105e4bcc3f192d88268ee6,35,35,1,245,0,35,01012,1
fb50c6b4cdd5ff2847f8eb20a86a575e,16,15,2,56,16,0,05200,1
04bac86692823816b0def12b576038ef,172,126,3,401.33333333333337,88,84,01026,4
febd9d4544e8a859535520c19409cfdf,50,50,1,350,50,0,09130,1
34105073463ea5ba648dc5c102a8fe38,32,32,1,224,32,0,07142,1
88ad6854a39690a77a1f121e41e3abd0,50,50,1,350,50,0,05040,1
d937b439d32cf4dad7c3632ed571e3e1,719,250,6,838.8333333333334,594,125,05040,4
7a31426d36167f7b036c71919790f822,26,26,1,182,0,26,09090,1
ed32d934dbd2265a4accd3563ed5224c,27,27,1,189,27,0,05040,1
d3c3f13f4aacdb408b19eedd74da4273,214,84,4,374.5,214,0,01012,4
bb8f65c45387202d1975568fe89cd04b,23,23,1,161,0,23,01012,1
6a506f0696e7cb37e800184943d7ac10,1,1,1,7,1,0,11040,1
f73ced5da4a42aecbc2998a921815499,41,37,2,143.5,21,20,04060,1
df56dac9b23ee1e0042550a69ee4ef38,30,30,1,210,30,0,09030,1
06373f493495a47f3ceda61e99ac8bd5,16,16,1,112,16,0,07143,1
a1aedb70951dad1bb0f021540584aadc,37,33,2,129.5,37,0,05030,1
3c1a757b92ff357d784cf625db6a2389,234,118,3,546,180,54,05100,4
7e69ff6f1259ae273d9e965296b84ed3,46,27,2,161,46,0,05030,1
282cffc3264791fef9c564707e363118,45,40,3,105,45,0,09170,1
5dbea6e874f43c7c0c376545aede6b05,299,98,2,1046.5,299,0,05040,4
4a7e5d3f13d8e0554be0c609acc3cea0,65,65,1,455,65,0,09150,2
5b3a51fccce54601b76032a84e9996d3,164,78,3,382.6666666666667,164,0,01027,3
ce71fe88760cec9e2483dfbae4b4f16d,173,100,3,403.6666666666667,32,141,05040,3
b09e47e613bba2998e0c0e80cd82a6c6,46,46,1,322,46,0,05030,1
d880a075fc4289b3c3cf10deaa6e8415,138,104,5,193.2,92,46,05100,3
eb7928428b701a31e60e303891d3f711,168,120,3,392,168,0,11140,3
b6c0d6a4df71e9cac4394c453a124bcd,107,65,4,187.25,57,50,05030,3
10140a3f3f743b6de725739fcb4b10fa,26,26,1,182,0,26,12650,1
b42db38dfad1a534d756b7fcbc630ab9,38,38,1,266,38,0,09170,1
8e2f1e4d54ef8a70206655973b6ab810,143,71,4,250.25,86,57,11040,3
2df13c2ebb3874a22e7f50c51e17de7e,202,93,4,353.5,202,0,11040,4
2e7c6ac9f8ca6db4fea873e47b12071b,144,78,3,336,106,38,10028,3
c79cb41b577fb673232d6218c648b3c1,101,74,3,235.66666666666669,51,50,05040,3
a89af41a1fb2e56b8b96db5e6bfa3858,24,24,1,168,24,0,01013,1
8edd9350eb6cdd2b9060e9c935641225,132,61,4,231,132,0,01013,3
e3825ab7ef32a89a6eb4ec4f993ce018,27,23,2,94.5,27,0,07123,1
4807fcfb666828ae717cba3c2d2660a1,101,71,3,235.66666666666669,73,28,10200,3
40b7b0541dbef51080bfbfe802bf2919,79,72,2,276.5,36,43,01201,3
1d5c55e5e08e6146162f5ebba11c64df,1,1,1,7,1,0,09010,1
f09390592ebad7aa89233e9836c58fcd,407,121,3,949.6666666666667,407,0,01012,4
7d8da53b0e566eef661da41546972ffd,15,15,1,105,15,0,09170,1
37499ae30fcb4364330cb8e5d1659ddd,53,53,1,371,53,0,05040,1
ce681a6e2f8d5941b4fa328d2085c874,30,30,1,210,30,0,01026,1
35ebf8e403818d4114f78787a2b1c91d,61,52,2,213.5,29,32,04020,2
061c1419bea8bd4e6e5f2650f2282169,423,114,2,1480.5,423,0,05040,4
269721b5534e48927c0be2ae890cfd7b,222,165,4,388.5,173,49,10200,4
66636073ae6c942c05ce8ab73089b4aa,79,46,3,184.33333333333334,79,0,09010,2
3298b7f84faaff656b7f9d0f96685eab,23,23,1,161,23,0,01013,1
377b6fe777e69f071ce6d038d1e28aa3,75,65,2,262.5,75,0,05040,2
0a034cf0bd33d62b764898569eb2196f,300,144,4,525,136,164,01013,4
f848eaced9426ed3bb48a11761d27f4a,21,17,2,73.5,21,0,04060,1
966f5d5ab3b5fc45ce8bb74b257c9a33,137,73,2,479.5,137,0,05040,3
050e279a27b9c8e922ad5a0a8a5d87f8,24,24,1,168,0,24,09170,1
42a38c136a5f915de05da0533b64f52b,420,173,4,735,395,25,10240,4
0dc2074beedf2324f69667803aa36fe3,163,120,1,1141,163,0,05100,4
12d20a7ddd8be7c9c83dba253e9f58de,40,40,1,280,40,0,01026,1
d22384f8939961422e4fbd407378f5d7,43,33,3,100.33333333333334,43,0,09150,1
b86809a60cf70ffa123933a165926420,567,166,6,661.5,481,86,01012,4
bf42078cb9cb93d1d1c496e38a0bcb76,71,71,1,497,71,0,01026,2
171a17c1839289f4fe03376392ddf481,111,84,3,259,42,69,01201,3
368bdf5d944abe845a3d968e1817ab1a,217,94,4,379.75,172,45,01026,4
86e8f8c96df4bc85a9559cfc873606d8,703,151,4,1230.25,703,0,01012,4
75cc9d8b15a141800ad0ec29058d073e,72,54,2,252,72,0,08090,2
c32e05fd6137e0deaddb0f89a523fa94,46,46,1,322,46,0,02650,1
9ed0037536b9eb445a83e34b68acaeb0,61,33,4,106.75,61,0,11040,2
1cb9367f12b167a9d790078beae97efc,3,3,1,21,3,0,01201,1
300948b3ff33898a0383cf40fcd6851a,85,68,3,198.33333333333334,49,36,14301,3
d3df2aed6c27c6f642a560e0e1be72df,299,113,3,697.6666666666667,299,0,01012,4
e4f9891fe8f7a70ab635fa6902cbc782,13,13,1,91,13,0,05030,1
932faa7b2e2ffc18fcfca301690c5b86,40,35,1,280,40,0,12670,1
223e4e2ad3bcb3ed85b7c7bb2b130395,1,1,1,7,1,0,09010,1
ef5d9c72100cdefeac956fedfffd83f2,49,23,3,114.33333333333334,49,0,01201,1
47e1bd5c7ac57b44d4ab4ed0c4f934fd,29,29,1,203,29,0,12590,1
44b5ac2cd0af93b5fc3e69436feea3cb,144,87,2,504,144,0,01085,3
3a153909cede02cc4d8e15668d0347ea,29,26,2,101.5,29,0,05040,1
370907ef345ea0c880fce4a44854c769,88,48,3,205.33333333333334,88,0,10200,2
922e5de51d4e0e769ba570bcbdf4358a,19,19,1,133,19,0,05030,1
c15bcb6589ea43844e3e7ef516e08e65,55,31,2,192.5,55,0,02650,1
efb52c509b6bfa9456630f0ee13e4587,51,37,2,178.5,19,32,05030,1
4c9543bef4f558880edad47560aaa9a6,23,23,1,161,23,0,04060,1
a0dd153287cd6ad5acf232a2d1c5668a,111,87,1,777,111,0,01027,3
16b3593add1dec2c4fd2dee28f04b9b6,190,89,4,332.5,133,57,03030,4
c5ae82a738d937182aab4c628bbf2401,65,56,2,227.5,65,0,05040,2
c56167634ce3f05d5e9d5a25d975517f,11,11,1,77,11,0,14301,1
7910fdb1756dbbc5cb3ece1ce904fd28,234,172,3,546,234,0,01026,4
3e4c69bb5a9345d8da704979a00f2ad6,43,36,2,150.5,43,0,01012,1
355ee4ffcf757d449638e7822351e2a9,298,167,3,695.3333333333334,298,0,11140,4
bc754f3c5bc3bb1b781f8359be01dab1,53,41,2,185.5,26,27,05040,1
1e898fa8cb39a05f5af99b0ed24096e7,44,29,3,102.66666666666667,44,0,05030,1
96096c9293a9188cbed49809a691f078,228,107,3,532,109,119,05040,4
955fafaf94559d76bb60185504e33c92,14,14,1,98,14,0,12470,1
87d135d481d4671c7629f18680e510d6,116,79,2,406,116,0,05040,3
759bc99673b46a528e3c6a069e5ce53a,144,60,3,336,144,0,10200,3
a517446c46bf6eac1a42f3df18a6a4bd,15,15,1,105,15,0,10028,1
1f853aebba03833b36a6d5253f8f5a0a,65,41,3,151.66666666666669,65,0,05100,2
b62604d577f2ea9d1892bb72c78349a4,43,36,2,150.5,28,15,05030,1
470aa82e3b60809950c6edb3a9f22529,87,60,2,304.5,87,0,10200,2
6378bf4ba5d5f75d3b8ee9553d7f1b79,112,55,3,261.33333333333337,112,0,05100,3
388cfbfb214c1c316fcfc2c09ec57a7f,88,68,1,616,88,0,01026,3
adca35577a83eb46770cf6bafc39416a,158,86,4,276.5,80,78,11100,3
01b19e93c09cab04f5aaae3c95560597,22,22,1,154,22,0,11060,1
adbaba7ad09984852373b11653590910,29,27,2,101.5,7,22,04020,1
757ef5fbae8852934e3cdad2fe4e1bcc,103,60,4,180.25,54,49,11040,3
f90584490cdd5e816694a97225041f0e,75,53,2,262.5,75,0,05040,2
cd0c62376831bb0daf6031ca4fca41dd,51,37,1,357,51,0,11040,1
5888c69afa3329d153a752584a0c3983,14,14,1,98,14,0,10220,1
1eaaee3c3845ded49a80ab1e9542b93f,144,74,4,252,144,0,05030,3
8a3eac725f608cbb8b5b92793651221b,14,14,1,98,14,0,02756,1
57c783d7dd7ad13fabc83f65aa5a1a5f,9,9,1,63,9,0,11103,1
50bc825b9ad9fa74a6c601d05a895833,170,129,2,595,170,0,04060,4
34b54f1bac1440106dd63ecde3912fb7,28,27,2,98,28,0,12590,1
3cb6c6328b32d5474698227a0b932d3d,21,21,1,147,21,0,05040,1
efc9b3bc76e5e77204513ba5890414b8,84,57,4,147,84,0,05040,3
07c0dc5dadf114fb89286e6b57e41737,34,34,1,238,34,0,01026,1
f9374ed7cc415bb36e32a4361bc3dad3,26,26,1,182,26,0,01026,1
a1a625a2a7edbe6d0cdd84a23f9bb3b4,86,76,1,602,86,0,05030,3
6a62f26ad0a8e27212b4a2e39fda584c,62,48,2,217,62,0,05041,1
85f35d19668e1df493f9a6aea09ffed3,109,79,3,254.33333333333334,71,38,10200,3
81b257db18113755f4d9c7e58a0fd2a8,28,28,1,196,28,0,04201,1
f1b0497fd8cc7d645e7b35d6b7051f02,113,77,2,395.5,113,0,01026,3
8fc21532b5891e1aecf27a55cd6e68de,139,99,1,973,139,0,01027,3
47c7488f37025a5f74cdd04f20ce4060,345,140,5,483,281,64,05100,4
8d140b0bbaa892d503ed473a0999a2f1,30,30,1,210,30,0,05030,1
9cfd6d161733ed8280558937112a0dbb,28,28,2,98,28,0,05100,1
5fc6524736ec0f07e7efde3ae00eea14,74,74,1,518,74,0,05040,3
ea2ce03c814d8046e894650289d6d24d,47,47,1,329,47,0,05100,1
8d2ee119fb15754b39612a7c8eef3d72,35,32,2,122.5,10,25,04060,1
f030a6110e690bf41aa49942a4e4a44a,106,81,2,371,106,0,09130,3
250a55da564c491e79331e0a90ab716d,8,5,2,28,8,0,05030,1
36f2c1cebef0b4b0785ffb05c1b36878,99,71,2,346.5,99,0,01027,3
e6cb33f727d02afd81c238b95e8c7086,130,89,2,455,55,75,01026,3
6a9b2d6e16159db5bb2db5b42813d12b,148,101,1,1036,0,148,01026,4
4c97a0d9b23e810cce1cbfafce0ce1fd,27,27,1,189,27,0,05100,1
e96467652474e56d4db2ceb8117dcc47,271,101,4,474.25,271,0,05040,4
ac6754737b9fe8d5d8455946a99ec09e,255,142,4,446.25,255,0,10200,4
b63cafe8afa2ed14ac313f514cd6f13f,48,48,1,336,48,0,01012,1
11d59e2f1641254050127a0738cf731c,40,40,1,280,40,0,08100,1
c5a99243c65db07d1a336df71e5237ce,35,35,1,245,35,0,08010,1
11e3b035d701d450b6f1c9f946345232,20,10,2,70,20,0,05030,1
cb75b0276087949e1033262793f36bf2,144,79,4,252,98,46,10200,3
c8608cbc2d7bd1a8d7ac9a114fcbd242,151,76,4,264.25,117,34,05100,3
dbfa88a0042cc438a92963e5cc8b49e6,19,19,1,133,0,19,01026,1
3b09b265d56f7babeea6886317c1dddf,32,32,1,224,0,32,03070,1
bbed9d87a0d0bc35bef8b9b6bdb375fb,52,37,2,182,52,0,11140,1
fc55a756ff6d598aa94ec8c4d3aef7bf,25,25,1,175,25,0,01026,1
e074e1af39f1b83a7a7f8caa69ff69f5,21,15,2,73.5,21,0,10200,1
dcbc02ea0e5e063026fa727c97aa9470,46,44,2,161,16,30,02650,1
994f9e70eba0dfbded6ef6755b60f3dc,238,114,3,555.3333333333334,147,91,03070,4
8a6ba9d41590a21a2b527224af897ad9,37,32,2,129.5,37,0,04032,1
cbf0af11e202dcd1850b9fb67bf206d2,222,102,4,388.5,182,40,01026,4
cd097d6409fa7d965aae465674f63778,28,28,1,196,28,0,03070,1
232acd1569f103eeb1e566c9efa5c5f9,12,9,2,42,12,0,11140,1
f02eb3a26f9630115e5698611160ebe8,64,54,2,224,64,0,01013,2
995476fc15820040808b0b3eac00b781,48,41,1,336,48,0,01026,1
2dc6e1a230dee45dc65b44367f228085,83,81,2,290.5,46,37,01026,3
6d267d9ffbab54bce09c01d27e2abd0e,13,13,1,91,0,13,09091,1
fe6a1f40cc89865544887248ba8405ce,29,27,2,101.5,12,17,03050,1
5d42357aead07717119ddecd3a371652,14,14,1,98,14,0,10240,1
b01a769b751b392b6656978031213325,32,32,1,224,32,0,01026,1
4762811aac958bb4eb35b6cce6f8a055,138,82,3,322,48,90,05040,3
b8920975fd5062e805506b14d7cfc30e,38,38,1,266,38,0,01085,1
53b720dfdb669d4a54024ddaf2e69fa9,41,41,1,287,0,41,05040,1
ca8f8edf5fe14a49f867e2e3347ad358,86,55,1,602,86,0,05040,3
384bacaf0ca6262b9ba890861dd133a9,72,44,2,252,72,0,01085,2
d2e412ac27daa28a5deda81861695f7b,38,38,1,266,38,0,01026,1
3ef97446bdacc3c2a9752cae69726964,151,127,3,352.33333333333337,125,26,10240,3
4ef4466926b7a33f0b5359ee0f3a229b,182,93,3,424.6666666666667,120,62,01026,3
9109c1ed5eb3d23d6a053791577dcb37,71,54,2,248.5,71,0,01026,2
983ecfc7e4ef1e9ee9782011c25b375c,49,49,1,343,49,0,02720,1
1115e4427c633086d91b96c7de5a82c3,40,29,1,280,40,0,11080,1
c92d04ebbaf1c6a22307eb84f83f17ca,45,44,2,157.5,45,0,01027,1
3680810738593b358fa36029e4b6d43b,107,86,2,374.5,107,0,05100,3
9abaa5235d4688a2dd61f770babb8dc7,174,126,2,609,174,0,03070,4
76e5b2fd63cade291c11b50edd2ae8f2,126,93,3,294,126,0,04201,3
8f40d97924d64208f3bf49f66b1e14ef,87,73,2,304.5,87,0,08052,3
0e628e115f452ac99e5ad4982d772b0a,301,152,5,421.4,235,66,01201,4
45b323a4176bb80aac003acca0d0a996,33,33,1,231,33,0,10080,1
1a6dad55389974cd3eb45c65729c801a,24,18,1,168,24,0,01016,1
b373b9265005b985f2eba1f80c2f0c38,122,85,2,427,122,0,05030,3
bd3d2bd78a82d746328008a1ff4e9632,109,64,2,381.5,109,0,01026,3
e28ce7cf133289f89ef69b4340857c88,144,88,2,504,144,0,05040,3
6703b47b6d138006db358902a22e2fab,108,51,2,378,108,0,09030,3
acf2a4377b64f6c9353b8f9ef13c1abc,2,2,1,14,0,2,11040,1
b7c6f57521f647e1ed9f209f2dabcbe4,133,67,3,310.33333333333337,101,32,01026,3
aee4c285dcac237293cacc856c77432f,89,74,2,311.5,89,0,05040,3
605f3ebeb50a80d2a412bea2ddd244fc,26,26,1,182,26,0,02620,1
7678756068d0df54abf594a7f5afbceb,116,92,2,406,116,0,01026,3
73129599e5fad5cdc927ef58ac4a4a17,29,23,3,67.66666666666667,29,0,05030,1
d2db11b2ba19affba103cb45f9945efc,160,103,3,373.33333333333337,160,0,05040,3
5156824b9e17f88de922bd1dccb3ae32,16,16,1,112,16,0,09090,1
82b4e3d5cae7cfd8d9d313165b77eaf9,1,1,1,7,1,0,13650,1
a9d6454b066c994bfc99b9d9df45b9d6,33,33,1,231,33,0,10153,1
2a99c8322846e52ba4f60b194bbbdf8b,152,83,3,354.6666666666667,152,0,01026,3
769878fd98bc82086f0ddecb90e64e8f,119,61,3,277.6666666666667,81,38,05030,3
fbe92635bc2e4c57cdfc41595965b7cb,49,37,3,114.33333333333334,34,15,05030,1
0589ff4c4ee31d97a9a27d9bcf00c100,99,39,2,346.5,99,0,05040,2
e64191425716b452655d60b1137fc10f,41,41,1,287,0,41,11140,1
a91e80e319137c896aa9586b83fa0aa2,165,116,2,577.5,81,84,05100,3
4727b9d4fd9f131145613888c4fd7152,28,26,2,98,28,0,06100,1
b8f6a9c19fc5d96e88af2c0ef2c5fb9a,86,59,4,150.5,71,15,04080,3
ccd31eda234194ea2edb51eb2cc2300f,16,16,1,112,0,16,04201,1
f09cef2e8a466f1db4de2e4d87ced105,46,46,1,322,46,0,05030,1
a2ebcf409892b9ce4f5157ec841ef5ca,67,54,2,234.5,38,29,01085,2
11bfe367c4eadd9b549ba7116f38fb2f,14,14,1,98,14,0,01013,1
d389f04c86ed252063a17ce69e3bf6f7,21,21,1,147,0,21,01013,1
92288d8757b10008306a6ab83b5c91ef,15,15,1,105,15,0,01085,1
1110bcdbbfb228d5ce35a25c65f3d1d5,55,55,1,385,55,0,01013,1
cf0a76359a0aad5d52a6d2ca5503e8e6,2,2,1,14,2,0,05030,1
36c34fe2fc1e500aacdc5cb85655820d,14,14,1,98,14,0,09070,1
d5b007557af5a9e7f9cd9282bc9e86a9,102,73,4,178.5,77,25,11100,3
afc555a66783cdb991049826afd4004c,40,31,2,140,40,0,03050,1
cdf5d71f1a7318aaf3f8f4d4a9e5c8b4,22,22,1,154,22,0,01026,1
3fc4dfcf1c96c3186c4f8dff652bd59a,74,74,1,518,0,74,01026,3
caaec6d104f8a85a7a77fec58d805bbe,10,7,1,70,10,0,05030,1
848be85144bf1c9df3e82cde405bf092,182,103,4,318.5,116,66,05040,4
2666949201cc0ef4031d792fd71eb964,180,113,1,1260,180,0,02690,4
5140e2284141bdc5f23d7ee7692c0102,4,4,1,28,0,4,06100,1
1168f2631f0f604d452e9aaa7b2453d5,247,99,4,432.25,201,46,01026,4
58684d84a3727565b22e2334669774c8,153,78,3,357,153,0,10200,3
08894a09b40563d57835737a5ac48885,148,100,3,345.33333333333337,110,38,05040,3
a87a0965ffd6351c95b8b13cc3c552ad,26,23,2,91,26,0,01201,1
46fe7d484c90adf9fb8ddb3e9feda4a8,329,98,2,1151.5,307,22,05040,4
71aff7ce17c9763b1788d92824f8bf14,14,14,1,98,14,0,09130,1
5a2c76e6c659c436bd109a1bb8d8d5da,85,57,3,198.33333333333334,85,0,01012,3
945ad1a760f0a355b536300a9e56134f,73,56,3,170.33333333333334,73,0,12410,2
bf03b5cfb73543d0f05d2a6ca66d639e,85,69,2,297.5,42,43,09170,3
e1a5429cf8653b2cdde8bace7ac69b68,21,21,1,147,21,0,12501,1
4ca71996622d4d63c270f7ec4fbebff5,283,104,1,1981,283,0,05040,4
0bbeea8329972d0bc9c7497220c4b166,28,28,1,196,0,28,01026,1
d7e5e5b4458e648f2bd6a35aff317cf8,23,23,1,161,0,23,01012,1
d83eedb55e692f568839d0c14f4c083a,27,27,1,189,27,0,09130,1
95751efa40e3984bc02b68f9dbe1e093,402,115,4,703.5,372,30,05040,4
6e1f4a3bf3d271e84b942cf7954e6266,87,70,2,304.5,87,0,01013,3
c6925a4474e08d9e658a69d9419a4041,77,77,1,539,77,0,03050,3
a55453d55b63c88dc130b6bcea932530,69,59,2,241.5,69,0,08230,2
81d5234c318db2ea476549bad883500c,120,66,3,280,120,0,05040,3
85b2411e944ea0887dfe97d3e22f91c5,313,116,6,365.1666666666667,269,44,05040,4
68e606a94a549eba4937de93ef7a64e3,254,101,4,444.5,254,0,05100,4
3799433438e35d7fa3ddca19d5522ef0,16,15,2,56,16,0,05030,1
ec91ab234c37cd9e53eb4b97c6384f07,148,85,2,518,99,49,10200,3
f7132cb02785fbc0e2094e1c4ad5a799,4,4,1,28,0,4,05030,1
d63a0ba41eba5fa2992f238a61f2bc9c,93,74,2,325.5,93,0,08230,3
be93dcdd911cdf1823300b03a8a80f50,36,36,1,252,36,0,13490,1
696f7a58706f5c78f6623dcd6ffbe5d9,22,22,1,154,22,0,04060,1
93199fd5d28f304c5639db9a29d633d7,21,21,1,147,21,0,12570,1
219fc9b21da13f24e41d51a3e07f46f1,12,12,1,84,12,0,11140,1
f89534da1a54ba9aa02657e83e67773e,28,28,1,196,28,0,09030,1
812864c9681839a0c99577e66c496060,458,132,4,801.5,197,261,05030,4
d670d10c938168845fdc7987091040b7,20,20,1,140,20,0,05040,1
18ff26b822f79bf7a632d570a0050646,19,19,1,133,19,0,01027,1
9ef91c6c189d9c51ad21de72a9916c6f,319,119,4,558.25,210,109,05040,4
6a12dbaa55669f65bc366e9be7834fb6,73,58,3,170.33333333333334,42,31,05100,2
a56ffb5f97e0d4135bc8c712ff0ab91d,302,122,1,2114,0,302,01027,4
493b089359ea63b6ae124338e2082f3c,9,9,1,63,9,0,03033,1
bc3be08013400ea43ae80eabca99e044,77,68,2,269.5,25,52,05040,2
1fb49963c3e8c70f541c54f9ea5ba1d0,283,134,2,990.5,283,0,05100,4
ad63500452d74ee8c1d36193d5ffdd95,133,85,1,931,133,0,01012,3
bedaef406908e45d9a8d9ac76fd42346,54,44,2,189,29,25,05040,1
0d9c8339a071f6723924a8707085a339,34,28,2,119,34,0,11040,1
85fe82ffb69523a6ba5489663021e3ce,87,27,3,203,87,0,08452,2
1a3dc1de485f60eba59645d869bb23a4,185,110,2,647.5,71,114,01026,4
dec6164779d5f23e25622f93be7a0cc3,79,58,2,276.5,36,43,01201,2
226c21b0c145320df94ea8858a33ba0f,41,38,2,143.5,41,0,01012,1
fbba0d0f875f6b5e2e7ddf5f7dc8475b,101,71,3,235.66666666666669,101,0,01027,3
8d78c2bc62e0cc39a1f8683744038fcc,132,103,5,184.79999999999998,117,15,03070,3
2b58454ee4cb980cb97c096a3c50f1d7,52,43,2,182,52,0,12500,1
5d7738120cbf6325ec42e5a5e3019f43,299,134,6,348.83333333333337,253,46,05040,4
b1da8a2414ee4de711db7fa73eb8e8cc,102,55,4,178.5,46,56,05030,3
a5fa3ff736103132676fdc3a041d8bb4,34,27,1,238,34,0,11100,1
6639d1595c6356291ecb5ed3aae3f5f3,2,2,1,14,2,0,13930,1
bca3329741631f8525a17d8e59b99e2b,167,106,4,292.25,133,34,08010,3
1ef36eed655808c35ca54d590d273d79,254,59,3,592.6666666666667,217,37,01012,4
5c0a8a32a877d81799b2332091218e19,25,25,1,175,25,0,05100,1
52762385824994338bc6d81ef18d500b,24,24,1,168,0,24,08052,1
14e7c3ed489c1dd86f11ed34d934a897,38,31,2,133,19,19,11100,1
667cbf9f5f8521f671ae258a0dc24cb1,29,29,1,203,0,29,07133,1
768b70c8801c43736271efcbcb716773,82,75,2,287,82,0,04060,3
6040f269e4acf656fdec6d124df26375,131,69,2,458.5,131,0,01016,3
c0a6c96c34310f8d7884908afa9a1fc9,714,264,6,833,659,55,01027,4
7838a700b3560111f2ff1491998874e6,83,46,3,193.66666666666669,83,0,10200,2
b156e76373c864001e9f341450f9ee0c,23,23,1,161,0,23,05040,1
d26ef62f27e2b0ca058697b99afd0b48,37,37,1,259,37,0,01026,1
d86ca6aa82038aaaeaa3f6f4488592c0,111,69,3,259,111,0,01027,3
a5a334228e1e0b3032dcb6da612aee5d,76,61,1,532,76,0,05040,2
7b486794c8bccd214d894a07264e805f,18,18,1,126,18,0,09130,1
0ab7ec44c1a56a11e692ab562a139827,14,12,2,49,14,0,05030,1
f63c3ceb951c3ca524199ecd35d330ab,48,48,1,336,48,0,08100,1
7259bde6a58ef6308773665e8c142f7a,93,72,2,325.5,93,0,10200,3
640a10b5138d6c2ac9bd22868d37e25c,14,12,2,49,9,5,01012,1
0071f575f1817f30eb3c490597ea12df,66,66,1,462,66,0,03050,2
1c477dd830ca38d5985adba900026ce7,130,82,2,455,130,0,05040,3
dc9c34da119b125ddfc9badc15e34431,411,132,2,1438.5,374,37,05041,4
c6887735464c7481b33ffb9976757dd4,20,20,1,140,20,0,01012,1
cbac36f5f683575bf66d8844e6df1ca1,22,22,1,154,22,0,11100,1
18125c1b8aa4ab92e8263740e02af15b,16,16,1,112,16,0,05030,1
f827dfe776c6ae307af0262fd2d9b310,66,47,2,231,66,0,05030,2
f75e726546014c0dbee1d94420ec4da1,37,23,2,129.5,28,9,05030,1
5988846437bece743be9fd46a795d4a4,22,19,2,77,22,0,11040,1
cbc2cc8141f5c9ee630a637f8c6ca5d2,118,98,2,413,67,51,05100,3
4b6074ede80512103e3d5ebebbcc6bed,19,19,1,133,0,19,08110,1
0a4fd477bd96589b875907ec6c7fb6df,30,30,1,210,30,0,10240,1
83b6d38c37dc0c16d005f517b9d74f05,45,45,1,315,45,0,01085,1
e10227a6d8b761eeb5637cc90c04babe,147,60,2,514.5,147,0,05040,3
99d84b73b98738316969ae4763ab3521,30,30,1,210,0,30,10200,1
317a450a450ee32e9b2c0410453fa0d1,192,77,4,336,192,0,05040,3
19ac7739d18c2bd971d673976cb87e40,45,45,1,315,45,0,04060,1
8d6c70384f674128a6df6eff254b683c,42,39,1,294,42,0,08230,1
603400ec8ba9a2afac55e3290459b930,133,93,2,465.5,31,102,05040,3
32b31caf8fcc80c2f09564ae28f2a58b,24,16,2,84,24,0,05030,1
c37938c7354143ea65b0b586e708a477,18,18,1,126,18,0,11100,1
061ddcb7e87a61035e6a507b8b36d290,61,61,1,427,61,0,11100,2
e9947f0a6b877bec23bdfaf6e9644119,87,70,3,203,68,19,01012,3
d8547a4f835333faea4a3066368419ad,76,55,1,532,76,0,05030,2
d149f45fef9eaab2516609944776f959,41,32,1,287,41,0,05030,1
b12798276f7b23b8ceb7d1b07c356253,163,116,2,570.5,163,0,05040,3
8bae08292eb8734b8be8c8a0d37db86a,76,58,3,177.33333333333334,73,3,11140,2
2b0fe1420e4ed69bc691f4767e4d1f4d,209,108,3,487.6666666666667,209,0,09030,4
e2ab2d6776d033a3cacf487c5037dd98,125,50,3,291.6666666666667,125,0,07131,3
d38fcf979bc00f5d23824a2f1557d65f,44,44,1,308,0,44,03090,1
2bcafe9c77f3fef24857796e74da4a3a,18,18,1,126,0,18,05200,1
22d9ea86db056b839852e62caccbda35,18,18,1,126,18,0,05030,1
d5c3f5cf28a327022201db8c74b0fb69,19,19,1,133,19,0,05040,1
440d022b3f25ed845d7acd90728450e3,160,112,4,280,160,0,10240,3
ad31eb944862461dfddbda0a425ea1ab,69,50,2,241.5,31,38,01026,2
b73fb8ac71f8d079de9a5ea30e1b0953,42,39,1,294,42,0,07141,1
251c9163462fcbaec6bf195cc0aae1da,12,12,1,84,12,0,01013,1
ec3f60cb5eeec1f98cd54cefecdd1137,98,82,2,343,98,0,05040,3
58a083f24777fff03ca2389954b21135,39,38,2,136.5,39,0,01012,1
9c78bacd46b499f67e9c323de7e914aa,11,11,1,77,0,11,09150,1
ebc0617741a60a25d0862a462e597421,42,42,1,294,42,0,04060,1
8776c5b9f40ed79fea538e0fb5c99aed,137,112,1,959,137,0,05040,3
c6a51cc5633256489cfaa8d3270181bd,27,27,1,189,0,27,01026,1
795e13afe15faa86ee15f2368b969744,29,29,1,203,0,29,05040,1
6c718128d4aa9e92352096d4ba7d879e,199,65,6,232.16666666666669,139,60,05040,4
56b3446570ee5e5904a3133cc2987621,27,27,1,189,27,0,03050,1
a49a3a62beb0d48e72c774b5a65c9e61,208,107,2,728,114,94,01012,4
4ff166850443e904e7ce2aae27f2841c,64,64,1,448,64,0,10200,2
d68833b9ad067cf60533d292e5b8daca,114,74,3,266,114,0,01026,3
783f6e6ca2f64c7649124443a6749c4e,81,54,1,567,0,81,08100,3
9fa4704026cf01deb678c0c8277ee6fc,108,70,3,252,61,47,11100,3
4c19db4dd2d623252e83dc91dea226a6,88,74,2,308,88,0,01012,3
ff2b5a6acd93c603f7dd853bbd10effe,74,63,2,259,74,0,01027,2
59bf20f4d0280899c09e8f03d00c3233,171,83,3,399,79,92,05040,3
d07c81ec72fc1da370903206b35d6d65,237,110,5,331.8,143,94,13953,4
72a1a0470220c8cf2953074549ad3bb5,73,46,2,255.5,36,37,09130,2
4b30378d13c871cda956119eae474ddd,166,102,2,581,128,38,05040,3
b2945748e9366fa77179014dce5abc18,72,56,2,252,33,39,05040,2
0e13148abaf09d53075d46a0ad26f837,117,94,2,409.5,117,0,05040,3
2c9e9548a39b030bec25a9a99049065c,43,37,2,150.5,43,0,05030,1
0805e030862c53d6a7d51e439291839b,99,64,3,231,99,0,05040,3
5b2b0fb1e1a72ac803a239b06ae71b81,271,148,1,1897,0,271,05040,4
b555c3f732f34b5d0beb9133ea39b056,251,97,5,351.4,251,0,05030,4
21544ed539dcc4ba51e1343ac4a6bd78,177,84,3,413,177,0,05040,3
113ccf497a343465b2d5f1261a8398e0,110,76,2,385,110,0,02650,3
0ec8c2820d096a35b68dcf48379be2cc,47,39,2,164.5,47,0,11100,1
f791adea005f30703bfa62d25fe65dc1,117,66,3,273,117,0,11140,3
61fccdeea4f8e15dbf738cfc2bd2d12b,52,52,1,364,52,0,01012,1
8e8e8b37df5fe08be362bb22a17fb0f3,54,44,2,189,54,0,04201,1
181c68eac54c5c84ba92a81db00a1ee3,285,106,2,997.5,218,67,01026,4
c1a4e1bed9702aa39a01861da75c6bae,9,9,1,63,9,0,05030,1
7220d5b2edf70a608dcbbf2ea348aa74,152,75,3,354.6666666666667,152,0,10200,3
33bcfdb407a4ddd09600ad904b712ca3,35,34,2,122.5,35,0,01026,1
61e2218e5f290a4d17d00fec66a6f335,11,7,2,38.5,11,0,10200,1
62d425352725ededdd6595cf4cd3ff4f,85,55,3,198.33333333333334,36,49,11100,3
c1249bdaf31a5c61c966234606fd2378,266,137,5,372.4,241,25,11140,4
fa671e2f5e58a9508b8a1d6957982d9c,31,25,2,108.5,31,0,03033,1
b42c39697fdc9e9b71c1f12a34276376,53,44,2,185.5,53,0,03090,1
5a596152ac02a0cd09a0cfab7bc4584d,122,68,3,284.6666666666667,59,63,04020,3
bee66d809af701ba512322a6e813684f,104,74,1,728,104,0,10200,3
1a8baad2f13b984eaf33497456695bc2,151,87,2,528.5,151,0,10200,3
c60121c77cf6f4dedbc7670f1c82ccc3,40,32,2,140,40,0,05030,1
b2857a61bd4f81de452e511cbfc8bf1d,31,31,1,217,31,0,09130,1
9a5e84ea8244d76452089104118b7b35,259,126,3,604.3333333333334,259,0,05040,4
29f55a97c2391ccc9437370bc5e69688,23,17,2,80.5,10,13,10101,1
e605d228c0605f6a31c9b88228cc462b,155,108,1,1085,155,0,01085,4
5c854391a6b84bb396976bc4624c18f2,48,48,1,336,48,0,05040,1
51e818ab882851a2c56d8feb71e06878,118,76,3,275.33333333333337,81,37,01027,3
79510d121ff6c2eb812ead2995c21429,34,34,1,238,34,0,01027,1
8c44de73b484cfed231137cc9e0ff218,353,163,5,494.2,312,41,10200,4
a3377a9927e4f62c767997f5519f6e17,242,103,3,564.6666666666667,208,34,05040,4
e62445152603f6d396b492c1c38fb845,78,65,2,273,78,0,02691,2
6585dd02a465a0fefea6f30d4b3281df,52,25,4,91,42,10,09010,2
f220e9e0b2e44ad14feac80f58ee2828,201,94,3,469,201,0,05100,4
cea152313e228d183717ac6ca97dfce8,120,77,5,168,120,0,09010,3
05ea238e992af4431c605a60ff51a52d,218,94,3,508.6666666666667,129,89,05040,4
d09756ffb33e59b5b552d77f1988d529,16,16,1,112,16,0,12470,1
6292d15a4beb066fb18cc2d76c83b2db,48,39,4,84,48,0,01026,2
e16ed81419f41c86a83b2b7b713b3899,66,56,2,231,22,44,09150,2
76543206e00fc8fea6c97c657f68c363,12,12,1,84,0,12,01201,1
c7431050a3865b3abdd1085b4373861d,35,35,1,245,35,0,09351,1
415a2c21328d76c798352ec8f709ece6,67,67,1,469,67,0,01085,2
8fc7d864a1cfb3dc0ac382de29c60fcf,11,11,1,77,11,0,01027,1
1d0414139f72f29553a9fdb5d0629399,17,9,2,59.5,17,0,11180,1
c0de865452969b54be1f93422bf6ae05,25,25,1,175,25,0,01201,1
8071e52cdaa0ee8b95f48aaae148aeca,308,154,4,539,308,0,01012,4
ed6d50d4e566f0adb666a9644dc75062,120,97,5,168,120,0,05030,3
eac9338b8c002c99a06c121760d1193c,31,31,1,217,31,0,02691,1
a43b69e528706f2131f9d2f7a08939b9,44,44,1,308,44,0,01026,1
f862f6ec6e22ecd99511bde47d5fff2f,112,74,3,261.33333333333337,66,46,01085,3
dc2769fa845e2c0d8a3630f9da873de0,8,7,2,28,8,0,11040,1
80c11ce8f3d12d164d58ed80a40201bb,86,52,2,301,86,0,05040,2
fce242bbf75c5e9a428ad068fd9c6f11,268,135,2,938,45,223,09150,4
2f177403ac2512d0d9199ed3e0d450ec,187,86,3,436.33333333333337,158,29,05040,3
7e6ce396f3589ac49b2c59f72e245789,52,52,1,364,52,0,01012,1
b5e9a0148e0d504dea55751c761dbe96,327,183,4,572.25,164,163,01085,4
d54c1f363ec459dc01c10fe202c1e275,74,61,1,518,0,74,03070,2
95e87483bccc597deeeb1e61960ac664,101,70,4,176.75,71,30,03070,3
db55d76f323447d08aa18e8344118a40,43,40,2,150.5,43,0,05100,1
7c2b47979e55b3f5cc5e679365567f3c,93,67,2,325.5,33,60,05040,3
72914b79704b5ff0b6ca5d8c2a55359c,115,80,3,268.33333333333337,72,43,01026,3
d3997196614938b0384fb52e65bac07c,38,26,2,133,38,0,05100,1
95d88419a55799b6c03c221ed3e75cad,115,115,1,805,115,0,09130,3
bd77c6e9763d52db0c9e79e1b4004678,16,16,1,112,16,0,05100,1
0752819fd01d779cea6b04f2b6740176,73,73,1,511,73,0,01026,2
ab581e4a51779aca1886fe9b1ddb13f6,78,47,2,273,78,0,01013,2
1ea226ff26b23502fe77888abf86208d,81,68,3,189,37,44,07141,3
44b4a18505ba2e20b91b9d80cebe9a04,22,22,1,154,22,0,05030,1
bddad8eeb2de27efa163666b3c318aa8,22,22,1,154,22,0,10260,1
df9ff85e681aaba417739c3c8ca15b8c,23,23,1,161,0,23,01026,1
2f937b84a5737bb436d6cc212ce96f76,145,86,2,507.5,145,0,08010,3
9005e6d0ee6bef3d0fa9468b121a92d9,56,50,2,196,27,29,01026,1
b173892b6697aca29849df9349edc925,19,19,1,133,0,19,01012,1
17a62bf901caf0e00ea7d76aec90012b,103,53,4,180.25,103,0,09110,3
8d804b92af2630a10c9813ce4cacea58,172,110,3,401.33333333333337,121,51,10240,3
b4248267a56a46d81fce3532ff7f577f,145,83,3,338.33333333333337,145,0,11040,3
6fcec856db77fc419dd370a43d6d5d02,53,38,2,185.5,27,26,13820,1
7156e6a3c489257643950a3f49904742,44,44,1,308,0,44,01012,1
854e91d0c8aed54faf0a169578002eec,76,57,2,266,76,0,09170,2
b8c2599c8c00a9f882b69e857dfa4402,290,126,3,676.6666666666667,237,53,05040,4
e076a57e467c9039a63c18f4129a6185,72,50,1,504,72,0,02650,2
1bcfa8e835bc5ae3d0243a5d608a32c0,11,11,1,77,11,0,05030,1
729e67bf7364e35806953256747181ad,19,19,1,133,19,0,05040,1
0814f0e6d7e16f867a2b5094713f3ac2,14,14,1,98,14,0,04201,1
7a5b709965c8a1c4f29e62a991567a9b,25,25,1,175,25,0,02650,1
1dd3fc79020f7a1d59b1bf4c7b85fd4a,427,94,2,1494.5,2,425,01201,4
82ea71bd7dba05989fa8b198c9f70e34,85,50,3,198.33333333333334,85,0,05030,2
224555500b1601f7db77dd6f371f80b9,501,232,4,876.75,339,162,01026,4
f04d7a8d71b6d731b022fa2822a514bb,154,103,4,269.5,125,29,11140,3
21a14b8abf8da207baef54d2e0c51b4c,50,50,1,350,50,0,01012,1
47c78b658d29fd53223ce5e74d0730db,787,164,4,1377.25,617,170,01027,4
5f183ff2566c833c0d67acf0945acbeb,108,77,2,378,108,0,10028,3
da2431d5dbab23ab05414ca01293108c,335,154,6,390.83333333333337,289,46,05100,4
673a53b96a34b86298d702b1d44ed2cf,181,124,2,633.5,120,61,01026,4
b8eb6054ffe919fe1f036d4ad0e785f8,66,49,2,231,66,0,09130,2
5e417bd94e70b129b543401f848cfb38,450,133,3,1050,450,0,01026,4
da99c2c89c7fc5b56055baa363d62610,107,72,3,249.66666666666669,107,0,01027,3
8c1c225e4fd1a3132c448d6273558560,55,55,1,385,55,0,04020,1
2126316452d53bc4efb6176e71f77890,363,120,6,423.5,266,97,01012,4
5b166b7441d0bbc3d2698607f3d97bd1,105,67,3,245,105,0,10200,3
a1e86aa3d9ab898e713e90962c040d26,67,44,2,234.5,67,0,05040,2
c0c04eba8574b0fd68a335a90e18ab7e,173,97,3,403.6666666666667,173,0,10200,3
9084b042a1781855c7aa76d808c28e6b,87,87,1,609,87,0,09130,3
6633914d67069b323a951761106a8a24,106,93,2,371,106,0,01027,3
d975773c56db928405056cd2d0a174d1,267,118,3,623,267,0,04020,4
105be44277fa3e5f26f18db3d2135f4d,19,19,1,133,0,19,01012,1
cd7c87ba6428a1acdad379b912eaefe8,87,59,2,304.5,87,0,04020,2
d4a795032663de890cdb98f5fed00c05,148,95,3,345.33333333333337,61,87,05100,3
2323bf55a01620c26c9fe2142231d3a1,71,51,2,248.5,71,0,08010,2
2d106a92ad06427ddcf330ac58a849bb,126,100,3,294,126,0,08032,3
cb40271a1095403c042bda586d22d7b2,28,28,1,196,28,0,09010,1
ca2255c0d1c1ae6f5fd1b83ebb057060,106,59,2,371,106,0,09130,3
351131aa32aaea8806db43de644459ef,14,14,1,98,0,14,01012,1
b713f340ef794cb22bbfa37e7c06d71f,42,36,1,294,0,42,05040,1
b1d2fb5c54b5cd853ae04c4b791ff8ba,21,21,1,147,21,0,09090,1
6e878243e2489348f65bc7164c192ce2,96,72,2,336,43,53,01085,3
3644c183e1ee0051d3b171bba8596b30,106,99,1,742,106,0,01026,3
94a43350777a7f77dbb4ddce658c4d74,11,11,1,77,11,0,05030,1
72fe9568a3eccbf73e7a36380721e961,13,9,2,45.5,13,0,12570,1
eaa5ef09e35b8d7dea881bd07f131aa4,43,37,1,301,43,0,09010,1
215c04971ea471b0c991cb7a410ed3e8,159,98,5,222.6,123,36,05040,3
bf50fd0ec7858d6988d510773421d6aa,234,134,6,273,208,26,05040,4
8484933f5eb811f836d7a0d281a55b87,33,23,2,115.5,33,0,11103,1
9c54fd97d3f95b71d4099b086b02880e,42,42,1,294,0,42,08010,1
85ade2177de570d8ce03eba48a6a1f3c,61,55,2,213.5,34,27,03090,2
f36cfe76342d95239a2de1e5cde1df50,140,86,3,326.6666666666667,140,0,02650,3
e8d05cfcd3f53cd29b908c654113aeb3,52,48,2,182,52,0,03090,1
d975ed3d57fbcec47af0c9f44fa2c3b7,77,69,1,539,0,77,01012,3
22b81e6d298a4b888d94296386f14728,12,12,1,84,12,0,12670,1
874363b3e3ce4fcd9014d5343a6216f5,121,80,2,423.5,121,0,10028,3
6e5c0f4f4c1fd838185e74616f00ead9,308,157,5,431.2,257,51,05040,4
19a1e86825294e03952c38d26d802269,45,38,1,315,45,0,08100,1
ff295df20f30b073f2b3710d6f83faa7,190,100,2,665,70,120,01026,4
2c2dd4d08d7006080172c3869ca181fb,23,23,1,161,0,23,08010,1
7dd897742fd4e63b3494366a44478f01,25,21,2,87.5,25,0,01013,1
34a6f3a0427b00d0b680369b51962388,20,20,1,140,20,0,01013,1
09157a62ef5d1b23d905f927e4bf65ae,49,49,1,343,49,0,01013,1
1271d08b881ce80d94d056f46f73281b,110,83,3,256.6666666666667,57,53,05030,3
a8e2adc9bf170a171d9eb1f92122c398,50,45,2,175,50,0,01028,1
0d5788c5f17a538c726d849048576ac6,18,18,1,126,18,0,07144,1
1a72e933f5be49b1c39d4481743dfd6d,34,34,1,238,0,34,05030,1
7d35e8dd76962db1ba923e39c546d7b3,14,14,1,98,14,0,11080,1
ce67da232f0791dbfb8520055fabf1e7,103,103,1,721,103,0,04060,3
fd3a28548d4826c5447e4a3efeef9745,210,170,2,735,58,152,01013,4
2038e8599f73b0122acee51bf81fc0ae,19,19,1,133,0,19,01012,1
24cae3e2be2f83910058664edba6aa6d,94,54,4,164.5,94,0,10200,3
bb37d283c1c0d756c85bcba1e41ad0ff,106,81,2,371,106,0,01026,3
62dfb753c42c86f4743c0971df968e3c,29,28,2,101.5,29,0,04020,1
0784b3936cfb27eaf08ab40efd7c9847,21,21,1,147,21,0,01085,1
0db50a338aaa63eddce065393035ee5b,209,111,3,487.6666666666667,209,0,01026,4
7ac0e491b30c7004838501f00fd63be2,14,14,1,98,14,0,12530,1
7f578e48ff618a0e0ef66bf41229c5cf,76,76,1,532,76,0,09350,3
0ed4bf57d86017a1620883a0800a3c38,91,76,2,318.5,91,0,08100,3
c89a591941ab94daddeaaef623937de3,213,81,3,497,213,0,05040,4
ed0dda42a017769c8f2d9db1cf26ba78,84,45,5,117.6,50,34,11040,3
afd581904555174bbeb8add1dd690459,20,20,1,140,20,0,10102,1
e0cc7f138e52c3c557d327ac1fa048f5,16,16,1,112,16,0,05030,1
90576ed0a7c7e27c309b255ef562168e,361,164,6,421.1666666666667,262,99,03050,4
d0ea67de767967bc500272c2d3a519ec,214,68,2,749,214,0,05040,3
66f7210f5b3ee830b526b0a4203dd176,110,43,4,192.5,93,17,05040,3
f32b0ee1291317186a3c9686103ade34,67,44,2,234.5,25,42,05030,2
f5b16c23e13f431266cd0409dccd425c,58,42,2,203,24,34,05100,1
9102b2bd62c6b18b22ce0a0c3ffd01e3,30,30,1,210,30,0,10200,1
7b27e5a0abb1ff318e427d28f4d5a50a,51,42,1,357,51,0,10200,1
0ceb5bd8c0d16f371dcfbdc0f105c24e,66,58,2,231,66,0,08052,2
cfe89b3b299cc91563d9e31871ea4ec5,54,46,3,126,21,33,04200,2
4de8638721b66ea70dd0638806b9627a,120,79,2,420,49,71,05040,3
502a1a5bcff3b3e7a43da4552ffcc5f5,113,68,3,263.6666666666667,113,0,02690,3
3401eac7602f5cfadd6db38cb773b9a1,30,30,1,210,30,0,01013,1
667f590e1d559f820f531fbb5e57f1de,99,44,5,138.6,82,17,05160,3
8d61d0d830691582e7e9c33941615a25,135,84,2,472.5,135,0,05040,3
ddfded9a89f88b2c5365d009c1e4c0a7,23,22,2,80.5,23,0,01016,1
6312a8484dbe2e5a4cd1c082f28f8629,78,71,2,273,78,0,09190,2
a279c0d2060cf0ad908bd14372e9eec7,78,56,1,546,78,0,09030,2
10eedf478f7503c33a2cfb3ad663c6ff,27,27,1,189,27,0,08231,1
96b381e15fe92f59b0190330e3e0b31c,55,42,2,192.5,55,0,05040,1
b31ad53fa39ebbcb9e1b7016b93e1ed9,376,153,5,526.4,200,176,05041,4
0b92e0908155ff5398d744e82ca92165,71,46,4,124.25,30,41,11101,2
bab895c0d98244463bebc3c5f9e7419d,35,35,1,245,35,0,01026,1
4f9eff9161a8ea52cac14a14c9dfc111,123,77,2,430.5,74,49,04020,3
13905817536025f71768407fb2473768,33,33,1,231,33,0,05100,1
bb8cf95186113f73299c0ec87a01b634,163,99,4,285.25,163,0,05040,3
3c815a92a60165ee66746a2105ef6f24,166,121,2,581,166,0,01013,3
7b14ad572410a217f021fa5bb87482d0,15,15,1,105,15,0,08100,1
1d5880c2f7917f402d73d11ca24633c7,244,164,3,569.3333333333334,188,56,08052,4
22c4adb059bfcb7808a65ea7c257150d,95,63,3,221.66666666666669,70,25,05040,3
398da08746078d98f87e55eccc088ade,104,64,2,364,104,0,04060,3
57bf482e9d516f25d2b74e9a8e42b987,72,54,2,252,37,35,01026,2
c6c4b05b33acdfc4ae8ccaff0a0022fa,131,82,2,458.5,131,0,01026,3
252b41aaa40abf3772586daf22cfffc2,120,86,3,280,120,0,05040,3
61f57563be5aad5c7737781246c20672,118,86,3,275.33333333333337,67,51,05040,3
d1da820ca95078f7d015aeb958db5bae,14,14,1,98,14,0,05040,1
ba962abd7a22d4075e367567e4f8b553,29,29,1,203,29,0,05030,1
76f3f533c520696b5ddca84b0495e294,55,45,2,192.5,27,28,10200,1
8390035b628ebbd30cd80a0fbdd04dc6,110,85,1,770,110,0,05100,3
728163a84cad51f33d0b6f92dbe2d249,60,60,1,420,60,0,01012,2
3e51e02d2ffd93378373ff6887bc5024,82,82,1,574,82,0,05040,3
5f999ff2f77a5d47e4eb277438e7d716,57,49,2,199.5,57,0,09090,1
1b2d49895dbe0092d496e5544420ca86,192,110,2,672,192,0,01026,4
c9caa9024b04d2f819bf7b11026f58b1,91,47,3,212.33333333333334,91,0,05040,2
707fcaf119c1e2017c5f7ed4e47046bc,149,96,3,347.6666666666667,95,54,04060,3
129c0fc6dd261955fd0f65105ddd374c,109,55,2,381.5,0,109,01026,3
fdd7f751e6bad5908b5421121eb403df,106,85,2,371,53,53,01085,3
22f477dca7ba462d77d7d72601c4c24c,22,22,1,154,22,0,12570,1
35780ee7ad123f7b04e4c728daf2dce7,29,29,1,203,29,0,01027,1
0d30f367d05b45ffa22bc3cbe7f0279d,107,72,3,249.66666666666669,107,0,05040,3
5636c2c20ecabff52904db100dfb0d20,40,40,1,280,40,0,10080,1
aa20045067df0d595ad783cf331e1ce1,174,88,3,406,174,0,01012,3
ac32d0468e42495f7146c6b728676276,145,70,2,507.5,145,0,04020,3
43015b5a5089cd605ff17c8b495a2e98,191,126,4,334.25,159,32,01012,4
93d5cac4fcc6fd5a822d610b6e3b1fc8,56,56,1,392,56,0,05030,2
a66fb0126f8e6d7315b20f1b82864d82,22,22,1,154,22,0,01027,1
a4f2890fa598287afa53c4d85bb3eec7,18,18,1,126,18,0,05040,1
d102f63ae3d2d25602e2570f6f2b0e64,164,82,4,287,148,16,05040,3
ac2886ed0249257f2c33152eb96d6886,239,126,4,418.25,203,36,01026,4
00abab2d6d24ec7092b71eb31312a561,39,39,1,273,39,0,03070,1
1b68b1db07a958704b49b0b325b99b4a,28,28,1,196,0,28,10240,1
dda4ced34d9621ed372b30d77d766ab4,258,170,4,451.5,258,0,04060,4
830ae38c161e8c59073be2c00ad4e6b8,603,184,2,2110.5,551,52,01012,4
828de4e98c664ea162b4eaa12dbf20d8,17,17,1,119,17,0,11100,1
9542017a9ff81e61df7a63cd3ab5142b,67,50,2,234.5,67,0,05100,2
2d9b54cdcc9b6d639cfd4d9c7ec6fcb2,31,31,1,217,31,0,05040,1
3ac0d15636ad1c71b8978a458a1251d7,19,19,1,133,0,19,09210,1
613fee8d2a2b7c027fcd2b838d144fad,34,34,1,238,34,0,05040,1
9e0bcf133ad04cf91e0e4068dd4f58ce,32,32,1,224,32,0,03050,1
cd59ff7f36663139111d309d2c710c15,136,91,3,317.33333333333337,64,72,10200,3
d11b91a017265d4aa9ad0cc75dc801ae,13,13,1,91,13,0,04032,1
5ba69702f38b93762c9ce6fd599ed8c6,42,42,1,294,42,0,03070,1
4fa9d58e18b604bc8eb0fb4ecf88cf6e,60,51,2,210,60,0,05040,2
ad3ca770f7389f0fe4ef6174d04f976a,152,76,3,354.6666666666667,152,0,10200,3
e125789f02c03e66f6b664a7188e391e,28,28,1,196,28,0,01026,1
5617d06aa398fe6c74cb8334d61561a6,195,149,2,682.5,195,0,01026,4
f307eb2f29df922a40773e05230f25c9,47,47,1,329,0,47,08100,1
dfbd9b707fb0493af1ae0dc83fa47834,30,30,1,210,30,0,05040,1
9a50d55191e51c3596096112fa26c5ad,36,36,1,252,36,0,12742,1
deaa8f26b8c7c3830327011dd96092cd,21,21,1,147,21,0,01027,1
ea5991969c5660a59635147b35257b84,78,78,1,546,78,0,01026,3
fb5d9808fc27d2d3429e32a1bae54481,77,47,2,269.5,77,0,05041,2
c9d45185a055a434ef24982f59db9a87,53,48,2,185.5,53,0,05030,1
43fd6691ec72b4b62c38a07eaabbd4c5,390,203,3,910,118,272,01026,4
9d6c8ea7d51785f3b31ca1ca4f46923f,64,48,2,224,64,0,01085,2
9ff730c5126914496f36990bb697da26,80,68,2,280,80,0,10101,2
bc416550c272498aa36f470ab6e3af6a,97,58,2,339.5,97,0,11100,3
b3416bc316664ff291d6405952ec5941,182,94,4,318.5,130,52,05040,3
676b2d795b2212827196e0f20fe8a981,147,92,5,205.79999999999998,115,32,09030,3
bac20f549de0f8080e2b0983ae654797,19,19,1,133,19,0,05040,1
b1c2c6fc11e4b6435bc27c370317b697,268,129,4,469,268,0,05100,4
874d393f3decc2720b96278d99ea2de3,192,109,4,336,138,54,08052,4
90933ae817c55355119a2418cd87a81f,1,1,1,7,0,1,11182,1
d2a7b9a41be50d30cbed15c50a376298,41,37,2,143.5,25,16,05030,1
a2d714bf5ca57a42e07ab4bbbe7ff931,14,14,1,98,14,0,01013,1
44371a16c177dbf676b18ede98dc421d,44,39,2,154,44,0,08010,1
046734d69f274a818610716de5acf5aa,430,148,4,752.5,430,0,05041,4
eb79ceb46d2884410ef5f2ca0fcba401,42,36,2,147,42,0,05100,1
96a186aa73079138d243d41d5267823c,57,41,1,399,57,0,08032,1
f11dbe3b9dd739bb510e1d7c2a2ff9dd,23,23,1,161,23,0,04032,1
5eb3bf6c3bf6eb563dedcd3c91803d73,68,58,2,238,68,0,01026,2
467d6119e609f1c948798625b173494d,2,2,1,14,2,0,10080,1
7b3fb23f66339825762d74205d6e82e9,27,27,1,189,27,0,01085,1
d6fc6a14db0c7fc3ce85ad52554f86c2,49,49,1,343,49,0,01026,1
96bafb006feb37526b8803c8fb3516de,265,129,5,371,236,29,01012,4
fc5f08fe338738038da90227b89f310b,63,50,3,147,63,0,11080,2
52ee3823b8eec359476ab6e221a0a000,34,30,2,119,17,17,03070,1
cc1ff351d92416d7a719fc685402413c,45,32,2,157.5,45,0,03090,1
a7f2d8228ef926071a6f9ce4cb589a0f,20,20,1,140,20,0,11040,1
f1cf660e790777efc886211fbabc416c,87,87,1,609,87,0,01013,3
a2951d68a2e5bec29703b60dae616788,22,22,1,154,22,0,01027,1
88de533bfa40ffacb5cbb59ab9cc51c6,147,98,3,343,147,0,10200,3
95e31db31bba3ae1bff4b2aca02f1f23,37,37,1,259,37,0,09130,1
30cbd9300ecec99105d633999e1bb2be,18,18,1,126,18,0,01027,1
9f4a1fbed58ebb93aceeb3a44dd20495,106,84,3,247.33333333333334,106,0,01026,3
94f7be7d0da9140f21777a2d044c892c,247,142,5,345.8,218,29,01012,4
361fabaf09d5aa5e4cfe7a869a372286,49,43,2,171.5,49,0,10200,1
0a35c5ca286460035c3ef94801a547af,28,28,1,196,28,0,08100,1
9734309646cb64efef95af87c5fe8feb,76,57,2,266,76,0,03090,2
e5d9a906aac8f9ca4182ff9ced304fc2,69,49,1,483,69,0,01012,2
99409f075f41de82bf515ef23a036f7a,58,58,1,406,58,0,08051,2
c9ad251c2479a282bbb35d89374b5141,165,103,3,385,165,0,05040,3
2578eb14a11fd23a9f4568f005a32cf6,502,167,6,585.6666666666667,438,64,01026,4
41b5704ce6efa641d6470544ddea0bed,140,105,2,490,140,0,01016,3
f3895ab5c6a2ea8eb4d2a3871c34f2ee,89,77,3,207.66666666666669,56,33,01012,3
6826419d7a32e28980f255adf5d77e7c,14,14,1,98,14,0,12650,1
3387a65d3350b1a7cf6d756760aefecf,110,74,3,256.6666666666667,67,43,05040,3
58a7a45ac230c3a7a9955e7f9059699f,26,26,1,182,26,0,03070,1
f8bf140d176736d6f1e375f6e60f3a01,62,54,2,217,62,0,05030,2
9d168b0de9c7e4b6ffe957c09bb98336,4,4,1,28,4,0,10080,1
77ea559952979444bb9bb58a74279511,78,43,2,273,78,0,02756,2
f097a90fd1a15167aa58c791bdf510ae,32,32,1,224,32,0,12570,1
44b06c635d9b0bde1922b3c06163d7dd,49,49,1,343,49,0,09130,1
1e43e456fd2df213c56e1010202068b4,161,105,6,187.83333333333334,153,8,05100,4
f649487be1a1d1f599480a10bee8c1ef,32,32,1,224,0,32,01027,1
cf2682a12c567c560faec3a0d4ac93ea,21,21,1,147,21,0,01026,1
b1ec089e412f11cc6ffb6fd27c4fbf2e,127,64,4,222.25,88,39,05030,3
70f4447b188b86995a245af45393a142,25,25,1,175,25,0,04032,1
b7552635324448ab94d49b7d45a75b50,11,11,1,77,11,0,05040,1
8e6f604aa6d53b864701ac4efaa97a25,260,116,4,455,235,25,05040,4
805cebbbb4ac658678b8e03016c534b9,15,15,1,105,15,0,01013,1
1e1dd3a96dbe3e7bac1ebbeeec46f4b2,270,113,3,630,51,219,05040,4
a1451a8df0dae046b1b29dfaa05c0bb3,2,2,1,14,2,0,08230,1
089ac05af3f233fab60e81fb4abdca80,334,158,3,779.3333333333334,123,211,11040,4
899795a68f19f38259d2b75bc2ae5991,69,57,3,161,52,17,01027,2
3d94a88afe064bb54febd040f79efae4,114,61,3,266,114,0,11040,3
219a835d7183aeb94153b6a339f751f2,104,68,3,242.66666666666669,71,33,01026,3
de51601b879be7bf26739073aca95483,59,46,2,206.5,59,0,10200,1
36a587e0faf79435a9f37a15a542d871,75,40,4,131.25,62,13,13953,2
091c2dcb3aca1a48fb66178f980f28e2,84,59,2,294,5,79,11080,2
d47633b5581986bf111dd25899cec78a,116,87,2,406,116,0,05040,3
90131045c93ce786ca88a4d56476f78e,88,74,3,205.33333333333334,88,0,03090,3
210de4b00cabfe1f85d07a47acadf8c2,39,39,1,273,39,0,12570,1
0c665c3cab9ae17b7ec51285e0c01c7a,360,136,4,630,203,157,05040,4
3f3c65bf9964b9145446cc1a7f977011,73,52,3,170.33333333333334,73,0,01085,2
a7a46b61de70100eea5621b6b6d396e2,26,22,2,91,13,13,09130,1
9c2641b2c448f8f66801adb8bd628fe9,21,21,1,147,21,0,01201,1
d0d0579a5c0a3ef26d5a210fb7324d7b,448,207,4,784,225,223,04020,4
d4e55f04f1667c8f31db843d41c1d891,214,104,2,749,186,28,04020,4
2ef8f8864d03bdd9ee02edb008858ca6,1,1,1,7,1,0,08230,1
f949f3ee7647b6c7a875bdbe93f6005a,18,18,1,126,0,18,04020,1
65ced4a1d4f14a9096a070b82262edd0,5,5,1,35,5,0,05030,1
dcbd2b67e5af8a5d5d1393ef02df6063,523,144,5,732.1999999999999,367,156,05040,4
fa3f5ee0a1af054fde1fbdcaa4e8aa5f,54,39,3,126,54,0,10080,1
90e2632780177bac65554cf5d64426fc,48,36,2,168,48,0,08315,1
99d117cb87cb3199e9e4af89e80c703a,24,14,2,84,24,0,05030,1
ebf59d99c90f0d19077f4ce345349387,182,100,3,424.6666666666667,102,80,09030,3
de88413cc84f258a0bcc3fc59d96481d,1,1,1,7,1,0,08317,1
d8a811f09445ee491970391cad09f501,102,67,2,357,63,39,01012,3
645b112ba3e9fd36db68a4b1fa97ae8e,49,17,5,68.6,38,11,10028,2
e2f496efc2035f531e988850a53b2e67,93,52,5,130.2,93,0,05040,3
291c364c540a30674ad41cf7e2c8a86b,38,38,1,266,38,0,11040,1
8f14e900bbb9236d08b446097e4d881e,37,37,1,259,37,0,01026,1
ad0c0c1a2af6b8953f0a147dbe04445b,71,56,2,248.5,71,0,10200,2
71bc5c5a02e0333afc1b8711b64efb64,60,42,2,210,29,31,05041,1
11e25f76fc6d1164fa63b516f2653c85,93,93,1,651,93,0,09110,3
d405135941c1157eb140110875cccb9d,7,6,2,24.5,1,6,01026,1
c89805ea8fd2c4d6761e82337c38866b,59,55,2,206.5,59,0,05030,2
392a4c8234bf750fec6cfa23e281ac17,42,42,1,294,42,0,08452,1
7221f29e0085acffcd8d2a24589dc385,9,9,1,63,0,9,05030,1
34377df3e201562fdf8b5a9507722401,34,34,1,238,34,0,01026,1
5c35310fcb8a3227e1ea8c4ddfacb628,97,77,2,339.5,97,0,01012,3
9938da4abce636ff1780421d41a39390,167,110,2,584.5,167,0,05100,3
da50bda50fa9d2861e7e6abd694c607c,155,84,4,271.25,112,43,05040,3
a1024b2c5e1151df9837419374233b19,196,121,2,686,40,156,05040,4
e9e013747d72b4d1d43f104bedaded80,11,5,2,38.5,11,0,11040,1
1c66475fa450dde6366466868e0d413c,92,56,5,128.79999999999998,79,13,11080,3
a389f09838eeee4e4421e94a81a73c23,102,61,2,357,102,0,01012,3
171568e2547a5617b7092b47a7d5a97b,53,45,1,371,53,0,05030,1
1aa69b58cdb6b40bca4348303f60b8cc,52,52,1,364,52,0,01027,1
60c290e760536cfd48733423e6544df3,2,1,1,14,2,0,11104,1
081ae0ab6252bd413b67fec52ce10525,74,67,2,259,74,0,01013,2
6c010f58b245e1a3918640d22693dd0b,97,97,1,679,97,0,03070,3
f3523f59d4b037d24634f3282f0da5f6,163,71,2,570.5,78,85,01027,3
1b63913598a5c988397785c08cc60678,185,99,2,647.5,185,0,01026,3
7c51ef70e418286faf849a36ea7efee2,59,59,1,413,59,0,09170,2
8dca5ac3cb465eb24263267e6b3a0fe2,19,19,1,133,19,0,05040,1
dcb4864a8e64427e32da797fb665f58f,252,120,3,588,128,124,10240,4
6693c9fa9f0c8eb50c2efe5e358c18a0,66,45,3,154,66,0,05040,2
288de1dcbb8e7591d2bd05713d14e273,134,81,4,234.5,101,33,05030,3
f6f3cf3f585622aabbbd7e1a7d5a67dc,54,51,2,189,33,21,04032,1
cc6992f33cd601cce9f16689af164428,68,63,2,238,68,0,03090,2
18a0a18f5e05faa0947b9f832c8e6877,62,38,3,144.66666666666669,62,0,05030,2
6490b6398fe5e9e5fe6e58dbb789e37e,38,28,2,133,12,26,05040,1
8730a5a508ad1c6ffdd5c7db4a710758,47,47,1,329,47,0,09130,1
83f563d97ad684a4346369345234c94f,11,11,1,77,11,0,05030,1
b4adcfc5ad4893f25409d2ec528ea193,48,24,4,84,39,9,11040,1
4a47aa700ff479981b0edec60c19da56,164,105,3,382.6666666666667,88,76,10028,3
29a94838b9d46dcd00d421555acdfd5a,11,11,1,77,11,0,01012,1
84696459093b0dffce1135d721c35220,87,49,2,304.5,87,0,05040,2
7aa98d961f409878340c07fb6010d376,5,5,1,35,5,0,04031,1
d5f1f7bd27bd0f738b0a90db1306b2a8,281,155,3,655.6666666666667,281,0,04080,4
da719ccbf973fee7c1da6efbfa9668a0,87,66,2,304.5,87,0,02690,3
cf396ceb2abc59379dd2d1a6ff831357,16,8,3,37.333333333333336,16,0,11100,1
37207e042f8361dfca61b32c3450b831,302,137,4,528.5,302,0,01013,4
6a83355bfaad02b3332e031e3a636299,116,73,3,270.6666666666667,116,0,05040,3
8c8f6b660f99787f3ee62ca36fd5de62,289,109,3,674.3333333333334,289,0,14301,4
d4ea7255a41c479f8b53a84ca4f3cf1c,59,59,1,413,59,0,05100,2
bb839cb865d6afc76bbba644253e3825,8,6,2,28,8,0,05030,1
6db2c41a1671b06d5705e3986f6a6d4e,28,28,1,196,28,0,10240,1
3ff4b41d2de25ace1dbd0ef45f240ef9,95,78,3,221.66666666666669,95,0,01026,3
df11f61fa654c9d18cc5ea1073f0c7d7,17,17,1,119,0,17,04020,1
95144df005696bd2e3c6825530c69295,35,35,1,245,35,0,01012,1
217db14eab0233c8fc6377371d05ae0c,22,22,1,154,22,0,10260,1
67d3511801440ed8219d30d28cffa50b,61,46,3,142.33333333333334,61,0,05040,2
3eb3741d804883a660bf1dc8b26b13f2,200,107,3,466.6666666666667,200,0,01012,4
3680d6575e2656de676fa94ccae5f345,38,30,2,133,23,15,08052,1
35ab14646f8a8eb0d0c4213489d278e0,162,131,1,1134,162,0,04060,4
6a1e605b08fb976ecf14a96e64c1e14a,100,55,3,233.33333333333334,69,31,05040,3
7f4958fa8122e08da42c36e28e5c5496,66,63,2,231,66,0,01027,2
ea8febe9e6ab616e400c83488a76176c,3,3,1,21,3,0,02660,1
54141b326381208f21336024dab8bb44,8,8,1,56,8,0,07144,1
3dd714c4950f0f5ffd31a11694b09f2f,31,31,1,217,31,0,03033,1
5129b0a02f06921c338bc19245c31bdd,74,56,2,259,36,38,11100,2
01f53c2e41b37acd0f0f49d504ec8e70,341,209,2,1193.5,39,302,05040,4
16f120b51e02b6842197ec7c5669880c,23,23,1,161,23,0,05030,1
ea80d2169fb26276f2d103b696c24c95,10,10,1,70,10,0,08010,1
cc0c0ef9246abad991343a9b3a240719,147,94,3,343,92,55,04020,3
e85f192ec38c71e717d9400342f4d7aa,9,6,2,31.5,9,0,05030,1
04b6716c7ed95609b9350f3a867e4102,61,52,2,213.5,61,0,05040,2
69905267fe4812d69639ea9011e0e121,76,73,3,177.33333333333334,3,73,05040,3
4e1d13a9fd62208e2f9d46d5e1760483,1,1,1,7,1,0,11040,1
8e825171aa3910f51542b419ebe8ec42,28,28,1,196,28,0,02620,1
7facdb765c26346bd7c18119cfd1b4aa,37,37,1,259,37,0,10200,1
924c0675680499e67a6d0ad2f7b40956,75,59,2,262.5,75,0,01013,2
3c99661ea497cece7e5a509555b59b09,55,39,4,96.25,55,0,05030,2
4d64e6153d2096d1501ba3b80ace3f9c,15,15,1,105,15,0,02691,1
8af179c7183d6dc2f454c630aa2d481a,10,10,1,70,10,0,02755,1
66bfad23528e61a683f0b7a210d055dd,12,12,1,84,12,0,08314,1
a4f90b9cc7c6e26bd172c27b2116cfb7,235,112,2,822.5,152,83,01012,4
78419e2028deb993a4bd10b5d12a2d44,87,56,2,304.5,49,38,09030,2
234a73d33cdae0813af0b7b561c89448,77,54,3,179.66666666666669,77,0,05040,2
6d55f8573e9b3100b7357855ba631a45,31,31,1,217,31,0,08051,1
3346dc508f83aab2812b44dfec04dcd4,88,68,1,616,88,0,01016,3
923e0bdc84ac61cd39d29fdda56ac9a1,135,96,3,315,69,66,05040,3
7ee9a47ab6a0abdbbc387aa08c7f61b3,1,1,1,7,1,0,09010,1
fed17537f598d0df96fedf9e789526a9,13,13,1,91,13,0,08330,1
f0b9c87020117572409ca111c51954d0,48,48,1,336,48,0,01026,1
e06005916c4e6079ca7d6e64bcf8982e,166,61,4,290.5,73,93,12670,3
927cee439649bfc98b3864a71bbbfdad,53,35,2,185.5,53,0,04020,1
9b6e7d8490e71f4863aaf1ff57be1da6,17,17,1,119,0,17,03050,1
b8c9616a31a37fee40bdbae54930c9d7,36,35,2,126,36,0,01085,1
d8b7febd4d065d5de33ee6bed34a8d46,146,59,5,204.4,146,0,05030,3
3c9ae9bafa7660af781914fedc538b27,28,28,1,196,28,0,02691,1
dff54ed560387ddbda785e0b4500a456,19,19,1,133,19,0,04060,1
4216a777a9a0db0a1b2d57129adde40e,53,43,2,185.5,53,0,11080,1
7fc802824505d603559a8e01bd3da944,95,73,2,332.5,95,0,01026,3
42bbaad5b02ec751e681ae95fdd4142d,48,37,2,168,28,20,09030,1
88559a3f95bd6d4beceef87f89d93f7c,159,89,3,371,159,0,05040,3
d5444d96bfe0ce2bf5b425e8f3f6fd29,36,28,1,252,36,0,09130,1
dfa5b28564572d380ded29a10fe13dcc,13,13,1,91,13,0,02690,1
60d17b0da3234d14ca231038b4b97a32,85,62,1,595,85,0,04201,3
f5c52a3ffb7879ad4b2505859d00ac21,90,71,2,315,50,40,10261,3
bec68447a02aa6ba6a710be1d8266585,34,34,1,238,34,0,02650,1
b6b5897954591a50a9cead4468a793a1,56,48,2,196,21,35,09090,1
7c221f3a4ace6c63f10601238e36af78,36,36,1,252,36,0,05040,1
6d9c09345bfe6a3eb900a19074444a20,92,58,3,214.66666666666669,68,24,10240,3
29886a48c9d0991f9163f7daa5886316,536,242,5,750.4,440,96,10200,4
1050b0dd884e7638149dedf13e420bc7,64,48,3,149.33333333333334,43,21,05040,2
dca3c945ea168e8de156e7c69d2b6f37,130,52,4,227.5,79,51,06100,3
608ce12b7dd55f8dd9af7992a53409a8,13,13,1,91,13,0,03070,1
2373980474ba9e6e503d86fb79b26c5d,12,8,2,42,12,0,10102,1
e7fe47f91697873400b4e34c9dd633f7,57,48,2,199.5,57,0,09130,1
c30fdb2e64c5d146920b0a1d621b42b0,49,43,3,114.33333333333334,49,0,08052,1
05e20c7c41a070d5f152ac3c6cdcbe55,139,96,2,486.5,68,71,03070,3
463a5b57e3b7fad327d17c46dc693053,42,26,2,147,42,0,05100,1
1ceed6c063c6fce5ed08c8c92987fd37,23,20,1,161,23,0,11040,1
397f0c2904ff9c415ebf0f8d9be7232a,27,26,2,94.5,27,0,13490,1
cbaf5352373cf77e4defa5f556024800,162,114,3,378,127,35,04060,3
77b7f445f8ed1a1752a5d99690d07b5c,163,116,4,285.25,124,39,04060,3
eeb6f9d49218a7fd2122b170d5200d81,27,27,1,189,27,0,05040,1
4e7ab3db7d7fbaa12ae7d95e0362f27f,197,92,4,344.75,169,28,05040,4
32095631b0dee1555fff2f6305ef3c76,32,27,1,224,32,0,10200,1
c2779804f0b95cb577cd859751338fcc,262,115,6,305.6666666666667,246,16,05040,4
47e4ab3f01bf5338c2e1292d4c847746,63,51,2,220.5,36,27,05041,2
16fe9ca292727e54e6292a859b71099b,57,41,2,199.5,57,0,05030,1
291ffde67fbdfa280e7f82a306a7c971,16,16,1,112,16,0,08313,1
9166e913f951248b07ab674a2a0214df,192,122,4,336,192,0,05040,4
cfad73094199dff6e90279cabbffd574,29,29,1,203,29,0,01012,1
bec1aaf70b57610a8402df11aff943b9,160,84,3,373.33333333333337,160,0,02620,3
d2a0c721b9c575f563153c4979b5980d,22,22,1,154,0,22,12501,1
19ea4ee9e0344fc26d9c5557f2c92dfd,29,29,1,203,29,0,11100,1
6b397828a572937e2b8c1b51eef35f38,91,63,2,318.5,42,49,10200,3
fccbaa0467170f138716a508c0e3f9cb,179,91,4,313.25,115,64,11140,3
d34950b22d95895d1a1896ef830abf64,82,63,1,574,82,0,01012,3
5553f92db7022ac9dc5c3e9810bd52e2,19,19,1,133,19,0,01012,1
b63aafabed9d97c472cc074c3fc4b59c,79,61,2,276.5,37,42,05041,2
15e4010050680327ef31ced618525bfb,172,61,2,602,29,143,02650,3
507379e3887c53fb08c65350d4a62419,15,13,2,52.5,15,0,08010,1
d604f7ecc53b8aee3d89af8719f31fb2,66,55,1,462,66,0,05041,2
fd8d43d6a6e3cb4df54f2379d6975c18,64,50,2,224,64,0,08150,2
d225d8d68735d35f514b93f7f36d6b47,84,67,1,588,84,0,09130,3
fadda161898d3882a6359a59655e9da6,95,82,5,133,66,29,09010,3
ba1f50f795638c39a555910e07f9e4ec,72,63,2,252,72,0,05040,2
06ed17baf30b5f87d26e46b23d1cc0eb,293,141,5,410.2,269,24,05040,4
65d2fb07a147e8b8397139034e3e67e2,29,29,1,203,29,0,01026,1
c86ab4b4cf16eae5f8b5f50831e2c432,40,40,1,280,40,0,03090,1
49407474752e0a5a97df5f72d06bbdc2,61,55,2,213.5,31,30,05040,2
ee583404962b00c3d45e8dd44bdc3694,4,4,1,28,4,0,07143,1
853018e2325ea98986c6a6edd8269dec,33,30,2,115.5,33,0,01085,1
f25b08859c404e20c010eea67397dcb5,34,23,4,59.5,31,3,11080,1
53599b33915bcded58c924ac9726ef3f,293,80,2,1025.5,243,50,01027,4
d0e6abfd497f240745dfb008226c86b8,35,35,1,245,35,0,10101,1
4fad1a03a3a600bb53447571c63a21be,28,28,1,196,28,0,01012,1
76a54c26955652b30e38066f90d455ff,88,61,3,205.33333333333334,88,0,09130,3
2b4a0e34d66ce4f88b670f509ce34713,162,101,3,378,162,0,03090,3
fecc6cefbd95746c67dc36ee462235b9,243,128,3,567,96,147,04200,4
deea16e661c21bb8fcf1fc14bf26b003,156,88,3,364,114,42,01026,3
65d24386ce5aaaa5baa6164b593e0304,351,150,6,409.5,257,94,05040,4
e049daeb64bb1f5470ec56a2b445cf4c,110,89,2,385,110,0,01027,3
d1daae94f2a66b8cf1afde8f8aba1b2e,162,82,4,283.5,120,42,01026,3
d6c8884574c7697dfdf3d167e8ac5226,34,34,1,238,34,0,01026,1
ab6832e8cbd969631314ff488967cdf0,26,26,1,182,26,0,09090,1
4a102a270b82021af0676627e7a9eb0d,191,95,4,334.25,191,0,05040,4
f2a25e9638e979bc167c3d157d651ab8,13,13,1,91,13,0,05040,1
ed44071457832880697ffdc6e349d942,14,14,1,98,14,0,09110,1
de807ff37329232e45ec6e7f4a646b4e,37,19,3,86.33333333333334,37,0,05030,1
eb531bcfdcb7f7d62b66043a6f52712f,14,14,1,98,14,0,06120,1
724af6755fe31bedc087ca334619eecb,264,96,5,369.59999999999997,173,91,10240,4
e6eb939fea3ae986a5369149d51868e7,127,89,3,296.33333333333337,86,41,05040,3
2edce15d14813b3531caa543cb3e215e,92,11,4,161,85,7,11080,2
612c19bb9217e8c123f25516ac99574d,203,118,2,710.5,203,0,01026,4
2cf1a991063a0037613edd8e0a7d3e41,51,39,2,178.5,51,0,11140,1
1fa2d7e485df78874d12464b8703c0ff,111,77,1,777,111,0,10200,3
626d8f7b4b70800d2d5a1508c187d5d9,10,10,1,70,10,0,10200,1
1040a4e81c46222e90ac3660fa37c892,15,15,1,105,15,0,05030,1
09132398b53ff3fb70ddcd59b53a3220,38,38,1,266,38,0,01012,1
39e3f311a2caad1c5f35bc7d9720f7f1,30,30,1,210,0,30,08452,1
57b52448edd19bc44592794265b322e6,80,23,5,112,63,17,09190,3
6e794436b2854b162d92389b8486622a,1,1,1,7,1,0,11040,1
36ac0141105d1f7b7217a277d2d7de80,52,52,1,364,52,0,08010,1
2ec4c79ec15cc4a1ae6b99b6897defc0,55,53,2,192.5,27,28,05040,1
3a1b1b2a5bbe44c9dfa4ec733eb8e476,94,74,2,329,94,0,09130,3
ce9819f40eb591428d331cadefe4d2c7,27,27,1,189,0,27,02690,1
8771fbafa203c6d02d9952657e12dbaf,40,40,1,280,40,0,01013,1
382623b62ed2bcb3e08b6f159f82f27d,6,6,1,42,6,0,10080,1
b52c4fe8324b93af50ed7e355eb17ba5,123,123,1,861,123,0,09030,3
30961da94df74ee158765f684d5a6602,187,138,3,436.33333333333337,187,0,05040,4
e4cfd96a42af3d00573773aae9b35909,90,69,2,315,90,0,05040,3
eb379f0d1acbb88a547822ca437a5c52,142,105,3,331.33333333333337,142,0,01013,3
8b18f804aafbcab987d8d75c57b49caf,92,71,1,644,0,92,10200,3
a98e3f8c12e3223d84980ac4241446d4,69,60,2,241.5,35,34,12670,2
297d7efbdc889a8e79e958b7860eeda2,101,47,3,235.66666666666669,101,0,11080,3
3d85df8196fbb873365a6fa6fb484dcb,1,1,1,7,1,0,10080,1
a726a3e33c31a39e81c803e81177e8f8,20,20,1,140,20,0,04020,1
efe06b96eb66c668fcec960772509aac,136,91,3,317.33333333333337,136,0,01026,3
3969143535fbf4a25fecfea5e465756d,125,98,2,437.5,40,85,11140,3
844b6c2f55d81d6c48a829bd457f0d28,33,32,2,115.5,33,0,09130,1
57f0bac698e698aed3983011bf7a5a01,140,71,4,245,140,0,10200,3
d562f3b422d3553fb312da219cedbb3b,118,80,2,413,39,79,01027,3
9e2834b2ef8c31454c5f9349f4b56c44,200,147,3,466.6666666666667,200,0,04020,4
dfea9744ca92d04eebf9a05a1abe1322,11,11,1,77,11,0,09010,1
c628ab27d20f1b984600cf0b68de2634,88,65,2,308,88,0,01012,3
c9c751730c04a5e42a3d03203bfc74bb,249,132,4,435.75,249,0,01012,4
29cfed559a418bfed10e36c762de191a,41,41,1,287,41,0,04020,1
e85c7bc3776681914708e24fa14e1b90,119,91,2,416.5,58,61,14301,3
6a18bd9fe96da8ff0fefb1044e49e13b,153,86,3,357,117,36,01012,3
12ea6e6e86633181d705fb0a8b9ec8d6,129,91,3,301,129,0,05030,3
058a51e0a7fc9581b0350a9d9385f8b7,70,48,2,245,27,43,01027,2
c744d05422f099d1ab009c3be4fede8b,471,142,4,824.25,392,79,01012,4
73d31886d2a18a57f8512a604263fe45,34,34,1,238,34,0,01026,1
b90073ac3a9ac09bc01ae702eb162b1c,29,21,2,101.5,11,18,10028,1
ac658cb1ba87735f69f7989ee4e062cd,214,134,4,374.5,214,0,01026,4
56abda617c87c78238d0818c8398fcce,39,39,1,273,39,0,10200,1
80d8ac35352c789df533075b2ccc95c9,423,135,6,493.5,372,51,05040,4
d3587e534e5540a806936095c0b9b157,29,29,1,203,29,0,05040,1
357c47d5b738bb58d0a1ee0a5871ef72,80,65,4,140,60,20,14301,3
4e41433934d5fa6016bbbb08c9e6c412,24,24,1,168,24,0,05100,1
c1f20ba95600ce5f75f9cbfd634ae265,55,51,2,192.5,55,0,05040,1
9742a6e7d90c1071e9eb7ff44c369a3f,15,15,1,105,15,0,13820,1
496d9d0218871559edb37239c1ef4896,75,75,1,525,0,75,01026,3
29f2715f163d3e760d7a17839129ceb2,254,176,3,592.6666666666667,254,0,05040,4
e14fd3a87adb1ec44c9cc3eb25bcdea9,160,100,3,373.33333333333337,105,55,05100,3
5ad0011c084c6ffd8b01bad81f336caf,282,108,4,493.5,253,29,01012,4
d57aa6ae6625f9629c6b070357ca8773,75,37,2,262.5,54,21,12650,2
e97c82b96f1b67bb6d6e51cce8ebdd0a,34,34,1,238,34,0,04020,1
a08bb2fbbe094daa58c6271bcdd8a867,28,28,1,196,0,28,11100,1
23b613dd2b22092a608f52ee6f07f248,14,14,1,98,14,0,01027,1
2f220d93203dc05f7c29b4d7747e4c2e,305,116,4,533.75,305,0,01012,4
39bd1e2701d0efaab6efa8357009a2cb,79,61,3,184.33333333333334,64,15,01012,2
5c2d939a108460031f5f0eed2736e4f3,22,22,1,154,22,0,12590,1
455efb68a69631e8b140efe1a112adc3,23,23,2,80.5,23,0,01026,1
edcb30b0cf65e2875e0ee2d5159a57f0,42,37,2,147,42,0,05040,1
3ad16b4799f9d12ebee71c840629d719,106,48,3,247.33333333333334,106,0,08100,3
436d6bc8ac4c633095374a16889f0827,11,11,1,77,0,11,09111,1
725ed163e6a0e4f2f5b5250ba18d4da0,14,14,1,98,0,14,05030,1
2327299454e026c8c00546f14942275e,42,42,1,294,42,0,03050,1
a96232301fabdc98f36033ae3c0220aa,25,25,1,175,25,0,05040,1
30e79bbb258387722f6a49d3e75bbe50,42,34,2,147,18,24,10220,1
9001198f5aa1833c11d4c2dbbc7ecb17,14,14,1,98,14,0,01013,1
4f2abcbdced561fa12d33acbe9c1653f,19,19,1,133,19,0,01027,1
247d30c1a20d1004b1cc7afd100641e3,111,55,3,259,45,66,05040,3
cd21663df9c517f9fc8c523714a3ee34,49,35,2,171.5,49,0,01026,1
ae0a277093c43109be6a165ef8ccb7a8,42,42,1,294,0,42,05040,1
3a08d40985d284142622cf5c5c19ea58,93,73,1,651,93,0,11040,3
7dd9fb379335c717e4138b5c7855b691,81,36,3,189,81,0,03033,2
f437c733c8b217374036b17e23250719,31,31,1,217,31,0,09090,1
9c983a817352eafc9e6e6f4233f07d07,22,22,1,154,22,0,05030,1
06b62a126e43ef9ab17314cb8d04377c,25,25,1,175,25,0,09350,1
61e96dbd2bd9aab03a12447a660c3594,55,45,3,128.33333333333334,55,0,05160,2
3e9011d40b7f00312c9f4a5485b1a23a,188,126,3,438.6666666666667,98,90,04020,4
c2d35b5f759da98bf7758ac9e7712a35,114,85,4,199.5,96,18,01027,3
833951da5e17e5ecd46459b4f7115b74,124,85,2,434,124,0,05100,3
b0ca4c128e738c75da11450d0a869c5b,18,18,1,126,18,0,03090,1
13977a94e8b0818bc497193efe717699,16,14,1,112,16,0,13930,1
c506284388b155fd0b996dfbaf3e0b81,50,41,2,175,50,0,05030,1
ec7b2a2c239f2b9fd594ee2bcc8caa79,8,8,1,56,8,0,08010,1
1d72f195142b7a6b9f74a10f2efe17c3,74,54,2,259,42,32,01012,2
08e6e81f28566e0691279b73fc057beb,74,38,3,172.66666666666669,33,41,05030,2
7da06ff868a723c3179be25688e64716,113,82,3,263.6666666666667,67,46,03070,3
55ceba82395c681427f2ff50a208bb72,48,30,2,168,48,0,01012,1
d500ad59f55dfe69abf0f951003dfcd8,118,69,1,826,118,0,10028,3
bbd1dad6da10640d5a86b4faa485ef74,57,57,1,399,57,0,01026,2
830ca2cd303b33c3fe4bcfcf7913272e,18,18,1,126,18,0,10080,1
4abbc7906560bb378a9a18461af75837,50,42,1,350,0,50,10101,1
af42acb77d456f71bab70d3d576994d5,31,31,1,217,31,0,05100,1
9ef058a42e5b8bc317c010b750a3dc2f,74,45,2,259,74,0,10220,2
7d9b284dfb451400a299950778ff105b,310,133,4,542.5,310,0,12650,4
0c39a3296baed35bcffafdbdd36727f0,259,105,2,906.5,259,0,05040,4
8c26e3bfc888021806e098e8a502da8d,152,80,2,532,31,121,05040,3
3f5b8ff02d83e0c11c6d2106da731fb6,85,40,3,198.33333333333334,85,0,05041,2
36d6e5eb538e3374bf46b2bb84fb0a0c,534,143,6,623,325,209,05040,4
3cf8c979ffddf3de1b7286144a779325,40,40,1,280,40,0,05040,1
17f4fda922f74e294c1e533d34708337,12,12,1,84,12,0,10153,1
3a2fcc1d779e5cf97add013474ff7e3c,10,10,1,70,0,10,05030,1
7de60e41a766d0ca3543e87edf87dc0a,14,11,2,49,7,7,11080,1
3516c2a3658c95503d72f65bdbbe9cd0,26,26,1,182,26,0,08134,1
7894aeee7fe3cbd3369953ffaf06fa4c,50,50,1,350,50,0,05040,1
d2d3c690bfc764b2cec91d99b3258c60,34,34,2,119,34,0,02751,1
b4d9e4d5e2cd37843e663d71de705bc5,45,45,1,315,45,0,01012,1
daf2ead71303dbe9e1f6e1e8839b765b,170,91,4,297.5,146,24,03070,3
f148f16fc24fde341a013a71b1224c18,659,250,3,1537.6666666666667,93,566,01026,4
391d642c8a52696a6967c7872bb85bdd,51,38,2,178.5,51,0,05040,1
66df72e929de5cc41b71a7f6c7d9b187,314,132,4,549.5,287,27,04060,4
5afe3f7c298f3f285a9b33d699dd74a5,30,30,1,210,30,0,01027,1
c95d17d689978a917410010c74ab9a84,8,8,1,56,0,8,05030,1
5960acc89715798fad9329426c790291,441,107,5,617.4,441,0,01026,4
46ba36518dff39aea6ac6a4421a970cc,1,1,1,7,1,0,11080,1
0741a092d7c05f5368f8a4966251b57b,88,66,3,205.33333333333334,88,0,04060,3
c083713fe46b331f13207824b9d72f12,73,52,2,255.5,73,0,01026,2
b9abcfda45511de0600319eb800eaee6,317,172,1,2219,317,0,01026,4
61999900684082ce78ef229e2f10800a,114,69,5,159.6,78,36,05100,3
8bc9d9faeb23796a391203287c108cd1,335,157,2,1172.5,125,210,04130,4
d4cd53d0f66ab1aefa7f9f3766f1b64c,184,95,2,644,175,9,11103,3
6fe4dc55e273ebde8fb9fcbee2f9ec61,205,114,4,358.75,205,0,04032,4
fabac5d0f11665df9ca7de425e9ac359,59,45,2,206.5,59,0,05030,1
0676f26a337616ef64de8e34c53a9ef8,46,23,2,161,23,23,05040,1
9818a205797a30110cc237e419cab87d,135,76,4,236.25,135,0,05030,3
e0d3286106ec8ade71dbc30b4d9829d9,37,37,1,259,0,37,01012,1
4ff32f1036db90039f66f5c893c7d39f,90,69,4,157.5,90,0,01013,3
53d1f7b3f50d849b4a90bfff97ac855e,149,86,3,347.6666666666667,149,0,01027,3
aced83b2b12b20d3a3c6c45a65397ae6,31,23,2,108.5,31,0,01085,1
c0303ca7be4d09201e6f29ca5b11c33f,154,65,3,359.33333333333337,117,37,01085,3
d1f5afbb37ee620485e9d2929b3ff030,67,49,2,234.5,33,34,11040,2
7bed715a2735f83f5ed48006dcd0cd7c,116,96,2,406,116,0,11040,3
f9f7b99b317b2826355bc089ee418655,27,24,2,94.5,25,2,11100,1
7ee5739318805a1ef341df56e79e2f93,20,19,2,70,1,19,05030,1
6c366e8a85fb2c1450afc760ee326bf2,45,45,1,315,45,0,05040,1
4d5e1824b8f04f567afb2a54175a84b7,51,51,1,357,51,0,02650,1
ddd4bd397a595086f0658314e271946d,23,23,1,161,23,0,11100,1
4a22eaef0fcc601ae5cee443a3ea9195,14,14,1,98,14,0,09010,1
f9020e314680b4b1af572d34c2605e96,117,87,3,273,94,23,01012,3
a7a4996564c0fd26e926381e44abde3f,79,60,3,184.33333333333334,61,18,05200,2
defb5fe7a213d4a9fa15fec7c9b54c23,90,69,2,315,90,0,01012,3
a680908fe940983f79e438a142132c29,121,79,1,847,0,121,05030,3
d9dca74b053df972b02cbd6097c1209a,23,23,1,161,23,0,01026,1
52e51071d4e38e062ee986aa261706f6,171,107,3,399,171,0,11100,3
a7bbab74fcb9c6bc9fb71b267655caee,36,36,1,252,36,0,05040,1
4133cc97630a0de9f3770c73f0709ad5,54,51,2,189,54,0,03070,1
5c79a66a8e49ae64261cb7c2a951e1fa,176,92,5,246.4,129,47,01026,4
4c3068ed383d3b5cc84e58f6ec490fa3,114,91,2,399,68,46,01027,3
9777886f93d8b5d40b193a49e532e727,196,145,4,343,151,45,03050,4
f75588a45b7e785aededc3d582284c28,121,89,3,282.33333333333337,54,67,05040,3
baaf26cc71645a5f34aec412589fa39c,29,29,1,203,0,29,05030,1
1de50f372af4a98594c6f7c238577978,45,45,1,315,45,0,05040,1
2ab14040729c199bd8f60f7e28d8ae77,16,16,1,112,16,0,01028,1
707783c6bfdc9b5204e12a9ba9f511df,204,99,2,714,68,136,02650,4
fb047d9ed769ddd4f997124ef8f218f1,247,91,3,576.3333333333334,247,0,10080,4
e8d77fdda1b48a7c14e12da08a2e74cc,41,34,2,143.5,41,0,11040,1
2d837ebcf888aff9312266af697efbf1,66,52,2,231,66,0,09150,2
dafe0f13fab9a28c3c3cb179c2961733,54,42,3,126,54,0,01027,1
04e34837a69fe6fcd0bcb430bde2f9d7,134,83,2,469,134,0,11040,3
affc9cad8829889ae6e630c93e5a9711,171,71,4,299.25,171,0,01026,3
7d26df551c761b1082bd1de9004c7b09,219,149,2,766.5,219,0,05040,4
3fbddbe7982b667fc7459341ec79f3f1,63,63,1,441,63,0,01026,2
91656d4e0edff7288b1c6e20f3b45f71,26,26,1,182,26,0,01027,1
cd11c7d554ddd84c6784497bd7dfb490,89,71,3,207.66666666666669,89,0,05100,3
d0e650016d8dcbc5726e3b82f6b0d0d8,27,27,1,189,27,0,08010,1
89ebc0f833a85e63482eb1c5bf5e9e13,26,22,2,91,14,12,05030,1
a8b6d234d8a383b61f4f6497787a17c9,186,143,3,434,137,49,05040,4
74890df807077cd746c9289ea1e70e0a,142,81,2,497,142,0,08230,3
a9e7a8fea85692fce344308e5d3d807d,16,16,1,112,16,0,01027,1
914a8241ba0d5ffc49556c2504c3767e,29,29,1,203,0,29,10200,1
5148df433cc892a76587530149a15198,24,24,1,168,24,0,07143,1
1ec27bfbb4e56301e329d01c026a790c,214,98,4,374.5,126,88,01027,4
f834991f7ffc6e75101e75534d60bcd1,24,24,1,168,24,0,08010,1
a829b2218eade1a368e1f18b52bef56f,71,44,2,248.5,71,0,01027,2
89d9379b11631cfdc8c4996197a002f7,53,53,1,371,53,0,10240,1
fbf02761382ae34959d88cd0b7e1b9ad,34,34,1,238,34,0,04201,1
cd3b55b9919b51e0e9d4285c46351edd,73,41,2,255.5,73,0,10220,2
7106af9d1d73607d00cef2f0bc040e05,27,27,1,189,0,27,13490,1
4c1f07cc035fd2486f649a49f15e0007,28,22,2,98,28,0,11040,1
b51c3ed85b47418a59f48fa73e4aa693,129,110,2,451.5,68,61,04020,3
09fb58942cb4f353c491e227322c8e08,33,33,1,231,33,0,01013,1
06115ed9e8a712692e1d0f4713492764,282,106,1,1974,0,282,01013,4
3b556265637818cf01464d2377113a94,265,125,3,618.3333333333334,265,0,05040,4
93d65d022676a1259b8585f695f9bf75,19,19,1,133,19,0,05041,1
674f696c5d97aa7eb497d6ba352f9122,275,103,4,481.25,195,80,10200,4
be9fdac6294c452732ad871029c428ee,560,170,5,784,463,97,05040,4
d2f15c3beb103d861aa6402bbe3c5bf3,46,46,1,322,46,0,10200,1
9774af72e2b1fa9041063ae6eb4c8cb9,37,32,1,259,0,37,05030,1
a09f5bac087e774d413b3e94673bbfa3,107,88,2,374.5,58,49,05040,3
ccf7d013da35b61d8a9401eb7a95791b,211,111,5,295.4,211,0,11100,4
43b3dde2a1e6dd475d221267662d8613,483,100,3,1127,483,0,05040,4
73224f783f57cb3dc98330cee7057301,146,85,3,340.6666666666667,146,0,04020,3
89784d3dc22fb92d5d2a8ee88c97e6f7,8,8,1,56,8,0,11080,1
0dd42ab63e4f67461704ae141234ca62,14,14,1,98,14,0,01014,1
7543a0216d213919d04348e4b91eb7ac,55,45,3,128.33333333333334,55,0,05041,2
506851fc8a7194896449d855cc7ce71c,105,82,2,367.5,22,83,08010,3
3657a853e997c83869861dfec4263f99,233,118,4,407.75,233,0,05040,4
c65a66ce39558795a1046e1a4c227b54,104,64,2,364,104,0,01026,3
0d40588d961f79984c37ac44ec49188d,72,62,2,252,72,0,01026,2
d3ffd5be20096bedda32b0b1591bf221,10,10,1,70,10,0,09090,1
65e3adb20e6cccd15a1741d39eb71cda,47,39,2,164.5,47,0,10200,1
677f38cc5af92bfaf57d7eb2245cb1c1,62,49,2,217,62,0,04080,2
b81a9dc21efb7ab90ebf5f2df0e1b1d0,138,106,2,483,138,0,10200,3
4d74e3e92a6de171bdb2df4437162875,31,31,1,217,31,0,04201,1
7ff8c50e57258e15032eea969d95930c,49,44,2,171.5,49,0,05040,1
8d1f63a8577a23dc5878ca2ee3f081fa,190,123,3,443.33333333333337,190,0,01012,4
f432350f4a945f6028417f8e040862c2,183,104,4,320.25,183,0,04201,4
59c74af437f42d0eb98c3fabaeaf603e,88,73,3,205.33333333333334,51,37,05100,3
68c242dd28f047ec378fa9a54806b3a0,313,113,2,1095.5,313,0,01013,4
2ce08081c5be03d07343b81ae3eb8b03,24,20,1,168,24,0,05030,1
6d508ec576614c27dc16c13233ea69c2,230,84,3,536.6666666666667,111,119,04060,4
1bbd87f254383a631ca09324895d95af,59,59,1,413,0,59,01012,2
4060b11e04d7a6e5e7aee56f2af4b97b,55,55,1,385,55,0,01026,1
a98e4057f3cd1f05211aec45cb2543d0,63,63,1,441,63,0,03070,2
e0cd23992425b141bb976b8736a667be,297,93,5,415.8,177,120,08032,4
710196ad586ab127baa52bdd90987c0f,56,36,2,196,56,0,01026,1
40aa351aa5ff31ec3414c86f47dcb077,98,60,3,228.66666666666669,98,0,01012,3
08bfff5cb61df19f7f06d4f362f8149b,20,20,1,140,0,20,08100,1
1b61e7989da1a1cf8c1f5215cf810747,40,37,2,140,3,37,03033,1
cd0d491bcf7fca703ea4d9c701e4e02e,34,34,1,238,34,0,01201,1
711aeb0abbdc35dc49694b22ab8bf198,89,67,2,311.5,89,0,02650,3
e53d4d59864b564e2e85ed5a7f1f6960,11,11,1,77,11,0,11040,1
d468fb61993235c3e1d42a12080ce3c6,35,35,1,245,35,0,01026,1
74f0b0ccb283ab2d3ed42254ae0af9ab,15,15,1,105,15,0,09170,1
5200aba89184ed8f343592e543173e0d,65,55,2,227.5,44,21,05040,2
91248696967b6dea411a1bfdd5813893,290,139,4,507.5,290,0,05040,4
08e8035b4cc5049011a6fc9e8411413a,60,44,3,140,60,0,01027,2
d18b08519c4c1f8fba1aba2299a3a2a4,69,61,2,241.5,69,0,05030,2
4f5d06c5da735251494f60cfeb59cad5,56,56,1,392,56,0,05040,2
804de49673bff1bf2952d858c99ceb5a,6,6,1,42,0,6,11040,1
5d44764923bb62ccf822979e44518718,10,10,1,70,10,0,01012,1
48120108f18a374922d7af1a32e01cde,32,32,1,224,32,0,03090,1
fe6b776a0b20fb79c96cb0b13a8a2201,188,95,4,329,139,49,10200,4
3cbdd44c95b7b42f3f1d593f4da96449,55,55,1,385,55,0,01012,1
ed06418aad89403b07f3c1353d9b8302,104,79,2,364,104,0,10200,3
b5b6547a337c65fec28dfcd299e903bb,139,83,3,324.33333333333337,90,49,01013,3
28cd138a034a508897acb45a124ca043,70,52,2,245,42,28,03090,2
4ed4da20df0be457875848230ac0761f,174,50,4,304.5,174,0,01026,3
1855d42ff9a7cc61a4af75d88d72f3bc,284,94,2,994,170,114,05040,4
5671c6c7bfe0b43692083cd5c8995fe6,97,79,2,339.5,97,0,09110,3
774a95f6384a19efcb0bfc41c6d037ee,106,82,2,371,106,0,14301,3
7146472f6e7cc4038a97c02a1f083377,99,71,1,693,99,0,04060,3
be4ef2d8d57ae87f7741964e44fe61ae,27,27,1,189,27,0,01026,1
c04cc93ac869f87591741ebd90c0be44,256,113,5,358.4,237,19,05040,4
2f4153feab7434fb70a97e9e3e7942c3,150,103,2,525,150,0,02620,3
d08276773080f64dcb52cf4c866bfb1a,107,85,2,374.5,20,87,05040,3
d48e6d3b2592efb33720a4ae4251130f,184,106,3,429.33333333333337,184,0,01026,3
d9f1d46f5dcdbe661a656ea43ea36459,180,67,3,420,180,0,05040,3
55500fd11189008641d9b6955ebab525,99,69,3,231,99,0,01012,3
b44656aa23645f7d31e1cb556e83f022,180,101,4,315,180,0,01026,3
d351e1fb6061667770fce56bcbed3c99,64,64,1,448,64,0,03070,2
63ff1614e52e66bff4244e0e19fcc5ef,116,72,3,270.6666666666667,116,0,09130,3
d5770d07efb104a8fa828b5e16364607,52,43,2,182,52,0,09090,1
bd81d987c92e44b41f6c33927dcb3b62,18,18,1,126,18,0,11100,1
d01680fb730e5a8971debc2596efc540,89,88,2,311.5,89,0,10200,3
327907c64ae300859cbabda05ad6578a,123,94,3,287,123,0,01012,3
48e563da51005bb6ba6c60140fd7ae9b,53,33,3,123.66666666666667,53,0,01012,1
36c8ae0353dbe8076a2e36efb6df221b,42,30,2,147,42,0,01085,1
7cc10122c8f682f5f75ff087d39cad86,18,18,1,126,18,0,01012,1
bc134c60cce4b0520e4aad9c53e23a56,158,88,5,221.2,158,0,08052,3
75c17f2b15717d2ae596534c484cbd58,184,106,3,429.33333333333337,184,0,09170,3
d222efeeb1e1ed8c42a25c289b9aaf48,54,48,2,189,18,36,10040,1
3a51ebe1002f7b9ddb303bdacb684d07,60,50,2,210,60,0,04060,1
0686f0a72e5e609b8d1bdabf9ec17f07,41,33,3,95.66666666666667,41,0,03070,1
affb85c1786fa989ab014cbd886c8db7,31,22,2,108.5,31,0,05030,1
585d00f53cd14406fd87fbfbb81432f5,157,90,3,366.33333333333337,109,48,01026,3
4c7dc317176771d1a26096a4effe3af7,13,13,1,91,13,0,11140,1
2aba11e3277c3677912e6dc4497098a5,546,148,3,1274,546,0,05040,4
ef54f292c90eb304a975f8f9043db851,39,36,2,136.5,39,0,01026,1
04fdf24660fae8bc0b207d73f2ce6754,39,39,1,273,0,39,09030,1
1499ae800ee292085128dd36844f46d8,140,81,2,490,140,0,01085,3
36cf74c8d7afd13c73d954f4ed0b8c11,42,42,1,294,42,0,10200,1
a69d9531bce96571e6ae4678051e8c47,107,81,2,374.5,55,52,10200,3
687e1a50449b153134e832490f29fea1,294,100,4,514.5,206,88,01012,4
25fd087e52b3401b3bf6ccdb3f0c9fe0,39,24,2,136.5,39,0,01026,1
d72a350de9aabf385e66688b7f79dbe6,61,61,1,427,0,61,01027,2
96049ac4047a9dd5eec10e1f04df3429,239,98,5,334.59999999999997,213,26,11100,4
66c2e11fe4673c1b4e162e6a240ec27c,136,81,3,317.33333333333337,136,0,10200,3
d8713e7827ffdf2a37fa7ae338d02c3f,27,21,3,63,27,0,05030,1
7ecd365b0de5bc7c1d08af3bc5dc524d,53,44,1,371,53,0,04020,1
0ffe1ca7236230dee5ba338c9e82ad4d,53,52,2,185.5,53,0,01026,1
86220aee05dc00d13017d1fb92d9eb40,19,19,1,133,19,0,04201,1
017af3a3f45d24c017220f2f92145da3,90,75,2,315,90,0,03090,3
02fa0d8be5c017d6debd569685496013,19,19,1,133,19,0,04060,1
3db3345a57d11aea8b2d6034edc2c585,56,34,1,392,56,0,08452,1
95ae3468718d9b8efdbf847cd1753dd5,111,63,2,388.5,111,0,05040,3
0f251568febb02f9961c62279b53dd1e,71,57,2,248.5,34,37,12500,2
910b71ce6692769163d962e609e6f70d,16,16,1,112,16,0,08052,1
b48c7be4cccf91eab610d2969fe6d12c,18,18,1,126,18,0,08010,1
9a1c10dce54629da70407ba54f802437,148,112,4,259,106,42,05040,3
4d6b1dfa438030b83b61ee17e1ff6134,31,31,1,217,31,0,03090,1
48e74e75065d0eb0b792d9809d4e3b3c,127,100,3,296.33333333333337,127,0,09130,3
df37e76670f99a11f100ed8dc68843fd,39,27,2,136.5,39,0,09030,1
1b864b583364b92019dd9fb0e5635fe6,43,43,1,301,43,0,12590,1
77c1f3dad78ff7f9d6ebe9e0a46bbff5,51,50,2,178.5,51,0,10200,1
698d2585a9b1d70e2312d4f1d005af5e,25,25,1,175,25,0,01012,1
0e41ba39cee9ca9e1a14432b393226ce,69,61,2,241.5,69,0,10200,2
0fc67b6391fe4ea830f833c879d407a7,369,163,4,645.75,369,0,01026,4
5f72ac652cdd9302c23e26ca40e07492,18,18,1,126,0,18,05030,1
40bc3e82bd38327d844a4c59f49a388f,91,68,2,318.5,91,0,10028,3
313fd5cb4099f97e77dd4d7115fcd5e3,114,96,2,399,33,81,01027,3
fd838873a2596f30da2e6da7ddcad8ff,59,59,1,413,59,0,01027,2
ef2eed1e3d5dc86529246a18426c97fc,249,92,4,435.75,249,0,01026,4
b82d81ed66a1459e1c382ebce2a9ba70,394,154,1,2758,394,0,05040,4
75d629a112ee271875b5e5f5c52d7718,142,115,1,994,142,0,13490,3
f51c7a11002e4332998d9c2f0ab6a27e,209,65,1,1463,0,209,04201,4
9f08c754d0243ed56cb43fe53bfed2f1,109,76,2,381.5,30,79,01085,3
9ed1814a290f00fde055699670d4f8fc,91,62,3,212.33333333333334,91,0,05160,3
bc9724d1b430da1df2bf0fe673bdaa42,9,9,1,63,9,0,01026,1
d3de9d52d5e49b3c92c026c96d926221,50,37,2,175,50,0,01027,1
77639d597143771c0b357cdd0d957db7,5,5,1,35,5,0,07123,1
99d8f4d4de319a08e74e1268e05319e4,42,42,1,294,42,0,05100,1
69eb2b5318fc92145caff8ba07bc8d10,133,128,3,310.33333333333337,133,0,09111,3
fb3f5ee2ba27f5b23b1064c67b557649,45,45,1,315,45,0,01085,1
94b52314b53fcd484a006d26d903dddb,126,77,2,441,72,54,05040,3
5d2d8dda065ac8486c76dad120ebdc2a,106,69,4,185.5,106,0,05040,3
a919c8ad749912ea8f06e3a3eb598154,55,47,2,192.5,29,26,08230,1
5c473876e24804710483c37c4d3e92a1,16,16,1,112,16,0,10200,1
c987a37fcf2bf87f51f55c256f102061,20,20,1,140,0,20,11060,1
61c457a5a6dfd9197ffc6ea218b56ac9,36,36,1,252,36,0,01026,1
6a5894b078d1ac29709af194bdc5efdc,246,127,3,574,246,0,01026,4
f887ee7f053551b9aa924e59b6134a06,258,109,2,903,258,0,01085,4
5776b88199f24e9233e5b4786633814a,27,27,1,189,27,0,01027,1
c8461d1f2e95f419f1160bd5ca306c78,39,39,1,273,39,0,09130,1
bca468d06f8ef4d85ea7178b324aa128,12,12,1,84,12,0,05030,1
e2e5ef99e3ca1ffa2b683448d8de3d6e,71,71,1,497,0,71,10200,3
09450bdc080ae3dea50c7f8140fcc5c1,284,113,3,662.6666666666667,29,255,10240,4
5fd0bdbe9404d3273b5ed03fb4be06a4,20,20,1,140,20,0,05030,1
9b4a96bd152dc9c5673a96c5dc5dd098,122,93,2,427,122,0,05040,3
8f685edaef42f15c47dc2eabc8f48671,70,53,2,245,70,0,04032,2
5480b6b6906238d212d7d6878711fce3,48,41,1,336,0,48,01026,1
4e37fc58db7a51649fc77e6f4b38d5a2,15,12,2,52.5,15,0,11040,1
c40f453000d28b7414699e0d947ddd26,274,99,5,383.59999999999997,219,55,01016,4
2b4799aa21d016e8126ad3df2ded0b34,324,155,4,567,287,37,01026,4
296ab7319c3acbffcdc80fc86b552d29,306,93,5,428.4,306,0,05040,4
f8db0c300416e7d0959f0bf8271f51e6,29,28,2,101.5,29,0,05040,1
59d0f0c95259355f1001dc8c71814fb3,372,146,3,868,306,66,05040,4
59381f77cdd186e17160fbd3eb06bd3c,670,176,3,1563.3333333333335,2,668,01026,4
34b03afdab69161826920c03001fe596,79,62,2,276.5,79,0,02620,2
af0ec59913afcfeff3b06d714a5f52be,53,39,3,123.66666666666667,53,0,01016,1
9f56673959644187ae6fe4a7c3b8ce60,33,33,1,231,0,33,01027,1
2062e9ee689c1809499beebb34f40ee7,336,172,4,588,243,93,01027,4
8ada60dfbe3856f518d000b6079b025f,103,75,2,360.5,103,0,04020,3
6315b1ab21eec333e9b97f16bb2aa58e,128,67,2,448,6,122,02620,3
d2ba4b293b8b8b4239b7c5bfb500cb05,97,80,2,339.5,34,63,03050,3
7fc7d50ec22de4b3f05d6f07a9617924,51,42,2,178.5,24,27,05030,1
e2f3b26589fdbbebb279376bc7068d2d,147,98,3,343,147,0,01012,3
763d725ae6d44be10ecc1133c4843c8c,2,2,1,14,2,0,09010,1
2deba1a07568820b3b39e6a7b5690ec3,209,92,5,292.59999999999997,121,88,05030,4
873c4ea03ede0f5d4e0f66a4de1cc1bd,27,22,3,63,27,0,05030,1
75d1b910d70bbe611e92d4ff81d83c46,41,36,3,95.66666666666667,41,0,05040,1
c863969fb96dc0d9428c61c9040e4cb5,86,70,2,301,39,47,01026,3
8d2f50658512eb33927d72afea2b6808,96,32,3,224,96,0,05041,2
6e6540960d93d190fab3b0c19f8da024,38,38,1,266,0,38,01026,1
08018712cd912cf85d19f0b22bea13cc,66,48,2,231,66,0,01026,2
2f81f31ce7c0f2629cf2139e563b6e02,368,141,1,2576,0,368,01013,4
4a8a43ed775dd0b4dc2c26df9e79ee1b,31,21,1,217,31,0,10080,1
993877b253d9b804c616060801aa2453,16,16,1,112,16,0,05040,1
b8bd63a5e84dc2e2c986627d31c02e7a,29,29,1,203,29,0,01012,1
5c699606e8637f68f86b13671baec7cb,61,37,4,106.75,61,0,10040,2
e38facf9360102fddf7f275d65e83fb0,110,91,3,256.6666666666667,110,0,10240,3
cbd1cd499b34a6bd5ebf7fe2185e3203,139,114,2,486.5,139,0,01026,3
99bdb98d94148200239625f3a3ccf6a1,64,56,2,224,64,0,05030,2
2f0958f79404b677508caf77c4af7e95,4,4,1,28,4,0,05030,1
46f4a34d1c6a87f1b0e81651b236edbd,128,96,3,298.6666666666667,128,0,01012,3
c8c8a3f9b3c6e3b390dcdac2502ac14c,72,56,3,168,49,23,09130,2
aaabbb5c061f61018c322d9cae53af67,364,163,4,637,299,65,05040,4
3d9494426a90399aad663483d37f1d90,65,50,2,227.5,65,0,01026,2
26e5a940f225abe8d9c6ee9eac779fb9,49,45,2,171.5,29,20,01013,1
7b684e571fe7fcd715bfa45ab6ac9945,43,34,2,150.5,20,23,09170,1
7d5f4264dc9c3e71a4d6c0810bae9651,193,94,3,450.33333333333337,113,80,05030,4
5373aa889bccaf95b5b72b12d6532fec,112,63,4,196,112,0,11140,3
0aa21b1c941a6f55a0a7a5fdf5eb83cf,13,13,1,91,13,0,05030,1
92341f64169df70f57b0b921aade6dcc,34,34,1,238,34,0,04032,1
234428fef47e59eb8afdc43ce44410a0,151,107,3,352.33333333333337,151,0,06100,3
c9ed872491f99abcbff1384037fe11cf,22,22,1,154,22,0,10101,1
cfa0243482ab9c8370ebe82b709c0de4,146,109,2,511,146,0,01026,3
f9f03e801a2bec50b8982be52776c0ea,134,94,2,469,134,0,10200,3
df30d49ddc28a36cadcb88b4cdc6686d,287,63,5,401.8,220,67,10200,4
17a0dfb7f6da37a8e0b397a01468c56e,189,123,4,330.75,156,33,01026,4
3ad22dccc252eb7f34725f03350f6300,98,73,3,228.66666666666669,98,0,03070,3
8efb049df2432b3a4950fc03ae290873,43,43,1,301,43,0,03070,1
41b6b23f66d7eeeee571fe5258b02f26,105,67,3,245,60,45,02650,3
abab09e6c2278b14317f8010ac87b332,127,54,4,222.25,127,0,01085,3
17c95f961ef56180cdf4fe6aa85985ee,77,61,2,269.5,77,0,04080,2
9228bf87ea1ec3db1d0c95e757428e79,88,45,4,154,78,10,11100,3
aaf23ba771f18a5baf471bafddad69bd,246,130,3,574,246,0,09130,4
0c7c200904393b326369a1a5ada400de,11,11,1,77,0,11,01201,1
589ebc520b9cf7607dde58204aabc9b8,44,38,2,154,26,18,01026,1
a9a68e1e55c2b1c2ff3f22a63c029e24,29,26,2,101.5,15,14,10200,1
7dd775a7f5bec2723e715e3a35e398fa,162,109,2,567,57,105,01085,3
43c7de82446c4d291fb30a5975532037,149,73,3,347.6666666666667,53,96,05040,3
95bf3c6d4be438dec775237797a6a378,12,12,1,84,12,0,04012,1
b41d9fc7cd1947c161bbb0bcea973b60,39,39,1,273,39,0,01026,1
d3a216c540518d29aeec9a0c0034b8ff,33,24,2,115.5,33,0,05030,1
1ce7adc730ed95787ebd5c8e22b968c1,56,51,2,196,56,0,04020,1
9e7520ad25aa8b8d651f85c4f3879e2e,357,175,2,1249.5,357,0,05040,4
ed3c7e0fb35769b80562ff47dfe33a61,66,36,3,154,66,0,01012,2
3c578265d857ab5c65af84e80567a149,18,8,3,42,18,0,08452,1
75aa5b150e3e24ce4fa3cb82cc265fbc,100,49,2,350,100,0,01026,3
ca5ef6cf3b9556db5e3733199e81b584,15,15,1,105,15,0,01012,1
655ec6b057cb65e19b281492a988a97c,158,98,2,553,158,0,05040,3
a10a46a401b9455774afb0f1c6f43d12,4,4,1,28,4,0,05030,1
44012633834d4d0ace0527a60d97faff,29,28,1,203,29,0,09130,1
2757a26ebccb70c9d40e07beb005bbcd,145,93,3,338.33333333333337,145,0,05030,3
a51c817ba17b28bb640f8e3b2dbc1fd4,235,133,3,548.3333333333334,116,119,08051,4
1351abb1d09aa2cba67747daeef64b5a,70,70,1,490,70,0,02751,2
bcfd092783511c8d92379df41f947e92,22,19,2,77,22,0,13930,1
05a1bc3c8cf791040c902ae016f66d38,250,113,5,350,183,67,05040,4
e19afe24eba738f61e7b4a09dd29863b,119,78,3,277.6666666666667,119,0,03050,3
e0587e2a39d5356cb16b9bd2080fc4c3,265,88,2,927.5,265,0,01012,4
26ee10a5c291cde71cc055e95a9000d6,25,25,1,175,25,0,09070,1
fda8571b66f5e811a4206e91ac4ed5f8,6,6,1,42,6,0,11040,1
603543359075d901392842b980d76667,134,102,2,469,74,60,01026,3
a512ea13439ed455ad7c99bf93b05a57,57,46,2,199.5,23,34,01027,1
bd2f9faaf6435bc906d949db9f236621,216,139,4,378,165,51,01201,4
36017c9c626103917bbdc8db37a4a48c,73,64,1,511,73,0,01027,2
0f116642d437a97592569d86a664d9cf,75,55,2,262.5,30,45,01026,2
7e63b3a74ef12b00dc0e6d987ae21164,130,97,3,303.33333333333337,130,0,05040,3
975273089bbe4a7990cd2e06420908b4,12,12,1,84,12,0,12501,1
24df1b4b325029bbec539ba21785b9ac,78,64,2,273,78,0,05040,2
36e8d721f1a20e136094e6da5db5c45c,121,99,2,423.5,121,0,01026,3
a16c3255f68c20b1014d48a703a7e929,27,27,1,189,0,27,10200,1
81d64300fb31d53aecfa04aacd5f7b54,43,43,1,301,43,0,05040,1
cd16b19617d5bd3f8d446e0a8c6d63c3,126,77,4,220.5,126,0,05040,3
3aa6c94cea5d81f9a16409b2193a6647,15,15,1,105,0,15,01012,1
19f7ec1b510df924d54462b3e44ba769,36,36,1,252,36,0,12501,1
3710356b7eb6d518b4944d2fe2b8c836,66,39,3,154,66,0,05030,2
a0bf16d89142172bfb315c7f910d1c95,62,45,2,217,62,0,05030,1
cdca572731d702e949f0f0d03b564170,36,20,2,126,17,19,03070,1
435749dae608c2500b0ff92a1adb1567,80,50,2,280,80,0,10200,2
1e61ab77a65d199763022b6817e33949,9,9,1,63,9,0,02690,1
e533ad674d0fe801750a50c62e8965ca,53,53,1,371,53,0,01026,1
78016e7fdfcf7f9870ebd76d9fc36096,68,61,1,476,68,0,01012,2
c10d0bc0fb367edd30457316a9015258,38,38,1,266,38,0,11103,1
9b063e78d6b7875dbef710b06975a5b2,34,34,1,238,34,0,05040,1
304af701f47ea10c7ebde6b0150f2ed8,1,1,1,7,1,0,11080,1
287c28dba0a8531a7ab9bfaced1e195f,51,37,1,357,51,0,12410,1
50aa66f37eac165dc81ba50b39328b4d,43,43,1,301,0,43,01013,1
817ef4ac9e3636f614537532e919f460,38,38,1,266,38,0,03033,1
30205aace14e78421f6dcf07347349cb,61,34,3,142.33333333333334,44,17,09010,2
a908013f251e43260b8a0e97c4760bb7,103,50,3,240.33333333333334,83,20,11040,3
c049fa9f5033d637937823cedf5d8c78,289,78,3,674.3333333333334,264,25,01012,4
3f5380e62f5fbb4876dbfc1e36910999,58,58,1,406,58,0,05040,2
11a2c6d94a73d483db22fef35a8df2fe,44,34,1,308,0,44,05030,1
0bc8c33b30b05b1bf6dceac614a96771,6,6,1,42,6,0,08131,1
df439669cab315c9ff392986861c6631,60,56,2,210,15,45,05040,2
0f2d5100733f7cfeec94c525a13066ae,114,111,2,399,114,0,09130,3
ebd00b60522fb6a1765326e62d15b1fc,221,131,2,773.5,221,0,01026,4
85e346a57a5e1c0f243b5c107640084a,40,25,2,140,26,14,07122,1
a9e0203b2a3f503820bbc7e389e07e34,70,38,3,163.33333333333334,43,27,03090,2
a9dddb0837cd7e7867bb10f6250eb15c,27,24,2,94.5,27,0,14261,1
dbd2baa2ea9f3fc4c6fed112dcc4658a,37,35,1,259,37,0,09090,1
e5097dc238ddcfec6bdffb4327fba927,105,78,3,245,105,0,03070,3
af023a354f6bdaeb99c279801e31c4a2,238,122,2,833,238,0,10200,4
89f81d748e58058202b674e82f80e2c0,41,41,1,287,41,0,05040,1
5bfef07528d74961b1ba92e264c6cb62,286,123,3,667.3333333333334,286,0,01013,4
990c540d91c5689a8c14e8ca76703d10,40,40,1,280,0,40,13830,1
b0b496a429dc8871d6377e5f1566f0dc,234,106,2,819,118,116,05040,4
2fa2a62d2cd1f41bd8da32d0baacd9aa,436,137,5,610.4,320,116,01026,4
dd5be0922b8cd587a1d435504f9018ee,48,42,1,336,48,0,05100,1
d5d960abcbb6b884c52397a56a76a49e,75,57,2,262.5,75,0,05030,2
ec3d06fd5c6a899bd4aebdfd5e429151,277,132,5,387.8,153,124,01026,4
cf40657cf23f8db42a8e858d5c106d57,142,100,4,248.5,83,59,03033,3
492e67b4d7a29ac56c33d73bee8c23a1,76,69,2,266,76,0,01026,2
9db3950c1ade56c781cf1d1f4e0ebde0,134,92,3,312.6666666666667,134,0,05040,3
55cf45eff3f4b5d9581d14016c7125c0,77,50,4,134.75,77,0,05040,3
9c8dbda443d6d4252065c534ba9f497a,113,36,4,197.75,99,14,05040,3
93e4acf85ec01f546b4193b54450cf4e,210,69,5,294,189,21,08312,4
cbf1b914fb217edea7226a4974f740b2,29,29,1,203,29,0,03070,1
504773c281c5792ac6dcc0dd23123701,445,93,2,1557.5,12,433,01026,4
858e1beed186c96724d8ee2273c01f30,150,67,5,210,131,19,08032,3
97cbda65d76d4ddb10c3f93f5ae90f4a,80,54,3,186.66666666666669,52,28,05040,2
ff7f7b59ef53c675d95c0ea721717ecc,43,43,1,301,43,0,01026,1
bf65a5d244ac0637ac6d4ea8b8b03a82,111,56,3,259,81,30,11100,3
1a85d5b699c944f4803ec401a1aa7fab,15,15,1,105,15,0,05030,1
91d6854cbe30877a081f3afaa2f3197a,15,11,2,52.5,8,7,11040,1
08387801853df45e950eb4b8b69a0ddb,16,16,1,112,16,0,03090,1
998e589605fbdfa2e55e7ebaed6746cb,63,46,3,147,63,0,11100,2
4a4654a26ceb170b556458202951b9e6,78,60,1,546,0,78,11080,3
69adcd5d6d05b66e0082f0bb52c1d69d,15,15,1,105,15,0,05040,1
e8d1fff5a3ac25c0a7621527d290bc60,28,28,1,196,28,0,05100,1
01dfb107e6ae4fea7231108d9a87b6c3,43,39,1,301,43,0,01013,1
adb137d16e10cea520bf70d15681e8c0,95,76,2,332.5,60,35,10080,3
e779993620dcab1e8c0fb9420cfb8d25,75,57,2,262.5,75,0,05040,2
97811393ae2ae217a8cdbe87ba35d604,121,57,1,847,121,0,08313,3
35114508f906e02335bf6945209c3fb7,76,62,3,177.33333333333334,39,37,01026,3
fc1119f1d0beb30d782114dc3a30b11f,33,33,2,115.5,3,30,01012,1
dd546532f15c6cb5434c5102a58fd497,14,14,1,98,0,14,01012,1
c2062e1ff1c0821655fdd5b8d92eb845,37,37,1,259,37,0,01012,1
5ed7b149f84c21d100ddfff5981423bc,52,52,1,364,52,0,09090,1
1f41a27773dd97df3b5306be98f59edd,54,48,2,189,54,0,11040,1
561ba4fcfd1779c279adfe594e5f142a,60,56,2,210,60,0,09130,2
3ea7f4be38b0d13586e66854a1b9c7ff,36,36,1,252,36,0,05040,1
6752b0c08d1f943e75d45bb785b22a93,48,48,1,336,48,0,01026,1
381cfda0e4845e8a2c32c0845bf82ffb,4,4,1,28,4,0,05030,1
eda3571c9e426e1ab2e476986418f934,73,50,2,255.5,73,0,01026,2
88587dcfbb6bc81d88b2b1c902c5521e,90,54,2,315,90,0,01013,2
625e68a7bae99efe2e3dcc6cf5e0e31e,58,44,2,203,58,0,01085,1
0fa35c1b618a79908180cfe514759c14,496,202,4,868,496,0,01026,4
4923eb0392e9b3ae692a32b5baae4b1c,11,11,1,77,11,0,04201,1
0e69f854daebcc1365accc57dd03ea45,55,49,1,385,0,55,09130,1
ff5fb0f25632e101aa20b0ccabe104e0,124,85,3,289.33333333333337,124,0,05040,3
ebed790609a9a4bcd6124c055d779784,287,96,4,502.25,226,61,05040,4
8a75e851a44ef9ca7214a0127331a729,60,41,2,210,60,0,08100,1
38f9a0baed37a516ee36d161a1861102,221,109,4,386.75,144,77,01085,4
00c028cba42fa353966abe28d12834eb,126,90,2,441,126,0,05040,3
a978cc4c30fe3c12e70f2890ebb8b09a,79,59,3,184.33333333333334,42,37,05030,3
726f6b63d6c2b7e369d5a31ef35e2be1,94,72,1,658,0,94,01026,3
00fe24f586fa6a3fa1af4a9b6338520b,40,32,2,140,40,0,10110,1
688621d8f55c487aa6d973fcf6eb02f8,2,2,1,14,0,2,11080,1
f187a055bec3ca98110a349ca1f54256,104,81,2,364,104,0,04060,3
4642e814a2af5adb9de76d1bd1b3726b,129,38,3,301,129,0,05040,3
ef63f29fc5fe9eb36ace0734f6b75af1,22,22,1,154,22,0,01012,1
8e7e3470bb398d00e82988fa704b436c,45,45,1,315,45,0,01013,1
dfb62be33a07ea78cab4e97f2899703f,50,50,1,350,50,0,08452,1
fa31b3b1afdb4c3d95c18f140279c1f9,30,30,1,210,30,0,01026,1
717c179d79874e25729c8c47eb7b4417,42,42,1,294,42,0,05040,1
4acdf78d5ede0f190129572e1b91d349,71,60,1,497,71,0,04020,2
bd74ec408d4e04da1301b68560edf4ef,176,113,4,308,148,28,01026,4
a7c644f1673f7287e29f9dcc4a15e1aa,44,35,1,308,44,0,01085,1
9a25921403cccaf03b46fbfc24dca7d2,77,52,3,179.66666666666669,77,0,10240,2
349c111a78315e0323852522ff686b06,25,25,1,175,0,25,01026,1
f87f26cbf04b2ac4405531b5d8c00e61,121,72,2,423.5,121,0,01012,3
55bfc17f2592a0a777ea2b1d17049942,220,168,4,385,145,75,10200,4
bc63bf9b9ad531d9385526a3cce6ed8b,45,40,2,157.5,45,0,01012,1
4a7fa515370f356a5892477fae0bb2c2,149,119,3,347.6666666666667,77,72,05030,3
fc443320bface6ae2bb8c612337fb998,123,77,3,287,69,54,05040,3
6044ed7c212d76e23c5db723c0c0b380,155,89,3,361.6666666666667,84,71,05040,3
0f227f689c0de53f6e815c2744ab7079,75,62,1,525,75,0,05030,2
5876a6d62db49a924ad743280623a7ff,34,34,1,238,34,0,05040,1
9f09a0ab5e20c083970c7d5d99c65571,17,17,1,119,17,0,10200,1
a88753e64bae76e7781cd63bd0a6c9c4,333,184,3,777,333,0,01013,4
c2ef1b7621feea601f5a6de1ae60e304,151,90,4,264.25,151,0,05040,3
4c5580549bf72789cf864694fd40481a,29,29,1,203,29,0,01026,1
ab44441ff3346edd1cb550ef1408c709,8,8,1,56,8,0,08100,1
eced23db4054431c8c164120470c06da,262,113,4,458.5,262,0,10200,4
81b20270a3cd8f834f2b73468da32c3d,23,23,1,161,23,0,01014,1
e58163a60e42040eefd64a729d462b97,312,151,2,1092,312,0,01012,4
0cda5c0b39cf7840e1689bfeba2eba71,101,72,2,353.5,101,0,05030,3
fb7e85e7e476066e9ea4ab4910206a28,160,101,3,373.33333333333337,160,0,05040,3
0e232854072803c4d8ae1efda4d0bbe0,61,47,1,427,0,61,01085,2
809ad50bfe814eb395b7e193d9bbf3e6,37,37,1,259,37,0,01012,1
fb8c6792010e8fcaad67c4e28e8600ff,5,5,1,35,5,0,05030,1
e312aa7e24f3bab9cbdaa5369042a89b,127,73,1,889,127,0,01026,3
b5042eac5e139be345fa5b2ba9856614,5,5,1,35,5,0,09070,1
91be5b3c1c4f403c5178fcd6debab735,65,45,2,227.5,65,0,01085,2
c3f0b95785b38fb503bb6450010489f0,53,30,3,123.66666666666667,39,14,09111,1
98edc9b8ab074372df541e98b922569f,28,23,2,98,28,0,12570,1
e264cffae4d9d0f01248420c7b535bf8,12,8,3,28,12,0,12650,1
6019a30d3c4b38e87e910d4a7e623195,204,88,4,357,179,25,05040,4
400addb6760b5024d1f59885abbe3eb0,488,126,2,1708,45,443,10200,4
c3ef311ffdfb8b74b5e1a2e4cbe6885d,93,85,2,325.5,93,0,02650,3
9234fae8677e65ef96bebaa5297c1b20,92,75,2,322,92,0,10200,3
0f96ba034b749b1727322e1b6048b52c,35,30,2,122.5,13,22,05030,1
aa2b450051cd6157aaf12c829296f5b4,86,69,3,200.66666666666669,86,0,01012,3
cc34229f2b34dcf294114ac9931a404b,9,9,1,63,9,0,10080,1
8b916d9a51b8448328006334bff2b0cc,53,53,1,371,0,53,04060,1
2b828345ac7f9c4cc25e52c0e9961c65,24,24,1,168,24,0,12570,1
72c1c5083d0839eee38c70bd6ccbaefc,10,10,1,70,10,0,09010,1
4b4a4c7143e4056a7b3a1c0f92e015d5,34,34,1,238,0,34,03033,1
1b5d6398ff7c389d40d609d4feabf809,26,24,2,91,26,0,05040,1
81efc69981202a5247f48eceee40a295,83,55,2,290.5,30,53,05040,2
a414549bd0def799857db6e235be2d55,32,32,1,224,32,0,01012,1
6a8d74fb6bfc9586a23f6096e41ff7c9,18,18,1,126,18,0,02751,1
f5a82b7b1d969c3264a8ac4ed55fa3ae,31,31,1,217,31,0,09010,1
3ff216509eb97be25d7e1aac96d48401,12,12,1,84,12,0,08052,1
90955988985894e411ce0a5a693e91d2,64,58,1,448,64,0,05040,2
2c3771fe4e550e8f20caa9c9f3afa13c,59,59,1,413,59,0,05040,2
ed076ed6f0b0f3f8552f60583e664a1a,71,44,2,248.5,71,0,05040,2
d7c52839cedbb4badd497cd0318ec5ca,254,143,4,444.5,254,0,01012,4
8ceed4ef721fdf4933e34287400c6116,130,77,3,303.33333333333337,130,0,01026,3
93c875b7bdb617678c46fe4ffe45640c,110,64,3,256.6666666666667,110,0,08314,3
39d4790aeb96669733bc5bca4cb0bb1d,55,43,4,96.25,55,0,03050,2
a86779ca8578273e3d7806aabddd83f8,40,38,2,140,40,0,01026,1
ba9776870d0c00a988eba54c642204fc,33,33,1,231,33,0,01012,1
343551f13074d031e5c25ac128d78c6c,53,43,2,185.5,25,28,05030,1
9e75be0fd36b4d7cf7659446421425b1,14,14,1,98,14,0,01012,1
64f2ab386e77c1b98df0401a3190429c,51,51,1,357,51,0,03070,1
252d796a39a890db8fa078a0f27521b2,155,73,1,1085,155,0,10200,3
9ddabc2f7f186602d65a058ab810a730,223,149,4,390.25,159,64,01026,4
032ea03347ccc20e98c7208b3af26774,33,33,1,231,33,0,01012,1
5e70dc5b1daf0b509cd0e01ec79dd65e,19,19,1,133,19,0,02720,1
fe841722e26a5a036bcb1e037e3ad4da,17,17,1,119,17,0,03050,1
09e7ea221426e193d645a240be804119,41,41,1,287,41,0,08032,1
e5641654a46dd72b5bc01142f0feaed7,78,68,2,273,78,0,05040,2
0e6ec85302c20256cdc5a875777c04df,51,36,3,119,29,22,05100,1
78cac4dfb3bfef0c8b2177a145b980cd,118,73,2,413,118,0,05040,3
b885aaf0a180e90f7af63b4f6f873b50,44,25,4,77,44,0,11040,1
8a2aed2bbb03d663072b3b09d95f1747,22,22,1,154,22,0,04201,1
378137d53ed47d987eb4a54d28dac5ad,194,126,5,271.59999999999997,158,36,05040,4
07bd507c69fa8c1dcffa5e4c6f2dfe47,25,25,1,175,25,0,02750,1
b519a0b4878c6d34b7fce030118e203c,17,14,2,59.5,17,0,12670,1
9ada37a090406e3b6794baca1aeced95,199,111,3,464.33333333333337,147,52,01085,4
036db132790df3a4ac82ca104bb30fbb,3,3,1,21,3,0,10080,1
52d78637ae9128e2671f704a4b6f9e77,156,72,3,364,77,79,05040,3
c455cfa4007c02cee668acab77836bc4,90,70,2,315,41,49,05040,3
bebde14f4fdb17f8f2fc22b0fa1d963a,39,39,1,273,0,39,01026,1
14de785b2973e5cd9aeeac4d06e827dc,43,43,1,301,43,0,09130,1
5acca6f8f4a17b8587d65ab1158743a7,30,30,1,210,30,0,09130,1
3c66ac31dcaa686890307fdc28672f76,60,46,2,210,60,0,01027,1
007e107c419d56f77ee4184799ca8681,50,40,2,175,50,0,05030,1
323199766bfc1af98ebc7f5b1163cb3c,24,24,1,168,24,0,01014,1
80195e8ab3bc1619d5e1c053ee62059f,23,23,1,161,23,0,05040,1
b60fb66a4915740e13c14d134be28788,208,110,2,728,208,0,10200,4
a44a7739254d8401240c8d9aaf42494b,144,101,2,504,144,0,09090,3
7940eca8769db162640aa642099ff9ef,27,27,1,189,0,27,05040,1
1611d345c39dea010cda94a444d8b8cb,18,18,1,126,18,0,05040,1
95e227203a0f371e2ab647f0a347b05f,28,28,1,196,28,0,03090,1
658f5bfa53e3c6625a650418c082a1c0,63,50,2,220.5,34,29,01012,2
5d81b3bfea52615d11fb6c964e3290b9,21,21,1,147,0,21,01012,1
a91a32804169bd67ed52da7cbf838828,25,25,1,175,25,0,12670,1
26ed6a007310bffdb6d8d6e4993e8463,64,50,3,149.33333333333334,64,0,01085,2
7b6f91d456fd279767b5aef204f0076c,36,29,3,84,36,0,05030,1
0b867caf2b21fc1a89cab57f4b566a7d,91,45,3,212.33333333333334,91,0,05100,2
73c0a0e58c4bf1be5e7e0d129bcef47d,201,84,4,351.75,177,24,01027,4
4ade17e6dc4dd65551b75e6a655f1cc4,82,67,3,191.33333333333334,58,24,04020,3
675a4b8e382becd230fab29708e6cc11,13,13,1,91,0,13,01026,1
c8d767871529a08ab7639c7814c4e1a7,27,27,1,189,27,0,03033,1
4c4764451fb4990b6d260179fb1e66e3,36,35,2,126,12,24,04060,1
821db477325ec1cf3a9f0d4571ce2195,41,41,1,287,0,41,05100,1
6009bd7132697235e57212b50af102f6,59,48,2,206.5,59,0,01026,1
233ddf7d37916b1eeb2fc4dcc0b8cabc,69,61,2,241.5,69,0,09030,2
fb3eeaa2d3adf6c71cadeabcda4fefe5,327,144,4,572.25,327,0,05040,4
32b8bc582cacf70a116747069c43f4f7,100,59,2,350,100,0,01085,3
7d8b3ecb67b01bf1f10a2375b4d8f05d,287,150,3,669.6666666666667,228,59,05040,4
12fbff085a7744825e50da118d3ab614,29,29,1,203,29,0,05030,1
f3d37aa64503a8f162aea3ecab8976ce,83,62,2,290.5,29,54,05040,2
e6a7e8d49b95da534787cb0009d4d04d,97,67,2,339.5,97,0,01026,3
1d5e50d5c19e0d9391da206234b84ee0,43,33,2,150.5,22,21,05030,1
fe4d2d3d9bae5d509557b07d827f69b6,136,77,2,476,136,0,05041,3
a7be76b08958225fef88a8b2ba3ebaad,26,26,1,182,26,0,01012,1
cc79bcfd6fb2bd7066babe7b0c474231,643,247,2,2250.5,643,0,01026,4
ab2b8eafc90a02a71186b11190b56411,110,67,3,256.6666666666667,110,0,05040,3
c2ab41a42dee1b5c74946ac64d93827d,129,81,3,301,129,0,08100,3
3ea5ef6d33531131e5a68a56f3065258,42,42,1,294,42,0,08230,1
bcbf6731a8f29f4c00d3766aa2cc13d6,118,92,1,826,0,118,08313,3
46c8adc0c91eb76574b90989a8a6b881,315,116,5,441,238,77,02620,4
427f63849368c3570ab6d25cf6c7321c,261,106,3,609,261,0,05030,4
c997798866f5149e1bdfbea764e592aa,58,58,1,406,58,0,03050,2
73d69a56330d1966d1cfdc5b2d6bed1c,239,120,4,418.25,118,121,05040,4
fdaee47413d1a2123b34bee8e0f2489a,58,46,2,203,58,0,01012,1
279ad989ff893d5d325b821bb515d7f2,3,3,1,21,3,0,11040,1
130bbe5ca1c49e556c4b7c5d890bab8a,99,60,3,231,69,30,11080,3
725379baf6154c95bf93f1e55838fcd3,100,86,1,700,100,0,10200,3
5a43fc2d02a537e53456ba980b6b5735,22,18,2,77,22,0,12502,1
332b67526b2346acce1be74cdb1b70eb,70,42,3,163.33333333333334,70,0,04032,2
64ae4da6e5ec8396ba1e0c160594b63f,96,63,4,168,84,12,01013,3
d9b9f80358633fbf6b335128d96d5f82,25,24,2,87.5,25,0,11040,1
c6e85b8d7814af448eefaa0339c6202a,43,43,1,301,43,0,05100,1
f689a325dd887a7e94fa33500881f3c0,70,60,3,163.33333333333334,46,24,05100,2
2a2c085b8a9eba2acfd47e1f7efd2675,62,41,2,217,55,7,05030,1
cfc234000d8451ae48eafcc877573eae,71,54,1,497,0,71,11140,2
8d0ee841ad6f661539d78977ef94b239,32,32,1,224,32,0,03050,1
c9ceb2c53d87a0db8de0d6b3bec010d5,52,37,2,182,52,0,10153,1
1fd4176b0748903569bb018a1a8a99a9,17,17,1,119,17,0,04032,1
909d362e13cf998d6bd9de103fac7b98,115,76,3,268.33333333333337,115,0,05040,3
7ef796e9fa1563beb6be79321dcef34f,36,36,1,252,0,36,05040,1
f31d5312f229af6f573109e7d52beb6b,24,24,1,168,24,0,01013,1
0a4612c780206423c8129efea8efd405,39,39,1,273,39,0,01027,1
31ffc5e84cadb0e5a8ea6945c46a03c0,98,71,2,343,52,46,05040,3
7408274156757543739d83e1844c834b,135,63,3,315,135,0,11080,3
a8f9ef912b167c125f4626a6bd7a149b,22,22,1,154,22,0,01012,1
594544fdb653a0ee5f978b7886504cdb,34,34,1,238,34,0,01012,1
aee3d3ce5ca768b141cdf486272c2be4,262,149,3,611.3333333333334,123,139,01026,4
d35020b5de1c6c10e037f0ea988bdd44,148,94,3,345.33333333333337,148,0,10200,3
ae0b78274ff51d36e13e0e961c62eb59,25,24,2,87.5,25,0,03050,1
5d8ae718846efc94f01532d814be3db9,76,56,2,266,76,0,05040,2
2cdccb26ff8f33cdf67420d0a86b3316,259,139,6,302.1666666666667,231,28,04060,4
2bbed04df38ffdf2c6b9a13c711d85b9,49,42,2,171.5,49,0,05040,1
1b16f9084764148efbbb617806bb89b4,2,2,1,14,2,0,08090,1
1bf960e60f097521d06def73b568bf47,17,17,1,119,17,0,01085,1
c2efa7898c542d6adbd16b083d464e22,132,101,1,924,0,132,01012,3
9476c6f6eefcc52c6c83d3e782a35038,159,95,4,278.25,75,84,04020,3
e983a1b29218a6b3db736213a710a638,19,19,1,133,19,0,10200,1
8f1c5f30091040a439a554a3d289dc48,143,84,4,250.25,107,36,05040,3
5f548b17f49e1e6449e6f17c953924d6,104,63,4,182,74,30,01026,3
48272baa9652ce2371dc291902711479,92,67,4,161,92,0,08314,3
c76c5d0ccd42160ca822dd12ef0992be,19,19,2,66.5,9,10,05200,1
9cf852c79934e3c2ba4f4328e734fed5,249,83,3,581,249,0,01012,4
756da13d813cf64166fb21ff36ad1bb1,67,41,2,234.5,67,0,09110,1
3ea00a9629b9859bd19923ce0bd8813f,66,66,1,462,66,0,09090,2
2cdc20586e3ae9bc04297d5d3de873bf,20,15,2,70,11,9,02690,1
5b5a37c1a152845544ef17874118d62e,8,7,3,18.666666666666668,8,0,11080,1
54f48850a8e27f98232054ae9ec14659,36,32,1,252,36,0,10153,1
88b96ce320731271789ce4f19ded5a65,104,90,3,242.66666666666669,104,0,09030,3
4d8c9de2b193a9e8a3693dade9d7c847,42,42,1,294,42,0,05040,1
d51e14add3279baa96b2b341b68aab43,609,155,3,1421,516,93,10240,4
44d442ec723f6c8a0c6f7f06b9fdf7b6,12,12,1,84,12,0,09090,1
43b8f1b718bec680dd5fc756e8cef507,22,19,2,77,22,0,08010,1
41df08412aa3aafca42086500850463e,122,85,1,854,122,0,05040,3
bf8e6c6238dbe4854d40145bdc9b1729,47,39,2,164.5,29,18,01085,1
23d510c8e869476e002c15bdc76a4a01,68,47,2,238,35,33,10200,2
41f9eec92bec9aaa296763f05a5af9f7,451,170,3,1052.3333333333335,409,42,01026,4
c695690ea006b4efb10dea94ac62fd9d,64,64,1,448,0,64,10028,2
e0ef587fa4f238ac2c0462f0014a6014,97,78,2,339.5,97,0,05040,3
23e093110b4afd6c58b08368537caa77,10,8,1,70,10,0,12691,1
78d0b055e646872d6b719d0944c2d278,44,28,2,154,44,0,12470,1
0af57f2d8236d6d0d72c74838cd64f25,47,47,1,329,47,0,05100,1
8971f1f954d3c3a84a7d326ed9e95199,42,42,1,294,42,0,01026,1
85c7c125df45fa06b0df8a1e315ebb39,49,49,1,343,49,0,02651,1
0f1a69baff9a5f7dab7470ee61a4c621,6,6,1,42,6,0,01201,1
1f553c90c91ac226cae79e861d23087d,9,9,1,63,9,0,11100,1
db75f8b69e2a9eb9d578d5cfc14e106c,55,47,1,385,55,0,04020,1
31e31fc5a91aab0b48a21672be85e44c,53,53,1,371,53,0,01026,1
e9ec5c8d379078dd7a6c83777f9c43e4,122,86,2,427,122,0,05100,3
36134f8cd97f9ae3a8e69286362a7e7c,267,140,2,934.5,106,161,04020,4
6781e05c6aa2d554d970aa73add71390,44,44,1,308,0,44,05040,1
29afcf97d982c7269cf71f9c324b7e27,73,57,1,511,73,0,01026,2
f852b25d86fd77e29d1d5bc65418c3be,30,30,1,210,30,0,01013,1
c2badcd8289d47666e52cb90cc75c896,50,50,1,350,50,0,01013,1
c1690f7c9f146541155b6f7b401ef24d,116,75,2,406,76,40,01026,3
51b6ea8cfc42eb4983eeebe3997238ee,45,45,1,315,45,0,05100,1
5376fce48396cf58b0d796396ff64b09,23,23,1,161,23,0,05040,1
623ac111476b6860b27aea18c461d8aa,12,12,1,84,12,0,05041,1
2cede0841e50d1056a419ad59460b6b7,285,127,4,498.75,206,79,01026,4
418a2380d4e70574b19b4a993f5dfcdd,111,77,1,777,0,111,09090,3
493f2aea0433ce37146042a8f61f40a9,24,24,1,168,24,0,08312,1
f58dabb26cfa9426317e359c0b7ff6e6,166,128,2,581,166,0,05040,3
adfdeefb2011c16a86e24de3b2adc2fa,246,136,3,574,246,0,05040,4
433c42a1f9f5475f94884ab2ce448dc4,45,29,4,78.75,45,0,11100,1
434fb768b3e5b853d38efa1ffafff628,33,33,1,231,0,33,08052,1
4270800731a2751d0fe4db5cd06b2efc,45,35,2,157.5,45,0,05040,1
5dbeb679d59435f5e7c91eb5c58e6587,25,25,1,175,25,0,03033,1
8ebe9b26303ee8f8d506381491526680,29,29,1,203,29,0,05100,1
4a72a5a226613c7e8c8a0a1d56af548d,25,22,2,87.5,25,0,05040,1
8e8d92f0143dcebf37c09a6ad983e09c,42,36,4,73.5,42,0,08230,2
8f680f9f2c15f9f2b455817b376fac4b,260,119,4,455,208,52,01026,4
5d44e40e853f7fd96324f33ef46c1d6e,54,54,1,378,54,0,01012,1
2e1c663a0247e249398936c1046eac36,48,27,1,336,48,0,12470,1
053d779d6853a7fc0b094fc7a5324378,101,92,2,353.5,38,63,08051,3
88ff265c3bb349dab605a2a889b43a89,29,29,1,203,29,0,13830,1
c762f7ed891f9d9595b9ec1e0eea7521,22,22,1,154,0,22,08150,1
cc6251c6e668ca67bb56f197e85fb680,28,28,1,196,28,0,01012,1
31731a89fe01d04e81f3e02b903f0fd2,180,90,3,420,180,0,01012,3
038b7d69d7049941434535d06340e24b,81,72,1,567,0,81,08230,3
ddb9395cbdd6cecb20fcfdc35f587c41,975,176,4,1706.25,975,0,05040,4
bf851828688efb14b219a09fdbf2e036,4,4,1,28,4,0,11080,1
e1cec67e6bb62a3ab0d145bbcc5b6d70,97,64,3,226.33333333333334,97,0,05040,3
38b6cc6a74189d62d092ec7d69d11389,118,66,1,826,118,0,01026,3
8bc8a06dfacfbc226b707fc7c8b85ac8,68,54,2,238,68,0,05040,2
6f354d3f4dfc584a9ab22f45ad165237,119,80,2,416.5,119,0,09030,3
135a10a3c3b3c43d5053e932f829a79d,106,78,2,371,1,105,01026,3
0334409d92e00b4c2a2afd6df4d05d53,8,8,1,56,8,0,02690,1
7f151d972d075dea5db03eff03018f2a,43,38,2,150.5,26,17,05040,1
f19259ab11bf04e0eaeba98655cd2ef2,36,35,2,126,36,0,05040,1
07de1c0958af8d59ab175251ea70dbed,361,171,4,631.75,80,281,05040,4
554d248d73ecef6ba7991996dd8a0ea0,53,44,2,185.5,53,0,05030,1
180569d7f67a70a1c490933496261a10,69,69,1,483,69,0,01026,2
748ea8a4182fbf9f571c194cfb4fddc7,57,41,3,133,34,23,05030,2
ece90ac70c80fc26cf17776e737633bb,13,13,1,91,13,0,03090,1
44abe590fa8b77ab04470a91b9d45f7c,39,39,1,273,39,0,12590,1
dd9aa0d416cb4fa22861bb8421cc0ea0,66,61,2,231,66,0,12500,2
6896fe6f4f127748eb27c9424c73ef71,311,191,4,544.25,229,82,06100,4
2609c2ec1905aa50215f5389eb56a9f8,33,24,2,115.5,33,0,05030,1
5dd7364811add95ccf045d70c320a902,112,57,4,196,101,11,11040,3
dabb54b764a26342c538dda6312e0c25,21,21,1,147,21,0,04020,1
d7dfe659f087958f297d4202cb703737,65,55,1,455,65,0,05030,2
13c15abb2567e13abae70049c08d5efd,489,164,4,855.75,101,388,04020,4
d734e5e11244b367abcb4ae49f2bb22c,289,146,2,1011.5,188,101,01026,4
0ece13fe207601ae8fbea90499f41095,39,35,2,136.5,18,21,01026,1
fc2e0de4156ff238dd9bd1262c51491d,41,36,3,95.66666666666667,41,0,09130,1
e37185855a400339a7cdb936c139f631,145,93,3,338.33333333333337,145,0,05030,3
6d36a0898c14731739a29af1d5317ffc,177,89,3,413,177,0,08031,3
faa1236d415209ff36b6ee565fc27923,17,17,1,119,17,0,01013,1
80d6f36d722bd16ea38f09b3a745fbfd,96,78,2,336,96,0,04020,3
321d81e548a6aad01af7c9f92e8cf437,51,48,1,357,0,51,05040,1
d2f795f2b03ae1008d531bfbbf5bece1,19,19,1,133,19,0,01085,1
74f2eea6ae6d444fb24fac4f151ff3d5,49,29,2,171.5,49,0,04060,1
5b73fec46afdd623892cd9ab44d65cf9,13,13,1,91,13,0,02650,1
1638260e70afc1d8165fb5a9a7cfcda2,43,35,3,100.33333333333334,15,28,01201,1
afb105065f4c210e1be22112e194319c,37,34,1,259,37,0,03070,1
9027bbd1d3dd1db08dce73cffd8e1932,53,41,2,185.5,53,0,01026,1
57878f261f505dd1015071b54cb38c02,44,44,1,308,44,0,05040,1
cdf34b4f1829e32f4365eb3f20cd575b,76,61,3,177.33333333333334,76,0,05040,2
111f91a63dcdeea3c16deeec2976e602,19,19,1,133,19,0,05030,1
f20ca257cf18b5f550c3fa46e7211787,54,48,2,189,54,0,02690,1
6b47358fa6e912a44393a049ac8495a1,11,11,1,77,11,0,11140,1
4c15fcd9912d48024dac83e7b63ff172,24,24,1,168,0,24,05030,1
ba8518727cfecb7792a93b58d76bf7d6,59,59,1,413,59,0,04060,2
57edcbbf23c421e891d7ab004148bfed,34,34,1,238,34,0,10028,1
4050dd62f8b8c71395653f94641064ea,6,6,1,42,6,0,04080,1
eaada7f7c2703d510509e4e39691065b,12,12,1,84,0,12,01013,1
274f149512e75555767ae4850a7990f2,25,25,1,175,25,0,04080,1
b7fc4811b5efdaf6e40990106fc3e2ae,63,55,2,220.5,32,31,05040,2
3cad872ab4112fce671312d1eb06f18b,15,15,1,105,15,0,08230,1
7ed00ce155307dcd3c4136252ca46b4c,53,53,1,371,53,0,12500,1
8e5dbb70fea03b23d4061b05d24837f7,48,37,2,168,24,24,05040,1
d0424da23e74e324f8c49b16816b2c4a,39,39,1,273,39,0,08010,1
bb1e1e8a70308d36ea70fd1c20aa5925,14,14,1,98,14,0,01026,1
6eb5c9d5ddce2504ecacf081b08fab74,81,35,3,189,81,0,01027,2
b892b949ac7dddd6b7e2781bcb9eed4b,10,10,1,70,0,10,09010,1
7cefa3c7c749e0e34c4125a9f6cdd068,396,175,3,924,396,0,08052,4
50638687ef07953456dd48d4e6491a9d,22,17,2,77,22,0,02650,1
2299bdac9ae0b1c40917eda6f55cbfea,81,61,1,567,81,0,01013,2
0bc6754c9f705e2755fd925f75e29257,2,2,1,14,2,0,09170,1
05389f275544c9e35265b9a1c67904ae,26,26,1,182,26,0,09130,1
ef83a870665ed145e36ab204b1a43d57,33,33,1,231,33,0,09130,1
f2140589cd030b65f7a8b17ee826cbf4,103,90,3,240.33333333333334,103,0,05030,3
7d878a72ccb9c389cf66ee51c8725284,52,52,1,364,52,0,01026,1
2bdce5d7952fb881bc07c3cda075be67,139,92,2,486.5,139,0,05040,3
80e6cf2d6f214ca0f764aa8ae6b7435e,87,53,2,304.5,66,21,10200,2
d2d93125f4afe19b69708cf1377e86fe,355,129,4,621.25,355,0,05040,4
2578520cc9449b4da1d2bbc606b3e13c,33,33,1,231,0,33,01085,1
1e41ce84b1b9ed42099d2cf20b20deae,22,22,1,154,22,0,09010,1
ae38a3a36b0c64b0ba313455cd1cd559,9,3,2,31.5,9,0,05030,1
8891cb5e675e400f5d88dde4bd4e1d82,10,4,3,23.333333333333336,10,0,05030,1
4df155c47f03614097927d77b111719f,87,67,1,609,87,0,01027,3
7ca90db2c3bc15b4272793d3129663de,26,26,1,182,26,0,09130,1
4558b4df1542d0895cbd0ecb6018efaf,34,34,1,238,34,0,02691,1
0a80003ac6a2351152926935df8e5c17,61,32,2,213.5,25,36,08052,1
61908add1a3ac2dcaaedc578e3ee38e2,24,24,1,168,24,0,05040,1
ef37af3f638e5062147d0ee0b4598441,69,54,3,161,36,33,01085,2
2f47ce5bb64a892cb502129f41217108,30,17,2,105,30,0,07131,1
9b04424c35eaf0e76c4407c8c179dd95,28,28,1,196,28,0,04020,1
041eab0a24583b9c03687c530bb2cc02,43,43,1,301,43,0,05040,1
0c7c3f294e31ab0edd66d71946e2a11d,64,43,2,224,19,45,11140,2
15bcb156bdcfd961a93e4549ffaa92bf,124,110,2,434,124,0,05040,3
838e470b9d4e5c48e043f8f0deb9c74a,110,75,2,385,110,0,05040,3
1f95bc879b6b341b18cb445bb462e5f3,150,83,3,350,98,52,08010,3
438214ec7682ae4592a9a65a153a9668,20,20,1,140,0,20,12500,1
05c1c8934457380060d6ae68532bd815,42,39,2,147,42,0,04201,1
3f6c2cf487d5a1ae630bd19b6a913e1e,39,39,1,273,0,39,01026,1
980d496c7ba9b32ab16e3229fa9c0cfe,25,25,1,175,25,0,01027,1
fff884357609da6ca15b373660f2f1f6,112,75,2,392,112,0,01201,3
1cf6487900906b9c7241c6d48a59e014,7,7,1,49,7,0,02650,1
144de19837dd69b0f31ddcea8a3933aa,156,95,5,218.4,132,24,01201,3
71172c2c35a08b43c79a34798c1ed0c0,42,42,1,294,42,0,01026,1
9e59bedba464f91621e92901093e69e7,151,88,4,264.25,109,42,03050,3
844e27074df0ea7d0202759699387ce9,36,36,1,252,36,0,01012,1
90f749b18d7d4a553fe8f7c9f83dba04,21,21,1,147,21,0,01012,1
d42da9047c1d4e4ff812562d01cedfa5,69,48,2,241.5,43,26,01012,2
a95b126984cfbcb42e165735ade92c1d,53,53,1,371,53,0,09130,1
90f3843924da315187a46be0cefecb2a,13,13,1,91,13,0,08032,1
3543139401d4b7f555bd44c15b75fe32,118,69,3,275.33333333333337,118,0,08032,3
1e4e1979dda8d60e934e86558bf6ad7f,115,72,1,805,0,115,05030,3
b6cc0869d9c00d4f723940b08c9677e8,72,63,2,252,72,0,01026,2
e773ba1af7f673e667bbd56cbead46da,16,16,1,112,16,0,02750,1
2c389df13f348802f34601c1b3c1650b,74,34,3,172.66666666666669,50,24,09110,2
90c394c9f9ae5d23fb79c556f415e2a6,25,25,1,175,0,25,08032,1
52d0067da5b2d80bd5052388a819ef4e,24,18,2,84,24,0,10140,1
21bd90d9719850a646d849c5b3507136,6,6,1,42,6,0,11140,1
80e4fa2d8ed0c574fdf2b7c40c972476,1,1,1,7,1,0,11181,1
3bf9bf375ca6f95322b43579b7430249,22,18,1,154,22,0,10101,1
c28235044f84a1c85c43feeceb02ac77,144,68,3,336,100,44,05030,3
da1f6b1d5e2634267b96aeed0150ca87,7,7,1,49,7,0,09022,1
2a17086bbb62070cbfd6a642bb9d77db,133,89,3,310.33333333333337,133,0,05030,3
a5b7020baa87e8517c5e808f35efaa7a,51,24,3,119,51,0,12590,1
5c4981387792e00bad3b8d5284b7bb29,73,54,2,255.5,73,0,08051,2
9591e1f096bb55f4be42b15204f07e96,235,110,4,411.25,235,0,01027,4
99941ead0d62dacd280bd3d727e371a1,65,43,2,227.5,65,0,12500,1
5cfedb7abd99a3af81759425331fe240,60,52,1,420,60,0,05030,2
ec1d654fff2f4df80197c651eb0c969a,37,36,2,129.5,37,0,08100,1
161d5f7d8454638a8b66d1e335be58e3,48,48,1,336,48,0,12500,1
bde36e0ca0b3b241891288479c5e0ce2,128,81,4,224,89,39,05040,3
2c4af36df20974187358e8b184145f41,78,59,2,273,78,0,02690,2
1d84086c57a2e038907b83fc4492ad47,143,59,1,1001,0,143,03033,3
8e59f9acdcef1c38f371c2a5dc259746,60,60,1,420,60,0,05100,2
f84ab687d642d2b2da20b9f27673d64b,22,22,1,154,22,0,01013,1
973a7cd425f4664258f4e682a85acd9c,162,64,2,567,162,0,01012,3
4e7a9cf03c2df3b8d70f45e06a46c5d4,33,26,2,115.5,16,17,10200,1
ede50a6de7c2fae0c351b16b6576eca1,48,48,1,336,48,0,01026,1
337079d560d00c4c8071cbe5e25c7f7b,41,39,2,143.5,22,19,05040,1
dd9572f3f8847f23c6170b3faeeccdd7,113,84,2,395.5,85,28,01012,3
22d8053345f5e5b6fa2762450f413e93,27,17,3,63,27,0,04020,1
6a0f30970cb92fd0e9e410a55b11aba9,45,45,1,315,45,0,01012,1
4ce80fc5b2988671b408f5f2af850219,251,146,3,585.6666666666667,251,0,08100,4
7670c1b2f79a54ad972e90acc3999a99,171,100,2,598.5,171,0,04020,3
dea95e929382309982e27e50f988be24,54,45,2,189,54,0,05030,1
e2a11a740ef3141c31dc84ff4048f275,108,89,2,378,108,0,05030,3
248454e46888dcc6bde5a2e2503bf679,200,98,2,700,200,0,01027,4
6cdd781ceae86b5f1415cc1699e85127,297,135,5,415.8,297,0,02691,4
922177fb5dbcfc954a61edfadaa5161b,77,58,1,539,77,0,05041,2
3104cfbdc28ca254eb9d92f06e5c09e1,50,50,1,350,50,0,01027,1
162b7347bff90f7407535f1930938b15,53,51,2,185.5,32,21,05100,1
65d695013bfd0c596e25bb49c4a51724,22,22,1,154,22,0,09130,1
57e3a01d96786f58d3143f9d941b9997,108,88,2,378,108,0,01013,3
bac8192fc3b0928155aa59f58a407d08,294,168,3,686,161,133,05040,4
0087cac244a1ce322096a477364f390d,106,82,4,185.5,106,0,05030,3
cc524faa8d0e25f226cb70aa5d303448,20,20,1,140,20,0,01012,1
b07af7ed7900dfdfcfeb40c107512e34,109,68,4,190.75,109,0,04080,3
edd62313cb2ac1c43112065905511978,40,38,1,280,40,0,12410,1
016523e7292d8ea780644499ac6b6a2d,78,48,5,109.2,59,19,01085,3
ab306d34030eb740f60e21f289dfd885,154,73,3,359.33333333333337,154,0,10200,3
17b22dde8acea0a4327aa4b61e36416c,24,24,1,168,24,0,01012,1
c4752256b48add912766dc5807599c42,61,61,1,427,61,0,04060,2
dfb84d561e5a0b9dc863c71f50f82c16,310,121,5,434,187,123,05040,4
360bd23520b38cd4d70fee0f0705b136,20,20,1,140,20,0,05040,1
8b40f5ab805b5cf127616ec2554350a0,195,114,3,455,195,0,08150,4
a7cc67500fb6f9c8b5399e68521d38e8,13,11,2,45.5,13,0,11040,1
faef0d51a5eafc7b71d7287c27a1f6be,75,65,3,175,75,0,05040,2
7566929d42e836694dd4e3c6ae823517,22,22,1,154,22,0,09030,1
375ff533821cf7e475da32985acd39b2,45,45,1,315,45,0,09150,1
ec92b39dd2edf6cd6a61bff515e6ad04,33,33,1,231,33,0,10200,1
cd15a1678f16b6bd9b329b962ddec4bd,45,45,1,315,45,0,04020,1
e7dc9be6dd4f5df89c0d1e4f188749d1,169,127,3,394.33333333333337,169,0,04020,3
d39d11f5240822dc70400c23ccee0cd2,332,112,5,464.8,162,170,05040,4
ffea03079d0def9995d5e7111c1fc60f,122,66,2,427,122,0,08090,3
4412cd88295852633e75bb2d611e6362,189,113,3,441,189,0,10220,4
d8c774a0ff2e6ba0fce6282fed5c4f14,45,34,2,157.5,45,0,05040,1
288bd00acecb31c73d265158b846659d,35,35,1,245,35,0,02620,1
8a9177a6b978e710bab12acf8c47240f,127,87,3,296.33333333333337,86,41,08090,3
61873c1efacbf0ddc000318371fc7927,111,95,3,259,111,0,05040,3
0a8a9cb9428a7a3ce846d4201fca4d21,74,58,2,259,74,0,09130,2
00d2e4b996a53e737a314c644dffb596,79,60,2,276.5,79,0,05040,2
a58585959a9d5a80a4c59766a92d13f9,33,30,2,115.5,11,22,05040,1
43e80c61bea67f29f448c41605d17dad,173,106,2,605.5,173,0,01026,3
98fd7778824f666b1ceda50e2fc64760,11,8,3,25.666666666666668,7,4,05030,1
ec6cba924b352dc8c371b91b3332d350,32,32,1,224,0,32,04020,1
67bcdc418348b46d3200a675a307a56b,23,23,1,161,23,0,05040,1
8dbaac7341d366e2c3b349fd6bccfcbb,102,76,2,357,102,0,05040,3
09ce6f28bfeefffc67c34af3c8f915a6,51,38,3,119,34,17,11080,1
26b555f667fbc4ca29cc44004a276e6f,37,37,1,259,37,0,04060,1
daa7e69c3c280ab2662a09f39139653f,201,97,4,351.75,201,0,05040,4
3f8c9a58f3c51599d41c6be4d08bbd20,20,20,1,140,20,0,01012,1
d0ad8b5ce02ac998ead633b8d8086371,93,68,3,217,64,29,04201,3
1c7eacf133eab006515c0c1420260a0a,58,48,2,203,58,0,01012,1
3bba851982450bd720a1cbf9d8d507d2,35,33,2,122.5,19,16,11040,1
d7d13f2dc2c7826bf0d414deadd82356,19,19,1,133,19,0,14301,1
9304bc55204df033554d5948f97f40b8,45,40,2,157.5,45,0,01026,1
7706974f25382179da14fed94ba8b753,88,58,2,308,38,50,05030,3
4f82db26b0dc11421b4903c3e4b275d1,19,19,1,133,19,0,10153,1
04937996f36659f7327ed69987384056,30,30,1,210,0,30,09130,1
c3b214d0f525981fb8d943ca0d6f6391,174,79,2,609,174,0,05040,3
0747897bffbcc6497b53d8f69cda36ff,73,62,2,255.5,73,0,04020,2
634b1677c1226d9c68ac70ed7d4298f0,29,29,1,203,29,0,09110,1
9ef2c715c31dc02f430847aa0ee611da,128,62,3,298.6666666666667,128,0,01012,3
ca3bcc476306eccaf195fa4ea428efa3,15,15,1,105,15,0,11040,1
39c95b090ec17bdefeb2ddeceec60033,158,79,4,276.5,34,124,01012,3
69378b17dfaace741b36aaa13b0ff0da,132,95,4,231,132,0,05041,3
2e3304b9b6a08a1e6f27f2d74901b945,15,15,1,105,15,0,08051,1
694d196f794553542c9fe4dfbcbcd324,8,8,1,56,8,0,05040,1
7c555029fc46479342d1b5b3c3c12cdb,78,59,2,273,44,34,04031,2
b7852f1b48ffbe0f6bb205bbc8ad7250,181,143,2,633.5,181,0,05040,4
beb7b117759f8ff5ed71b56595bdcfe5,16,16,1,112,16,0,05030,1
696359992ece2c55674875126e5944c4,443,132,5,620.1999999999999,443,0,05040,4
42ab402b29f33cbae6b610fd81e449e9,31,31,1,217,31,0,05100,1
8141861247501dfd4d4c2ea43e4de7b7,405,170,6,472.5,354,51,04020,4
48cbb39f6b4b4024b9ff6a2f5ee144dd,71,43,3,165.66666666666669,44,27,01026,2
7772082a819c96cc2d7e68668ed134f1,61,58,1,427,61,0,01012,2
0951308033ca59c9710fd6cd8bdf1491,48,48,1,336,48,0,05040,1
7b7671a8a06f590c25ab77c493492ad2,48,38,1,336,48,0,01027,1
0eb81dfa16732fd4843d1ce388135b4a,125,69,1,875,0,125,08010,3
054a7bb91b7487b8ec743bf95b8add41,36,36,1,252,36,0,09130,1
2e40729516b16c0fa44206cfe64a4ff9,175,109,3,408.33333333333337,175,0,08051,3
84ef87812883298b914954cfa86769af,164,102,4,287,164,0,05040,3
6a8b71676e44c0c949b726143bb0259f,22,22,1,154,0,22,09030,1
758b9ff673dd59d5231e501c9b1b683f,23,17,1,161,23,0,11040,1
f52f5f71fedbc63bf0fc00e49d677d3a,13,13,1,91,13,0,12410,1
92522ed9aef1125aeb26516ba6117dd3,15,15,1,105,15,0,01201,1
62ce932ab4e8ff99634e00be2a0f2eed,88,80,2,308,88,0,05040,3
db24ed71ff5683d4bdeaead4c3bba960,65,65,1,455,65,0,09030,2
8041d0be38a684ff08c6784d850159c7,46,46,1,322,46,0,03050,1
80c38513a8b969a8d1d4d839cb2cade3,31,31,1,217,31,0,10240,1
d5594a1a0d5cd31dc42c356a2f74aa3c,365,129,5,511,365,0,01026,4
63021cc0b2babaa7c8c00d6de6ec8d6b,7,7,1,49,7,0,01012,1
c002880f7ea9ba2943fef6cc76980b7b,27,27,1,189,27,0,01026,1
d97a54178d994659c5db90f095bd0fb3,344,108,3,802.6666666666667,309,35,01012,4
05690121fa531512868584a637aa734f,12,12,1,84,12,0,09111,1
02d2733509b3f7b9ef8eb6562d9cc77b,6,6,1,42,6,0,05030,1
35e81ea96d6a8d3bb22e78fb8938515c,311,113,4,544.25,282,29,01026,4
cfcf7a824240660f3f1d1f5f47cb0d99,318,173,4,556.5,318,0,10240,4
770fadf25aba69a93f63e8546f49d199,67,53,2,234.5,67,0,05100,2
2bd0772b2d02133554ee5d09cf38000b,271,129,3,632.3333333333334,271,0,01026,4
395722796ac5a22436f31c964b386bfc,22,22,1,154,0,22,01013,1
0f43ac054767ba060bf9a74ca6ef6d3a,204,120,4,357,146,58,01013,4
0a31c28899e2b6b9b38faab262c4b1b8,95,71,3,221.66666666666669,54,41,05040,3
c3f6c783a5be7e9104f2d03286b6b2a0,11,11,1,77,11,0,08131,1
90f9eb0d5a6e5bed83500814feebcc39,43,43,1,301,43,0,05040,1
29f4d660138e4ebb5b136233066a3e0e,44,44,1,308,44,0,03050,1
aa985cf01d45209d3f7069be493fe85c,16,16,1,112,16,0,05041,1
79dddac2b4339543084a147e029469a0,186,89,4,325.5,186,0,05040,3
43be2b70d561492ebc9c4de19adbf0af,37,31,2,129.5,37,0,05030,1
d71411389b01bfd75f5c561d871908ac,318,143,5,445.2,318,0,05040,4
d5c325fabf9dd34d5b8de00a2b848198,205,100,6,239.16666666666669,156,49,05040,4
fd83a2d751cb4a84d78f8fb4d3fdd2c0,95,75,2,332.5,95,0,05040,3
a20b195b7a660167f1d997b4516d3bac,317,127,4,554.75,260,57,01012,4
aa31e77f5f6064d3e93c65cfc8d66e41,219,117,5,306.59999999999997,219,0,05040,4
5b214a24d8b88e07feecdabc212d654f,94,79,2,329,94,0,08051,3
f8c48865c19a8f5433ead4cd61eaf402,202,75,5,282.8,182,20,11040,4
48c44d8ad39e747d7bb69d3d68f55862,7,7,1,49,0,7,09110,1
a80e607db40a5a6f091d2347abfff193,55,55,1,385,55,0,04130,1
119233643892f9845238ac18a1639e32,24,24,1,168,24,0,09010,1
759f91df5edd9c7529e259e6c9acc7f8,92,67,2,322,92,0,05100,3
5b20b97765ea34df57c91061ccab7d8c,66,51,2,231,66,0,04060,2
29aecfc411417e07c3d3ff7babfe44cc,47,38,2,164.5,47,0,07131,1
cf0f5d5f2fa7fefdeb3b12619fb09564,18,18,1,126,18,0,08313,1
c323ebc97c0eeecd3289b71ded76136b,128,105,1,896,128,0,04201,3
d35a56036e31d35b03bcff5e2410d95e,134,77,5,187.6,115,19,05040,3
ee3b0ecd78c394bb70b5b7b5e68936aa,132,100,2,462,88,44,01026,3
bed2730082424f0f1641c5570eb20575,238,97,3,555.3333333333334,238,0,05040,4
555c7692236aff37d76d088e1c3ad5a7,42,31,2,147,29,13,05040,1
df993ea32f9922b4dce82bbbe36cad06,22,22,1,154,0,22,05040,1
12923d6bd75a3213476efc15510b7831,148,81,1,1036,0,148,08230,3
844ef101857ae922e4500008c3739dc9,42,42,1,294,42,0,01016,1
f905e6fd9ecbc166ea46936a73896244,138,106,3,322,138,0,05100,3
e67cf2d265b1ca4561647d97cc7237fa,16,16,1,112,16,0,01014,1
a24e2347a20fb6bad6e5dacbce4c7bac,117,62,4,204.75,94,23,08052,3
cc40a96b66742a0090d41ee70a8d1026,25,25,1,175,0,25,09130,1
67d9d1704e072295458b963572dc7f21,138,95,3,322,138,0,04020,3
99d0d63c1defb222ccca285a3e4c50ca,69,69,1,483,69,0,01026,2
bd77f383c6e87eb07f152073ef7587b4,59,39,2,206.5,59,0,01027,1
92a8650831b389c0f0ef645d0565efd8,147,94,3,343,147,0,05040,3
32d77aa547bbc34e3acf48ae8133cdaf,69,47,3,161,34,35,13672,2
b605a49a9ab5bb608528f49fbcee8d92,71,60,1,497,71,0,05040,2
82d1f277aec25c3882ecfe3c45da78ab,131,83,4,229.25,96,35,05040,3
b05ca7372e3dfcddfb8082441cf8088e,55,23,2,192.5,55,0,01201,1
854e2eaf3eaf9ede347124e7240c955f,194,91,5,271.59999999999997,150,44,05030,4
79f3a9196bb5c11021572def38ca3629,107,70,4,187.25,91,16,04020,3
de18fd6a304a50afffa5e99945c23e8d,312,100,3,728,312,0,05040,4
bb7e8e5791d063d723dc05c87b2fef2f,53,37,3,123.66666666666667,34,19,05030,1
f6f0fadcafa264ba1a6760a87916d6b7,155,84,4,271.25,118,37,05100,3
7e56686264c4a6a94f758705a5d33257,66,51,2,231,66,0,01026,2
f0397e6b61bb77dd26702bd8ad0e9e1e,80,60,3,186.66666666666669,80,0,05040,2
8d423dbb11b506524b9acbb2797767a7,82,72,2,287,82,0,01026,3
a512698bbaed6706fec8ebe054eda111,19,19,1,133,19,0,04032,1
3b59d918ea445381a393340fd77bc6e0,83,59,4,145.25,54,29,05040,3
cc55b62f4ab76517340202f53f24848f,169,94,3,394.33333333333337,147,22,05040,3
dd71e26f6a3677494fc189dbe78d9bcf,22,22,1,154,22,0,01026,1
f8abab893a16ef79519b56e0d8c8cea4,35,35,1,245,35,0,05030,1
82d1d47024676a583dec617d9b00b9a1,52,45,2,182,52,0,05040,1
08dc679097872a1594358fdddc60befe,100,75,2,350,62,38,05030,3
141fc55a6394fd748066f096612b4044,95,59,4,166.25,95,0,06100,3
63de5ceece0b38d52f0338228d4dcef4,26,26,1,182,26,0,09090,1
3b594b231a7e7c62cccf0e134b44b0bd,62,44,1,434,62,0,09130,1
276c1d371df5338df5933e6d8b35ce60,65,56,3,151.66666666666669,65,0,04032,2
5288e00ecef3b5bf9f4abe79001b1104,39,39,1,273,39,0,05040,1
998f441172cf5919295bca51a5a6586d,11,11,1,77,11,0,11100,1
73e7b90e9bceac7145bfdd29ec140858,115,69,1,805,0,115,02750,3
fade28d59e45fb07d2151790d9e05d93,52,43,2,182,52,0,05040,1
037a2fb5d8122b410056a4da15e711ff,367,169,6,428.1666666666667,308,59,02650,4
a54b4fa82edb5e1cc9cb7c4e9fecf242,157,134,2,549.5,91,66,05100,3
9fc4d21f89b054c3308315efaa6c1106,37,37,1,259,37,0,01026,1
d1f507661c3fdad6e3b351cc4c9e046c,121,55,3,282.33333333333337,80,41,05040,3
8753e462d2e28a8f49f66bdce8b2a4cb,29,29,1,203,29,0,05040,1
4d3d81822faf8f612856d50c47ba4740,67,45,2,234.5,67,0,03070,2
a430ef0ca5116351ca42d01a7fd0cad4,72,52,1,504,72,0,05040,2
86b2e8775c4e8f6edf85b66209921785,170,104,3,396.6666666666667,117,53,11080,3
a8ade6ea49657b91c7c395a035a2407b,28,21,1,196,28,0,11080,1
04a92624d6811e9958f79a7f95385536,92,65,2,322,92,0,12670,3
2fe87c80cd381efd2d7f2235ef885e06,10,10,1,70,10,0,01013,1
6151d253728e374c3528606675c7786b,128,116,3,298.6666666666667,28,100,01026,3
0fd5a7807c22af17781ad458add5a9e8,185,122,2,647.5,64,121,05040,4
67f52c150a7845c82f9bbdd49a01ebd7,51,49,2,178.5,51,0,01201,1
b93e06dc3fd65ce2f26b48dfd45b8dd3,35,35,1,245,35,0,12570,1
765e03894af9eda1a36f2f2b7309f818,18,18,1,126,18,0,01016,1
3cba2bb7cbbbcc92f8b93c4904aa26db,27,27,1,189,27,0,05041,1
c4b3c5d53045de48884e0cbe010371c0,164,83,3,382.6666666666667,43,121,05040,3
5b6aadfcf18fdb6c7c14bd1ba058a165,1,1,1,7,1,0,13930,1
5eed86920e300d130cdaf721a35d96c2,153,82,4,267.75,153,0,04020,3
d7b53a845398a4cac6982a6f6d3af40c,84,53,2,294,84,0,01026,2
a88e5a0526b6d4b82004a62dd6f0260d,20,12,2,70,20,0,09190,1
2f21a5eb59c29b50dbc33eef3dfa09d6,9,6,3,21,9,0,11080,1
99a3efd7ea63b3b3fad065c7f3037a38,26,26,1,182,26,0,01026,1
f8ebe1775b330f8e4406d7205a38d7a8,5,5,1,35,5,0,08100,1
223b93dd6c6e31a8662b7905e94e91c5,142,88,2,497,115,27,04020,3
113f61a588c538ca27057e9dc7a81a08,117,70,5,163.79999999999998,97,20,08314,3
17cc2331d1b595f3602d6182f7a239f2,23,23,1,161,23,0,05030,1
ba647b4558653d1dff84d5ee7f9331d6,48,48,1,336,48,0,05100,1
2d821b6180599653477242a612057ce5,253,79,4,442.75,171,82,01026,4
8f023b46e02d8e79b695a5f41fdc5d25,57,57,1,399,57,0,12500,2
1da173923aad2245b82b66d8467a987f,20,20,1,140,20,0,08100,1
77624629792c0502c5bd3beab0173bf0,72,51,2,252,72,0,10200,2
88c026bc3df87502add98a3646a8efe2,250,86,2,875,250,0,01085,4
98da0673270381f085cf24a762a3edae,153,87,3,357,153,0,01012,3
fe6d1210660153fc9f94553763b5429c,73,58,2,255.5,73,0,01013,2
008b303d0d819fc99da25c39d42b5e04,31,31,1,217,31,0,03090,1
b14001f0fec9457cb0df0722371b5e57,136,100,3,317.33333333333337,51,85,09130,3
c0ed8a9ba19fa4ae849510421b9915a6,28,28,1,196,0,28,01026,1
3a986171336b7c7ebd3761b09947f94f,120,72,3,280,120,0,08052,3
4566ed2bd5ef4c06617345199f329da5,35,35,1,245,35,0,04060,1
3a1912b7ed8785171f4e796809afbabc,2,2,1,14,0,2,11080,1
f804303c052495dac2df20a4b79880a4,5,5,1,35,5,0,12501,1
5ad05f424e06167ef678506cb4a5b6e8,19,19,1,133,19,0,09010,1
09939ef86a8f906c35ef9fa05854bbd2,128,77,4,224,128,0,01026,3
9f3a73848e42d6dae1c8dbd85ca15e6d,26,26,1,182,26,0,05040,1
133269422ecb03946f8324996b306af1,25,25,1,175,25,0,08230,1
dca34e75bfeb5e54b4ce4984524fdfeb,31,31,1,217,31,0,09130,1
aab735b75817fbd6486e2f3ad98c7f97,45,35,2,157.5,45,0,01012,1
46b33fe8eeb4058b67c39aa82f57059e,1,1,1,7,1,0,05251,1
cc7c802ff0aa6028d78ae7b112e4cd69,174,98,1,1218,174,0,01012,4
8ce5874784cc4e4ff03b6300cabb441b,11,11,1,77,11,0,12501,1
54bc6281eac21eb8e74f0e5a94acefdc,75,69,3,175,75,0,01012,3
15cb7aa49f8b032613afe88f4b018fb5,21,21,1,147,21,0,01016,1
7e9e29140d82604be9cea80b31bebb3d,126,81,4,220.5,126,0,10200,3
d40539790d6741ff468f4405d666d9d0,744,290,4,1302,624,120,01026,4
6037635235c15072ab6cfb46fd3d00cb,24,17,1,168,24,0,11060,1
9ffb9718785da1301ff4d16e20917956,236,77,5,330.4,216,20,05040,4
c45421e31131e870dc9e050d0400747f,87,73,2,304.5,56,31,05030,3
acaf5844363de37faaa7a195e575c1c4,22,22,1,154,22,0,05030,1
e776e2ef0ab8d2c1fee79ac321bac711,59,54,2,206.5,59,0,01026,2
d67266a49365a0a73b8f2e23f29831bf,16,16,1,112,16,0,05040,1
2626e9e3726a7d208789d07b7156e61f,20,20,1,140,20,0,08010,1
8b8a0a2c2cd22ffb4e62743860603b63,11,11,1,77,11,0,08312,1
e03d45215237d31696a59215d20bbe44,5,5,1,35,5,0,13875,1
5cee4bd75a12a80607c49fadbdce391d,343,197,5,480.2,298,45,05040,4
9510d2f16b863be53cb3fe312ee43367,53,48,2,185.5,17,36,01085,1
e594fa9089ac3e5014d741bacfcee156,31,31,1,217,31,0,09091,1
ece9923fd84ca8e25229ff23a3221e68,20,20,1,140,20,0,05040,1
2bc8940ab4a5d2647f139126b52eff3a,42,37,2,147,42,0,01012,1
28915f694934747a3b06d0848cd28f2f,25,25,1,175,25,0,09090,1
6aadff57f1202a1012c048de79fe7e80,88,54,2,308,88,0,04201,2
f17aad79fbbdc0a7a7718a3762882e6b,43,36,2,150.5,43,0,01027,1
1e343a551bdb8ceaa2f6108e48b6a315,48,48,1,336,48,0,05040,1
c360a1cfbda016be1a1e0a78730caec9,18,18,1,126,18,0,12570,1
235c3f8e56a10c51b9d17badb6c52ce6,33,32,1,231,33,0,10080,1
b4075040d56e157892949edfafee3498,56,38,2,196,30,26,01027,1
d89d5660a58d9f5c1f009dcb5080c78b,101,39,3,235.66666666666669,101,0,09010,3
b32cf1518d939193bf97312a446edd10,60,39,2,210,60,0,10200,1
5bd41b355ea45fb5332200f297494dde,68,51,1,476,68,0,05040,2
dc895fae52837348a26f08fa0e8db1d0,6,6,1,42,6,0,11080,1
2b7916a2c421134b9ade41fb89b92841,105,66,2,367.5,105,0,01085,3
d96842b28ba0becfd832cd1ee7b34805,29,29,1,203,0,29,08010,1
790bb871756efab90512b323a928a5de,7,7,1,49,7,0,01026,1
6bc329870553e8c9a58d39d38bc97dc4,74,70,2,259,74,0,01085,2
fbee75da25f36de71508d050dd19ab39,92,67,3,214.66666666666669,68,24,04060,3
8f133bc50787145d387d946ec93fac61,18,18,1,126,18,0,09090,1
1fa678f65b26e91707640a3f484c1337,64,51,2,224,64,0,01012,2
9c9fd54a741047a1fb7f2b5ddc25dd1e,267,133,3,623,267,0,01026,4
b53881de711640cc1d04ab03ff714a67,23,23,1,161,23,0,02651,1
a30207cee0e6641a8371bb788c54242f,400,111,3,933.3333333333334,400,0,05040,4
78a9887b1aaec63cb4b2213cf147f24c,11,11,1,77,0,11,05041,1
978e38a31a0a7b8753774fcda0ae9ed7,35,35,1,245,35,0,05100,1
d8925f007ed9abf5f75c99184841761c,99,56,4,173.25,99,0,05041,3
a6bfe49b2974bef9d227f9947e7fab60,65,65,1,455,65,0,05040,2
f02305ede6ab7844f59b51227a04bfcf,36,36,1,252,36,0,01013,1
562deec4ea5172a926a380c716f5cffb,404,128,4,707,283,121,05100,4
4851103cb8286d8dc144859e13a97e04,33,24,2,115.5,33,0,05030,1
c5bc5196d09dbafe2f7e805c1a5d4b8a,11,7,2,38.5,11,0,05030,1
ff31f697c5fd66cf0024096893f371d8,34,17,3,79.33333333333334,20,14,05030,1
e3053d58969e7fcf854d3223ccecaba9,400,272,4,700,283,117,01085,4
de82a56fe5762ea7e0417d678c1b7cdc,57,52,1,399,0,57,01013,2
400b00a6063d89d2919b11546c7199ba,206,110,2,721,206,0,13930,4
72e69fa1ef3195745bf526603d8a1637,10,10,1,70,10,0,12410,1
9dfda808f4ca6bbc5fd9770863372931,17,17,1,119,17,0,05041,1
6fea64493ad2764d17162fde88026ac5,3,3,1,21,3,0,05030,1
5e3161ac96dc9d87f94d61d27cfcfc53,22,22,1,154,22,0,01027,1
01d8ad78d095adcb1867f4abe60f3c2a,34,34,1,238,0,34,10200,1
6d3deebb7d13ef4c5225f7f04156d9f2,198,111,3,462,198,0,05100,4
084f2b75c9e219b76fc89b9bd5033efa,22,22,1,154,22,0,09130,1
d1a7bdcc9f3c67c0b73041e1d29926b0,21,21,1,147,21,0,12500,1
9c296e1a6c102a90eb75778da1059d6f,95,72,2,332.5,49,46,01027,3
ce9b6fa8bfc5f0d7d6a7ce3dbd6d1be3,81,50,2,283.5,52,29,05030,2
e43a2851f4a9a35d72631fa505558f0e,59,43,1,413,59,0,01026,1
7a0aa89f82f9f975453c6aac2c8f9ad9,30,30,1,210,30,0,03090,1
e0b82424b0a9fb59eedec9018bbd5456,46,46,1,322,46,0,01012,1
745f0e96cb3642a6a3fce4c8a7e412f4,64,52,2,224,64,0,01012,2
27bf221ab798f91dee74cf3a2444b66a,42,42,1,294,42,0,09170,1
5d3847e5d5948529e98ce02eed309e69,55,39,3,128.33333333333334,31,24,11040,2
a2d88c761f29f2f76fbd83c00047ec9a,14,14,1,98,14,0,05040,1
521dd1087786d82c32598298284a4aad,183,103,2,640.5,47,136,05040,4
6accbc4ff4c8e94bad38389bc15382d1,30,30,1,210,30,0,04201,1
c17ba0b150fa4b8fce08fcb880d9ff03,26,26,1,182,26,0,09030,1
9d925f6a230f39f985db5fdb07450980,38,38,1,266,38,0,01013,1
93bf294827cd21109e91d95d9ec4ae54,75,48,3,175,61,14,11140,2
9fe440bd7c5bcf790dad2fe8c639b20f,99,70,2,346.5,99,0,01027,3
ee080a70ae2410cfbe88e4a064941d4a,28,28,1,196,28,0,05100,1
296fae99c6581b4ff59fc971f43d0e70,45,43,2,157.5,45,0,12590,1
ce9f8ef2b26d1c6a8fc5a658190d4965,62,53,2,217,62,0,05040,2
e3f782615ea075372ce27a3f02da7d7c,245,131,4,428.75,245,0,03050,4
fe970c1b30318bd65051463359ab9ed5,373,171,2,1305.5,339,34,05040,4
0d6c824a7248691f3ec9da41f629d881,169,103,4,295.75,169,0,05040,3
717512fc9033ca36254c838c75134200,34,34,1,238,34,0,01026,1
bcdb2e5d2c84f92cd7395e6a4f1ec202,36,36,1,252,36,0,07143,1
4e06890d3c9acbce0b8858d6a6cd14e8,31,31,1,217,31,0,03050,1
493a6223ab9893b78f517b9525dda685,65,60,1,455,65,0,05040,2
7da553de6ff2bf0b499c46d32b665ca5,173,70,4,302.75,154,19,01012,3
0362d29104a503d8295544f5b1ea4706,43,39,2,150.5,43,0,08230,1
f3d2df51fbc96b7a19b93f396ece0561,193,118,3,450.33333333333337,193,0,01012,4
872446cb2db22eaf70c2460a7f00b1f2,157,116,3,366.33333333333337,111,46,05040,3
d5aa4a0ef7a020310351f3e0e1c0038c,67,48,2,234.5,67,0,01012,2
5a84f527843b289b1730376875c579f5,13,13,1,91,13,0,09090,1
dceed96695b20431740a107bdcbab6e0,20,20,1,140,20,0,01085,1
7c8ead6bc03c9543ff372d13e084dd26,10,10,1,70,0,10,01012,1
55737429be83f03f50da12d708020974,66,50,2,231,66,0,01201,2
4673d6eb976cd6d3da5ebccc9f24e1f8,146,94,2,511,146,0,01012,3
6e9731f1d3a1b514e5c47756e123724f,14,14,1,98,14,0,11081,1
c98791c72de5feb8d18f8c7332b799e4,29,29,1,203,29,0,01026,1
e5fd6fde43dedb7785792ea158986320,22,22,1,154,22,0,01026,1
05cb262a6f26b66d1cf62687f3504095,20,15,2,70,11,9,03050,1
552f8097527a1de0972a4d8eaf9bf265,10,8,1,70,10,0,04020,1
a3bbf0122192d7e9b94dc65b3581be73,31,31,1,217,31,0,01026,1
6738dcbe75b8938f8a7f49f26abd4b01,34,34,1,238,0,34,05100,1
baca200ee35df1ba5da48a001dec5f92,77,66,3,179.66666666666669,21,56,01013,3
c5b5914cfe21aae34b3d2af35b20c431,21,21,1,147,21,0,09090,1
582a38baaec2f5ae8e1e46498e98fb92,455,125,3,1061.6666666666667,117,338,05040,4
87f80c667a14fdd145544d827cd064d7,86,61,3,200.66666666666669,86,0,05040,3
1e2f5b1957986a3be048599a17770bd7,28,28,1,196,0,28,05030,1
4fdf91424ee717fa79acb8b6748b3cb8,132,83,3,308,132,0,01026,3
5eeab726cd90272130ebf2bc1ebb3722,40,40,1,280,0,40,01026,1
bdf8116bd9dbfd7fa9568f446e5b07be,28,28,1,196,28,0,04201,1
a8da821646df444b4ef2f6ae724301f5,119,63,3,277.6666666666667,86,33,04020,3
16293c3b4486ccb6d9a386fbfdf81968,17,17,1,119,17,0,01026,1
85fca6f876b867b7a6e5674ce24685c2,22,11,3,51.333333333333336,13,9,08452,1
c2f2d2b1e20634c9d3a359aaa25b176c,86,73,2,301,86,0,01012,3
012a9b7a6616c6120a561c2470d82769,37,37,1,259,37,0,01013,1
d9ba16adc3043ba104ae96a0b48127f3,22,22,1,154,22,0,02650,1
69e954913f823e9ea8226c89981eb252,99,73,2,346.5,99,0,05040,3
ec90b0014c3a67a258d90db33b8a3ac2,402,162,6,469,215,187,05040,4
14d298ae62801cfc51e2a5efb1374d64,42,30,2,147,42,0,10200,1
88295a33aeeb86c61fe0cded864c1744,35,35,1,245,35,0,03070,1
ec06857491506b45b7adbacc523a55b2,26,26,1,182,26,0,01012,1
8c985ff580f928786e6b8a31dec0bca4,42,42,1,294,0,42,02690,1
cd7e9a2c3694c8c12553fbce1368edce,539,172,4,943.25,461,78,01012,4
92534a06f46af860f4683bcdd8471a63,76,48,4,133,57,19,05040,3
f3450dbdf1f1acaa5380a673fdc3d21d,12,11,4,21,9,3,03050,1
8f925359525c01aa8d68f40fd15d8ee6,43,32,1,301,43,0,05040,1
17d78f3aece99a91adeca1ce70653b8c,23,23,1,161,0,23,13490,1
5aca437a0a68aab1ca4efbeae9d8e2ae,92,37,3,214.66666666666669,92,0,05030,2
50476d4b7fcb1d1476a240fa14a9c4e0,445,193,6,519.1666666666667,406,39,01027,4
7f8552dcfe5b6a06cc7fd73e5118f57a,119,78,4,208.25,91,28,11040,3
10af9386ad50eb2cba7d15cba7f24c71,28,18,2,98,28,0,10200,1
00ec0d12b62291e884780604e4d5fbc0,80,80,1,560,80,0,10200,3
016d83958f16b96521f8cd4320a3eedc,172,91,4,301,172,0,01027,3
903a803c28e9438aac4051464937f135,61,61,1,427,61,0,09030,2
47fe557ddaa3f2aa99b11bd7de7a7cf0,87,60,2,304.5,87,0,01026,2
d84df0eb8b74c17e39c9176a7a78077e,332,125,4,581,273,59,05030,4
50f1884a1c39adce384d9ca4bb0757da,351,145,4,614.25,108,243,10200,4
272405bee50d4f000008153b87a2a38f,41,38,2,143.5,28,13,08312,1
a02651bf32275cc2368dc70ef96a4003,32,24,2,112,32,0,04200,1
e9775828b79230a994ed0c1f68b37b3e,56,53,3,130.66666666666669,56,0,05100,2
8d8b43de2b872bb4a5172089c6936a5a,9,9,1,63,9,0,09190,1
617433382aa8f2fbdcd33272fd866f0b,6,6,1,42,6,0,09010,1
1416b6f8aa7974c01bdd3479b81bba22,83,42,4,145.25,83,0,05030,3
8b23ad472b9ee434c5fe9b500aa22719,111,65,1,777,0,111,05040,3
8145864ff356471c053ed124ac40e6dc,158,87,6,184.33333333333334,102,56,01026,4
dabe2619f4a5b0896313d516c22bb202,50,40,2,175,28,22,05100,1
3ffcb73812da04fd698bd9b2953d4204,34,34,1,238,0,34,01012,1
59d0d528fe3e3baa0af24f7e78873a14,113,68,3,263.6666666666667,113,0,01026,3
cac03af8c0b663d283c1a151ed3da4cd,101,70,4,176.75,84,17,10200,3
07fb677c69416004ba5f92068f86741b,18,10,3,42,18,0,10200,1
917160d305242d1496fbfb64ce992a9f,22,11,2,77,22,0,05030,1
58a239d36f812ce4b7f86005ebbec3ea,125,91,2,437.5,125,0,01026,3
525f505104f04b499e648c90e3450919,183,105,5,256.2,145,38,01026,4
8f57c91b8cf70bc143234d78df43d570,57,36,3,133,57,0,05030,1
d34d88816146c289c4518a571e950082,343,146,4,600.25,292,51,11100,4
777060f1df730889fecbe88ee0878302,111,76,1,777,0,111,05100,3
a2156f362a79051988a35232a60412ac,30,30,1,210,30,0,03050,1
d31af1a916c4bf00443156532444c8f7,41,34,3,95.66666666666667,41,0,01027,1
b8a103b351670d136e1866c0827cbfd1,124,80,2,434,124,0,05100,3
02204680676e91e797650418e664b1d9,188,103,3,438.6666666666667,188,0,05100,3
af5bb1775b1fe870f5f265d985c1e270,75,67,2,262.5,75,0,05040,2
8bfff49a03a27f53c2545767e6442d68,8,8,1,56,8,0,05100,1
c29684975ebdab7a9e8a58d94f0c9855,137,103,3,319.6666666666667,137,0,01012,3
973eb7188e58613b3c45bedf07f209a1,47,34,2,164.5,47,0,09010,1
ca1c9ba5fd2a91cf876a0ef8745176a8,322,119,5,450.8,289,33,09130,4
e2f7db542dd02231c451f7c8cd4f17be,47,45,2,164.5,47,0,05040,1
71bfbeeef24569e2f63876e4815d5830,32,32,1,224,32,0,01026,1
4b717c72bd956ea7d805c738d116e02a,159,130,2,556.5,159,0,01012,3
e00e5291c1dbbbea0a0360f0c7340f97,37,34,2,129.5,37,0,09130,1
bb0a89d02fc8f5262d78bf8c552fd444,124,88,3,289.33333333333337,124,0,05040,3
a2e55fde741101140f2d100947944630,8,8,1,56,8,0,11040,1
01c16171c74e46cd242217963baf100f,428,177,2,1498,125,303,01026,4
4edb9f33cb929a7f09d68c6f8953ca73,263,163,3,613.6666666666667,202,61,10200,4
76d74ec10aa549bec26e406e8171934d,25,25,1,175,25,0,01026,1
7e4fddeaaacd194f8aeb538c7177ab36,205,122,5,287,172,33,10200,4
f941fe09ad7c5c17421f4fcfca029d24,9,9,1,63,0,9,05030,1
24e1de711b27e1ddfe309276506e3710,82,54,2,287,82,0,05030,2
c734d25ea5af4fe673f71bd5d5b6043e,21,21,1,147,21,0,08100,1
2a84e9fc75af2890587a1f483b5d0aa1,29,29,1,203,29,0,01026,1
dfe5d33494b0ce0dd5a0f5d2342d146d,9,9,1,63,9,0,11100,1
b241613c598fcdc791820795fe84d81b,36,36,1,252,36,0,03090,1
5a415f309a729a1e2bee8401b6073d63,31,31,1,217,31,0,09030,1
b566ab54a92f6b0c6ea1c1c36dfe4a38,16,16,1,112,0,16,09010,1
1f1552a2b5f6dce803747c9febd2269f,13,13,1,91,13,0,01014,1
65c0e9b8ae8a72cb5c5a65a121dbcdd8,63,44,2,220.5,35,28,01201,2
40cebd3779c7f6644dae817b883abad1,75,75,1,525,75,0,03090,3
e4c5b71be1b3983e59bc059b4e8527a7,29,29,1,203,29,0,01012,1
ec2a5cc3802e2a626a0a5f60d0fa3baf,309,107,3,721,261,48,05040,4
48b42d4ddb3a41c2d330610e7ba07187,13,13,1,91,13,0,08010,1
0a9a05cad9ce05e9c8164d8c231f92e6,17,17,1,119,17,0,08314,1
a4c73899a4ac0d93c79f265d3690fba8,46,44,2,161,46,0,03050,1
c1925d973518d1f1cdfe3859b4de20bc,98,46,3,228.66666666666669,67,31,09110,3
50f443616e3f4254a966e65f90532cf0,69,60,2,241.5,32,37,05040,2
c94ce179f69d854aabd21c9a1576e970,176,95,4,308,140,36,01027,3
83e10275f0fff6f764bba53b4bc96024,43,34,2,150.5,43,0,05040,1
9c77b54ce69351485ee4088787ed6501,88,73,3,205.33333333333334,88,0,13953,3
5a25e7aaa217294305b0fabe2ec36f5f,34,28,2,119,34,0,01026,1
9a7a472577d196c7d9a6dbebb165cd2b,54,40,3,126,54,0,11100,1
09ccdf48512724b0ac713fa87bf338b5,44,43,2,154,12,32,11100,1
f2e0653cb207baff53406a5063b4058d,35,35,1,245,35,0,10200,1
84b1c150f0e994886bf3d2e6f7e4485c,81,55,3,189,81,0,03033,2
95a2f00cd88e88c05444b091ed99f990,81,56,1,567,81,0,01026,2
736917a2b4b8e2c75f4af09594b7299e,83,61,3,193.66666666666669,63,20,01085,3
cb48b140a4ed4b523838c2f35eadec98,77,54,2,269.5,77,0,05040,2
308eea034b3bd02db71afdc337127ae1,109,77,3,254.33333333333334,109,0,01026,3
3b2e488778a6aec9b7b4adf3804a6936,116,116,1,812,116,0,10200,3
a6f599ccd0366243dd03ffc3989b8b42,80,75,2,280,80,0,06100,3
b5428b107ea27c948c4071f5546a5900,170,97,2,595,170,0,01026,3
1d1dd3dd9918075b37434eb934061033,14,14,1,98,14,0,10152,1
13a63bcb7aab639878b06ca4ddd89d5c,107,58,4,187.25,107,0,11040,3
7be4826f0df4b78dc9f05f8526faff7c,111,77,2,388.5,111,0,02650,3
c6140dbdbf3ab7adf2d87bca241146a3,26,26,1,182,26,0,08230,1
3923a704dc315222bb81a31ee9af2d27,47,28,3,109.66666666666667,47,0,05200,1
0b122a6871b4f40e6450ad593ba386fb,24,24,1,168,0,24,11140,1
3f9fe4265ea52dee2d494aeee462349c,51,43,2,178.5,51,0,05040,1
61d28536cf31a6e81d0d79b4da74f2d6,136,59,4,238,136,0,05041,3
d5a0b7dc14b7506ce2b50dc46465c53e,451,151,2,1578.5,300,151,05030,4
fb6ed65a29790f027c756b8caf71a6e5,123,88,3,287,123,0,01012,3
8845392290f7cf8d5fff927910bfa4f7,24,24,1,168,24,0,08100,1
1cdd9586ed5f91c5f7c41376ab09078b,67,44,2,234.5,67,0,10200,2
cb4b55a402c979870e7c94f196d92fac,102,70,2,357,102,0,03050,3
bf2281a3fdfae87382bb94440f28c042,71,60,2,248.5,71,0,11140,2
01446b52c1075ced44b5161236380480,83,60,1,581,0,83,03050,3
6bb80b255566564fd6ca6054d39ef6fb,44,35,2,154,44,0,04032,1
37e2453e440c2b6bccaf08d1e8f15187,11,10,2,38.5,11,0,05030,1
6b8937c195d550c27640558de83cfc52,66,52,2,231,66,0,01026,2
f0fe09f0dc5893b5f728d9fc5623165b,290,144,2,1015,215,75,05160,4
1626048b3bd2cac2042c11041188fafd,86,45,4,150.5,86,0,08314,3
09aa514b2b707af72cdf5cb576fee5e3,25,25,1,175,25,0,05030,1
ee326316df356bac877338c5feff0279,54,39,2,189,54,0,05030,1
977ceeab65d81a56166262fd9e99f7ea,68,55,2,238,36,32,01012,2
018a30985b136d2a4e1f30c095f2ec42,49,49,1,343,49,0,05030,1
865f5ff757b1f1c54de026187c492abc,26,26,1,182,0,26,03050,1
8c635b9d85b6cd88ef95578dfde8f626,46,27,1,322,0,46,11140,1
8efc5fce0872f73143ee716d28fa9d40,102,76,3,238,44,58,01013,3
f9f39c80f9a2ad48a6dd22538d42aa36,25,25,1,175,25,0,05040,1
3bd9db835489d8fcb74ab760d9100eb7,31,31,1,217,31,0,01012,1
fea1a5927c60cb53f5665a54003d69ae,103,88,2,360.5,103,0,04130,3
4b972d668822869638c4e8006ed6bc76,170,112,2,595,115,55,01013,3
f2d8ef0e18d2285434a7b82797cfcf29,151,110,3,352.33333333333337,111,40,01026,3
e681df1cf42df09de93adcdb526006bb,82,66,3,191.33333333333334,79,3,01026,3
70005e3dcc347b979011da7aa0841b39,26,26,1,182,26,0,01012,1
b728f124f564282ca02ef421142ac586,79,71,1,553,0,79,06120,3
eb56be2a97defd96d92a5c470697a8cf,154,97,4,269.5,154,0,05040,3
a5c0e86d01a90cdd6b50a367112648e5,21,21,1,147,21,0,03070,1
fec329a01fd17b22a88b68fb390c67ac,30,30,1,210,30,0,01013,1
b41dc8805e6707fe528d62d113f31672,84,61,2,294,34,50,12670,2
cee62a0ca56626674079796b8fa6905e,430,137,5,602,430,0,01026,4
60272d34273a532f5827b3f9da435675,260,142,3,606.6666666666667,216,44,05100,4
aa3ed160ab77fb6146c876ea6bca23a1,43,43,1,301,0,43,02620,1
3f124c1ad266e2380eca1b4d8c021a5e,20,20,1,140,0,20,05040,1
5e6a73fea54f9d55850bd03a338618dc,3,3,1,21,3,0,03070,1
1a7861e7b47f9b79a71ea550929b32a5,67,49,3,156.33333333333334,67,0,01013,2
2c39db007aa5d79e1df3d4e7401102f5,64,49,3,149.33333333333334,40,24,05030,2
01d7b2b9880d87cca390088adf7cc829,14,10,3,32.66666666666667,11,3,11040,1
2b55aeecc6e1502334bd3fb02383f643,852,266,5,1192.8,852,0,01026,4
d7a3087274982fe5c3078a7a2e7a5879,4,3,1,28,4,0,11040,1
08ad9040d18486fc404ce5cba3373713,185,103,4,323.75,185,0,08032,4
cd33143b17835d5c6e2f5e5b0ded6d48,24,24,1,168,24,0,02691,1
bde2a384dff61544bb09d8b467991975,85,66,3,198.33333333333334,59,26,05040,3
5b93169c70f1fdbf885a176a66af5b36,63,47,3,147,47,16,01012,2
b162a62c088afca49710501520c9087d,25,15,2,87.5,25,0,12670,1
b092e4af1d8f5fee11aa7862a0ceade3,10,10,1,70,10,0,11100,1
fa4d9ff2d01f09a4a05e7c364cd515c6,45,43,2,157.5,4,41,05040,1
7a9ca0cd08ab76a7f190d74251ed25b1,180,97,3,420,180,0,14301,3
6464acc57a85d230902df62a3d13c947,46,39,2,161,46,0,05030,1
6963472a517246c0f9493fcdbb479d06,13,13,1,91,13,0,03050,1
a984f8e670cb6ec154d7d414a2162024,206,124,2,721,206,0,05100,4
f4b1943ad745befb55c9cbc3da2f08b7,98,63,3,228.66666666666669,98,0,10200,3
eab591f3a5e835933de24f7901be19ae,65,50,1,455,65,0,05041,2
b4c19d42fbe825675bd485206beaa21e,106,58,3,247.33333333333334,106,0,04060,3
f3ac62d67f21e0661f506f1d7be7f2d3,38,28,1,266,38,0,05040,1
d5cafbe21843ee3eb307f37fea3d3f59,88,45,2,308,88,0,05040,2
3510d4b9d32a5628471524c67fdb8280,7,2,3,16.333333333333336,6,1,08315,1
54a35983ae2575794a5e45089fde8237,323,154,4,565.25,284,39,05040,4
250e77d07bd792193744190b6f84cd33,51,41,3,119,34,17,08032,1
f8a1359a1b5209d5bd1abae02ffae2fc,59,52,3,137.66666666666669,59,0,09130,2
37224f051887d884fb25574c535eb6e4,82,53,2,287,82,0,11100,2
dc598ca19ab73e2d2ff76ee0e3182de1,61,61,1,427,61,0,09130,2
5838dfb44a5f5a2fa291b26692e5ab98,88,61,2,308,88,0,05030,2
abc2f81bcb6000995d7f71c4b956a718,27,27,1,189,27,0,01026,1
c941f39774bbcdef750fd9bb16c1eacc,32,26,2,112,32,0,05040,1
6be216730209e310f94a83557b8bc3a4,48,42,2,168,48,0,11040,1
137cb6ad57a604e8b3eed858aae3dfc0,34,34,1,238,34,0,01012,1
3182ec23b081ee0eaa2d8eb521c36052,30,30,1,210,30,0,05030,1
275f5b0f705a48bc3c1f7ae9ec369416,253,140,2,885.5,253,0,05040,4
8452fd5a010cfbb2f429e9e5ef8c9696,18,18,1,126,0,18,01012,1
813824aaf2971b386a09c38862bd3a70,65,63,2,227.5,65,0,09110,2
fe44c1fb80136a3cc311ca20736411ed,30,30,1,210,30,0,05041,1
d967d2dc30dfe17e989fbb974d6a5061,35,35,1,245,35,0,11140,1
486c34c11817bb06ef09ef439063e496,67,50,2,234.5,67,0,01027,2
2d2994e6269bcd976e6428108691d50b,14,14,1,98,14,0,01026,1
6386dfdea85c240fdffc3334e64b7b8e,254,118,5,355.59999999999997,212,42,05041,4
5fef619423cce7d3fa6dc620a8dbe6d5,5,2,3,11.666666666666668,5,0,05030,1
43581b2363cc3968df328a8a37f10f22,64,54,2,224,64,0,05040,2
4c21207bb13f8252f94d34e727ac309a,77,58,2,269.5,77,0,01026,2
7198c3207cb499aa5b9803b194381861,44,40,2,154,44,0,02690,1
d6e28d1f1342f1e9608168bfdd93e217,435,121,3,1015,392,43,05041,4
f84d2f220248040b6f53778b08770530,58,53,2,203,58,0,01027,1
713c9dd7b687c20553928aaf34ea7ce7,202,113,5,282.8,202,0,01026,4
ab882e9711edcbbf3f8cfddf7643c7c7,88,51,4,154,88,0,05040,3
187a26018faedf3f76371285154e8507,71,51,1,497,0,71,01026,2
e6bd1148539c33eeec0d67f45452767a,117,76,3,273,117,0,01201,3
fcd6b6e4ef14809a7a44b06feba34547,304,161,4,532,233,71,05040,4
92cd980390522819da2be8f7e8496cfc,308,169,3,718.6666666666667,308,0,05040,4
ba7e948bba6143ba089f226117965123,144,85,5,201.6,144,0,01085,3
91905e51f09ec823ca2bd97fa9c4accb,97,70,2,339.5,55,42,05040,3
3cd9f6660fa135cfca3fe26cb5bf2f60,25,25,1,175,0,25,01027,1
09e425815321bd11154485e24e92e873,71,71,1,497,71,0,01027,2
70841e01bee35b2b961bdfe0f797bef5,106,75,3,247.33333333333334,63,43,05040,3
c914f6e8cde8a2bbb303db69a87469b5,5,5,1,35,5,0,10080,1
cbdc223842f3babbd8e7b635d9def394,291,113,4,509.25,291,0,02756,4
93c4b0b61677c095bd787c00052bbb73,31,31,1,217,0,31,09150,1
efdf27974eee121aacc26cec8c0b1f4d,80,52,2,280,80,0,05040,2
9b4be6a1089630e160ad77dafa1ecdcb,105,63,3,245,76,29,01026,3
dd8d958b1ef2221f875d59b91dc9c756,93,73,3,217,93,0,09130,3
d9bd1ac4eebf2430bf060e74e5b6b030,23,23,1,161,23,0,08100,1
c437371ae5d8465fe5a9ac296b598289,20,20,1,140,20,0,01027,1
b1d15bea1037479c68380515bd293ede,139,106,2,486.5,70,69,03090,3
583ab62b1a6523ddc0859a09dd8af15c,28,28,1,196,0,28,05040,1
7ea05e5d950750bf9081ee28ecdafe25,30,24,2,105,30,0,05030,1
8ffda536827cb71f1a7fa73aa1a6e20d,71,71,1,497,71,0,09130,2
2da7df9e9f418631a5e75d9af2d00156,56,56,1,392,56,0,08452,2
2e574999c3e0d27c4f67790add8424f2,374,122,3,872.6666666666667,124,250,01026,4
6fc32df560c721173fc9f3f6a63b8db5,35,35,1,245,0,35,01027,1
1ca0475b81c20982ce798eb0aa3f1fd6,121,96,4,211.75,103,18,04020,3
b144a851c453784f95448dc2ac36abc7,93,86,2,325.5,44,49,05041,3
a20375e9bb91d995623909af0286d1f1,123,99,2,430.5,123,0,11100,3
b850fcc2d3dd99a60549bd649a501a2f,37,37,1,259,37,0,05040,1
4c7f74471cecbd0efabfafcf55281cc0,328,147,5,459.2,328,0,01026,4
16dd80b45941f2b46d02e34a3bcb1708,11,11,1,77,11,0,10261,1
c219d6e010154df52052caf7371cece4,47,40,2,164.5,22,25,05030,1
f087598c8e08a00b30b5cce0c66ea485,60,50,2,210,60,0,08052,1
32748f224cc9339e5b025a376349d1d0,111,64,3,259,111,0,01026,3
c0323f3241d64716b1fa90f64daacb41,125,76,3,291.6666666666667,103,22,01012,3
351a2fa0c093966e6e4137b10b4f8fe5,20,20,1,140,0,20,05041,1
675fd77386001e0b86b9f9da6b33238a,407,106,3,949.6666666666667,407,0,11040,4
aaaf67b63529eb61521a400ae91b3994,33,31,1,231,0,33,09150,1
e848bb5f5bc77787fc695b93daf42e1c,97,78,2,339.5,97,0,03033,3
c54c91b122c2e022063138c00f6d498a,198,137,3,462,144,54,03050,4
df33c5fda799623cf19dde3bba0ad517,19,19,1,133,0,19,01026,1
c545f10ea2056e5b667d71beffbfd475,41,41,1,287,41,0,10200,1
aafbdc12ebce14d3b941b7c16c047f50,90,63,1,630,90,0,01012,3
b1111e3a6016a4a938bdb157ca98ed43,182,114,3,424.6666666666667,182,0,08100,3
c8b0703e5ea59f2b8a8b572f67e32a9d,27,27,1,189,27,0,04060,1
999fef00694e85839b2cc0225b7087cf,57,44,3,133,57,0,05030,2
49a497ae9c1aa6181c7f1e376cfc7b3f,45,45,1,315,45,0,05040,1
36bd687071b3f025c5250b9941163aad,2,2,1,14,2,0,05030,1
73300532dff6fc627d81308825fbeee5,26,26,1,182,0,26,09091,1
c99422c3c1d1d61195e1e482e5cbee0e,53,53,1,371,53,0,08150,1
b51160debe266a7ddf1cb91d9ddc53e2,175,99,4,306.25,175,0,10200,3
a55ab81062bfba5c5d257432fcb29595,362,177,5,506.8,322,40,05040,4
84fcde7e8abba919c4519fd62ff3323a,17,15,1,119,17,0,05030,1
b5ceb3dbff789dcb72f115a016de8313,31,31,1,217,31,0,01012,1
99ae4ac877c9ded2dd9b47f0a36b35bf,41,41,1,287,41,0,01012,1
934af8d32292c8b52ea09e1b70d9154f,25,25,1,175,25,0,05040,1
91bfe1f82f10e8c3598d4ed45935ec51,11,11,1,77,11,0,11040,1
4eae400f8934f0d3f50454e91a588620,18,18,1,126,18,0,11100,1
6173353480a5cf61b779910bfc6b93fe,45,40,2,157.5,16,29,01012,1
7f44f1818caa18adb754c41c63acd2ff,132,60,4,231,101,31,05030,3
211ab9d086562b67a2da3ade08e2ff3f,40,40,1,280,40,0,05040,1
4e122229afddc7be4174ef9f1fe1296a,276,78,3,644,276,0,14260,4
9df5eb38611f05a3786ddd54b0b093e3,45,45,1,315,45,0,08052,1
376ba4f5a55acb96b3ea55c126d4e352,334,135,4,584.5,301,33,05040,4
000be44cf2378041e456e9ef21076f32,23,23,1,161,23,0,11040,1
533c04a8fb9ba8d1155f4774439db4bf,35,35,1,245,35,0,01013,1
ddab65bb6173e4723b194ecac2994e47,285,119,6,332.5,184,101,01027,4
771d5cd0cdab83a0484bf15cbf2b153a,103,79,2,360.5,103,0,05040,3
13256a76795814d8d5b02501270b2607,132,81,4,231,132,0,01085,3
146df446af8fcdbc2ece358da9889413,34,34,1,238,34,0,01026,1
cffcaa1aa0a3386a27a3c4e8d2e9779f,49,49,1,343,49,0,01012,1
7e77229f3c4140419c1af400e64e2cad,21,15,2,73.5,21,0,01012,1
92096ea7e5b3131a8e70012e22edfa29,102,70,3,238,102,0,10028,3
c1131e9b8b2f8f4ed6efdb35bcc73523,60,44,2,210,60,0,05040,1
cd1fe9fc3a0bd6e61c8bd0e572632b55,16,16,1,112,16,0,05041,1
fe21e5b002ead2908d2e07cf5795bd36,43,28,1,301,43,0,01012,1
8624097fda1cd145dc6df3e3b344e655,19,19,1,133,0,19,05040,1
9c7de5ed725b8b7dcb24c72157ce31f9,167,69,3,389.6666666666667,92,75,05040,3
d8cd34634dde831b91f915431877d600,25,25,1,175,25,0,05040,1
25ff0852bd4c81b58d9626bdf9c6f129,23,23,1,161,23,0,01026,1
cf7d61c100941db3dd0fcaebeab9ea08,102,95,2,357,102,0,01085,3
9ac71ec0992c232e95275e3aa3263a39,154,43,6,179.66666666666669,138,16,01012,3
1fc9c870ed571f2c36c0a60bf9288dc3,22,22,1,154,22,0,08170,1
c1ee9635bdb367ebb79d3e1065d9b873,109,79,1,763,109,0,05040,3
02116948fdaac231e31448ca0be1fb34,15,15,1,105,15,0,09170,1
4206327a2c0e0a7ad9bcae4c1e1c05fa,118,91,2,413,27,91,01026,3
59c6d74f353434185a2a30fbeb6ee4f8,100,71,2,350,65,35,09130,3
87169b8618582553acfa891d6d5e9176,192,100,4,336,192,0,01027,4
211ae3e932a7841cc9be02ef94884e7b,62,42,2,217,33,29,01026,1
956d353e6f6107971aa0a6b8a8f9c44a,85,85,1,595,0,85,04020,3
9ac8c012aaab5b0be8b54cbef0ed252e,105,75,4,183.75,105,0,10028,3
a04b1397635dd8c8afcdb1bc9d7fa3ec,163,88,3,380.33333333333337,132,31,01012,3
0d3f3d98707d43f1fbbac8d49ddebb08,48,22,2,168,48,0,11040,1
356efe9e58ce4f708e2c91cf42dcde76,32,32,1,224,32,0,05040,1
839e51709a6b66c847a40c5280bd334b,20,20,1,140,20,0,05040,1
f3422be6e487dcebf37228d01599a804,148,98,2,518,38,110,05030,3
5796949bc48ae25e2f5a0ecf507b578b,30,30,1,210,30,0,02690,1
fe5eb277dbbe021e84360b45042fcc97,16,16,1,112,0,16,02756,1
00fee70117b2bf30aaeeed67e2bae1a5,225,144,4,393.75,174,51,08314,4
5b46f32fd03bf081964e18d7d2389b04,89,72,1,623,89,0,11080,3
596f522fbe972b1bc13bd767e27bae02,12,12,1,84,12,0,09010,1
ee3b9c915de643049750d20158be26b7,149,92,3,347.6666666666667,91,58,05041,3
142a514f68b7178d2f953c0d33233c58,113,40,4,197.75,113,0,05040,3
68fdab67038560f68299ae7bede5a9de,274,107,4,479.5,228,46,05040,4
34ec1a02b4794a438904e7cd009621c6,240,158,3,560,152,88,13953,4
79ba4a1a9bb3122f2433491aecff2924,402,181,6,469,380,22,11040,4
64356f6d29a56b33f3f9035ec7c618c3,95,64,3,221.66666666666669,95,0,11040,3
27c00af8d3a2923a7b2178b6a7bd3a7f,202,118,4,353.5,159,43,10200,4
cddcf94d69318fd1798a26fd9b3db422,21,21,1,147,21,0,09110,1
4a294392c16a491d5ef065ebd4b720f1,56,47,1,392,56,0,05040,1
e3511126dc27c9ef1f871adc5e8e4d8a,75,54,1,525,75,0,05030,2
0ccf6852ccd4a1aeaddab7981be1de58,130,88,3,303.33333333333337,130,0,05040,3
605e21d0efbe860c12e211bf9621baaa,44,36,2,154,44,0,08010,1
55ac037370c31c56eae89b06eabb54b2,19,19,1,133,19,0,01026,1
69daca3b653724cf4ba0db106e40e9e5,46,46,1,322,46,0,12590,1
0275e8122ce4ed2571163a7ba85257cb,70,41,2,245,45,25,10200,2
525f1c36b2dccaa464c8d27e19b19c18,33,33,1,231,33,0,08231,1
1e470388e2db7f029fc4593bfe58dd91,311,78,3,725.6666666666667,311,0,11100,4
702b6b77c8bdbd3df841949963472595,120,65,4,210,120,0,05030,3
f51c045c36ccec8c7fbbdc35332902d1,40,40,1,280,40,0,09130,1
ca75f69bd25f17843b146ecebba878ac,99,53,4,173.25,99,0,11100,3
bd3fac1de7de41b26908e24f5c41d6df,69,51,3,161,53,16,05040,2
8c1cf933145a61e254eb96f70b9ede9c,64,54,2,224,64,0,05030,2
2e5b43a9cd230849210dd81c7b4c95d5,84,68,2,294,84,0,01026,2
a37eee6ef9e5c3b4b6cbc8e8ca3250c2,79,62,2,276.5,50,29,10240,2
42243cd35784bbb6609d835e18a6b42f,139,97,2,486.5,139,0,01201,3
ecbaec12a37a691f5c84d947d52473f4,55,31,3,128.33333333333334,36,19,14301,1
3cf33362ae3ab08bd5a428ad0b8ae124,121,82,2,423.5,121,0,01013,3
9fa433d9271ff1150ef5d468fcaba13a,30,30,1,210,30,0,09130,1
6f4abcd4a344181ef3d512d6b9a35dfe,48,37,4,84,48,0,01012,2
ea7a493ea48aad4efe77a5cbb8f42fb3,25,25,1,175,25,0,08010,1
8c2c7460a883fb69c6466f005ecc59b0,60,46,2,210,60,0,09170,1
289a55c47b42d77184a0c5c1b6e831a7,35,29,2,122.5,35,0,01012,1
97a742c7892c97ae234fd00bd6b8b13b,39,39,1,273,39,0,09030,1
a20b9bf3b6235d81cf419481ac80f98f,98,66,3,228.66666666666669,98,0,08010,3
cad0d0ccb72f368554b725fa9ff7c5b0,103,87,1,721,103,0,12590,3
728236a4798b18cb502ef6ebe3e1f796,48,48,1,336,0,48,01013,1
11076d704979aef677bbb97e76cce869,32,32,1,224,0,32,01012,1
1e7e7c1ef3b8cd1bbd6b65bcafe1afe5,12,12,1,84,12,0,11100,1
cfe53f5e7bb722048ea98622e38da367,121,75,2,423.5,121,0,01026,3
2a7d4b61254629afd2127814e7ad19b6,204,127,4,357,171,33,05040,4
606adb8540e7ab25937f0af5bf4abc3c,44,44,1,308,44,0,09150,1
5cba90267e17e7a63d1a565be7b80977,209,97,4,365.75,209,0,08010,4
a6d32db7d6b0148c08da846ea627655e,124,84,3,289.33333333333337,96,28,01027,3
c9b95edfbf72cc4a59169ffe81c5b3f9,22,22,1,154,22,0,08100,1
14153055d5d46c992d0c6bc91ff9911c,81,58,3,189,60,21,01016,2
c720e6f577e90b18255e219f4cacd625,171,79,3,399,171,0,10200,3
450e83fc78b5e7b547355f85ae7a0e97,77,67,2,269.5,77,0,05040,2
d58f328962a77dba96eb77826a8f0dbd,154,97,4,269.5,154,0,02650,3
41108bfc09eac88b2a95f2d0a1b32ff0,54,43,2,189,54,0,05041,1
32408c00d39ab604d3122fabdcb203e2,57,42,1,399,0,57,05040,1
3d360988fbd3a0b07beb01796aa6a769,72,53,1,504,72,0,03070,2
4903903cfc488f2fa8b928edc310a5d3,290,128,3,676.6666666666667,290,0,11080,4
e99d97ef958df8170ebfe8257d77ab28,63,52,1,441,63,0,05040,2
725db5ef2f79e791a253056d81dc8298,335,106,2,1172.5,172,163,10200,4
c54ab520d5200b0a2497025a1cc66e91,177,94,4,309.75,130,47,05040,3
9d8dd9b8c486c9924aa5a1c90f0ba6c9,39,39,1,273,0,39,01085,1
08375f5431e87a1823d9205f108e5a65,18,18,1,126,18,0,09111,1
f97157f1a7e1ed0d36dc2f297ec7b32a,388,129,2,1358,84,304,01012,4
1df9d61f0f0b0325da4ed4f3432ece6c,4,4,1,28,4,0,11080,1
b0d405073a81baaa83b0b320d3a2d72d,183,83,4,320.25,154,29,05040,3
88f17a643db2382b0ce02c719cc53d63,1,1,1,7,1,0,13930,1
aade00c51f4d1791080d64decc68777a,223,106,3,520.3333333333334,223,0,01085,4
b30fbd311246f1f5c9f4e4bbdeab93b3,89,73,1,623,0,89,09130,3
ca913e7b9af4025f856cae96a2fe6c8e,32,32,1,224,0,32,05030,1
e2249df5e0787c7005a48ff013a6a088,3,3,1,21,3,0,05030,1
d7b730298baf8e60ad00c95a9a61ea80,74,55,2,259,74,0,01027,2
e713ed2f47518075677339a29198b730,248,98,5,347.2,213,35,05040,4
b2acfe95a3e786da3ff43be92e0e3c7a,158,105,2,553,158,0,01026,3
cd781d56679b0dad0c5e56af3f4796b8,12,12,1,84,12,0,09010,1
18c951e2a5b4d107e78d61f3e0a4ebd3,52,40,2,182,22,30,05030,1
1f949662db49eb7ee0598a7d00a32e1b,49,49,1,343,49,0,05040,1
131eea520f581334a1b1011dd18117c8,18,9,2,63,18,0,05030,1
8b0b11afb98ad1afbf7346679e094214,211,95,4,369.25,211,0,01026,4
cc37ab877e6de0271d154439be4d568a,91,60,4,159.25,91,0,14301,3
319b0c2d5acdd2f5f12c4d78c636b872,152,89,4,266,152,0,01013,3
df36f782947197c7625dba4ef0a9c8c5,73,53,3,170.33333333333334,73,0,03050,2
099f87276f8c26b5ee84527621e5c249,265,96,6,309.1666666666667,182,83,08052,4
254536b6b31a5f8e4c396c46e2650278,210,101,5,294,172,38,05041,4
b7dc79242be46cf305cbcc7c9caa48a0,134,58,2,469,134,0,05040,3
a2759534459cba5428455ff8b1618067,370,182,4,647.5,269,101,04020,4
663065fdb2cfc62bc8030837b40d7ee6,21,21,1,147,21,0,05040,1
e6733a29d1ec148180772eb6eb159d94,138,101,2,483,42,96,10200,3
eb66ad223dcabb373955afc4791a737f,47,47,1,329,47,0,04032,1
ea7a2f7f17bd92cc2d562ccc968c327b,235,148,3,548.3333333333334,177,58,05040,4
8f883c4a41c8d60f6146998a0f62ec40,107,26,2,374.5,107,0,05041,2
2e7253a2f6146ee1fb9bb441a068b5f6,183,131,2,640.5,183,0,04060,4
990d6488a3a36eb80f9a72ec2fb447b2,84,66,2,294,40,44,05040,3
9dc0a8203e858837b18bd763de1783ae,33,33,1,231,33,0,05100,1
a55eddb25b2536dc894540ee25a89fb7,68,44,2,238,67,1,05040,2
e035d6f2105883e158efe8f9d9db87e8,65,48,2,227.5,65,0,10200,2
42e853fa079c9864c69faaae35e5b84e,16,16,2,56,16,0,12590,1
75800f4c47532665f08f9b27d9ae660d,50,39,3,116.66666666666667,50,0,10080,1
80bbaa292fc8a2e220fd63b9bf3bf324,22,22,1,154,22,0,04060,1
605c21c829538645cf68fafaf5c45885,20,20,1,140,20,0,10220,1
65b47d16669e0c00978c5c05f3f1338e,139,102,3,324.33333333333337,101,38,04060,3
d2033b4038d51f3664a7d9b079dfb4fe,71,66,1,497,71,0,10200,2
efa593bca43c4c298cf614f5d06a2f11,30,30,1,210,30,0,01012,1
855e9d5c76fad3a21f590e5447c287ef,28,28,1,196,28,0,01026,1
1f80bb1f3aeca2e4babe961dcc99df95,25,25,1,175,25,0,01026,1
cf7208615fec49d5ec8de8654444cbd7,102,53,2,357,102,0,03070,3
3d8c4289d760deaee609a85d425cafb6,90,77,3,210,90,0,11080,3
c947ed8ae61cffdd890122e19f4775c5,55,55,1,385,55,0,05040,1
81a32bf0097d28a5d419bf58160aab8a,108,48,2,378,81,27,05040,3
a464aa705c2380050345b3d731962bc4,112,86,3,261.33333333333337,85,27,11100,3
55c37f92fc2069762ab06d8a224be8d3,38,38,1,266,38,0,10200,1
f2b9ab86a8956117ed7754c465f61ccc,77,59,2,269.5,77,0,05041,2
1d03da86eda991c199351db34ce15f95,280,81,5,392,206,74,01026,4
f0a078bfbf425df5663d979052bee3af,60,60,1,420,60,0,03050,2
9f03cb6a09d85f8ae808d515d477e20f,16,16,2,56,16,0,05030,1
8f41b56de09ef05c4134de51861117f2,68,51,2,238,27,41,01012,2
0cf1ff00a976d1833293049e06aa7f05,66,45,4,115.5,54,12,07143,2
b6dcb595e502816fcea7a754fa379736,8,8,1,56,8,0,12650,1
d3555c045aae8cdfae41992bcd7eb337,22,22,1,154,22,0,01027,1
1fa0c5abd82d38bae426c88f01be68db,32,31,2,112,32,0,01085,1
2c5a731b20e9be3171a75fdd65fceaa3,117,80,3,273,51,66,08052,3
2012568892549e6782fb6bcf5a7497c7,92,81,2,322,56,36,01013,3
faba8daabaa121ba63ccf0e54688a28c,8,8,1,56,8,0,01012,1
e5428bcf122441c67f80f3a3b1949684,73,57,2,255.5,73,0,05040,2
0f2fc227c044d2ad0d357d26f663a15e,69,52,1,483,69,0,04080,2
f8b8a3e5e3296234b0b51b1724a72a67,133,70,2,465.5,133,0,05100,3
1d7ac1585eb244399fd228142db65ae8,27,27,1,189,27,0,05030,1
efdb94189957303dcf11696400f8f387,211,130,3,492.33333333333337,183,28,06100,4
be53401c1ead5843abc15e06536df939,32,32,1,224,0,32,11100,1
aea170946b7ec6a48a2fe772c76953bb,82,44,2,287,82,0,10200,2
33b599688a48c39c3faceaa416c0ed48,43,32,2,150.5,43,0,01013,1
020dcd38222eb51265ff9086dfa18f50,30,30,1,210,30,0,03050,1
6dba3aad4ec27e13314942483ad4dded,98,71,3,228.66666666666669,98,0,04020,3
1697ecf4928745e14561fdd97d35effe,18,18,1,126,18,0,05030,1
fcc8063539ce2385eace1c6eb0139628,98,80,4,171.5,80,18,01027,3
96a2b572b480ba23cb6938a74620626d,69,53,2,241.5,69,0,11080,2
ab6c040971fd63ba034c1c6ba49c3a9f,192,106,3,448,88,104,02756,4
4689ea44aded67d1093f3137f9e13d7f,143,83,3,333.6666666666667,103,40,05100,3
061e49563f8b4d9e282a37050c97fbb7,20,20,1,140,20,0,05040,1
640c1a7093d55d00818065e87d85495a,27,27,1,189,27,0,09091,1
8473b23ee5b7bb55cb8043cbe37d6b6a,473,128,2,1655.5,81,392,01026,4
9332bc154caacd1246c94f2830cc4ca9,27,27,1,189,27,0,01012,1
fdfe6d9770e8b6dbb9e4225d0817fceb,19,14,3,44.333333333333336,19,0,09350,1
fd1a9c0a4c7346572a2757043d77efbe,23,19,2,80.5,23,0,05140,1
4285204d9db2cfa230fdeaa3a3c3b25b,22,22,1,154,22,0,01013,1
6185428a9e3265167288aa15b540d0d5,5,5,1,35,5,0,06100,1
56863305c9b6a6c11a43107b4854103c,49,49,1,343,49,0,01026,1
c9e3d66c8d25f28ef7469fcecec6c0d9,187,71,4,327.25,105,82,01026,3
180420ab3182059d5680b9c90796e4fd,52,51,2,182,52,0,03033,1
fbd45d352f928f871fbfb575c16cf93a,1,1,1,7,1,0,11040,1
ed496dd612785b77b139cd1577ad7a59,181,95,3,422.33333333333337,149,32,11060,3
9610dca8952d045e7af12c14c916590f,129,64,2,451.5,39,90,10200,3
e347a13222c6c8f98a1ead92c0edbc0b,211,96,3,492.33333333333337,211,0,05040,4
474a145a62eb25a09f2869d5f21856c9,42,42,1,294,42,0,09130,1
105bffd1a0577a2a8cfe29ca07d7888f,1,1,1,7,1,0,13875,1
69998c81c0faad80965f8236af241700,29,29,1,203,29,0,01026,1
862a6ee67b418da6c80bc59b0f9acfc4,137,77,4,239.75,112,25,05040,3
339dc0c4719f8513314d5c3aab781fbf,54,45,4,94.5,54,0,06100,2
fc089e1065c2c2275b9194e2c950cab7,53,27,2,185.5,53,0,08090,1
944a898b2e6f0348f753a937b446244e,12,12,1,84,12,0,07143,1
7e95d1daf075283a8d69022d1839cb15,217,143,2,759.5,79,138,02650,4
4b6498728622d27c0ff3dabfcbe6ffef,53,53,1,371,0,53,01026,1
dff6e24c94642b5b3948afaae1087c12,29,29,1,203,29,0,01026,1
cf21559ac37b8f7a18e5a1f74d7d7045,30,25,2,105,30,0,11040,1
95cd5126934806c5d99e0821ff4042e2,27,27,1,189,0,27,11100,1
c310d19f4a30caa311ea9fe46856a7c3,18,18,1,126,18,0,05030,1
207b07c8ef1d65da278cf58cf2ad0aa8,76,59,2,266,76,0,05040,2
3661fbc3e7c83eee77dea664ba8d5e5c,7,7,1,49,7,0,05030,1
c27a4bdcd47561bd2ed62eed4bca6fd9,1,1,1,7,0,1,11040,1
a7abd83fe4c2f95b8aa69c3d7549d8d4,85,69,3,198.33333333333334,48,37,01026,3
e1c54961c9a23cad1a0be2d8b8a02bee,31,31,1,217,31,0,01012,1
f15dbde58df0fa01be058dadcb53b719,21,21,1,147,21,0,05041,1
451736269ac96f49fe18d9007aca9286,287,153,5,401.8,220,67,05040,4
7809b6249cb4e6ce6002fe259451fc48,32,32,1,224,32,0,01027,1
1cf50cf5d82084ee415dea7ebff3f687,118,81,3,275.33333333333337,118,0,11100,3
7f689d12b660d5e3f1286cb44a3237f8,77,44,3,179.66666666666669,53,24,05040,2
012229659d2b7758ef0d763a9d12fb2a,288,119,4,504,268,20,04020,4
00b8c37fd3617b2b58261785dd22044e,38,38,1,266,0,38,01027,1
01b87c2f70c8806206d61929c5dae86a,8,8,1,56,8,0,08314,1
42f8966c64d66f54a5aa2c15c8d42245,23,23,1,161,23,0,11080,1
3a9e2d804d3be04bc5ab77e4847d1f23,16,16,1,112,16,0,03070,1
8956370e3ac56524b8a1abed0f8f5519,23,23,1,161,23,0,05100,1
164e5a1deb2aace9f2ebd773ee4278af,124,89,4,217,85,39,03070,3
bbfbc5fa4b125aefe5a5a633b73ba436,19,19,1,133,19,0,04201,1
93214ca352c53eabe4c8b51641cb10cd,21,21,1,147,21,0,03050,1
5e109b9c0cbe7d0c97570e3de6790440,72,62,2,252,30,42,01027,2
602ead714718dccd2f61db50cde5e6ae,397,139,2,1389.5,35,362,05040,4
d0704a1cf59fc591419924ed0837beb2,354,135,4,619.5,234,120,01026,4
6c5d8f1bf50bc238d4df7ba39e5420a6,126,85,4,220.5,101,25,01027,3
d792989e78a5ce0b101e845a58a79d25,35,35,1,245,35,0,01026,1
c792b4ff03f32d5a758843d2e7c4153e,9,7,2,31.5,9,0,05030,1
895de92d123d05d750ca22ac94416641,115,62,4,201.25,102,13,13930,3
add607cccb7e46688b2bc15a0e94e1a4,454,148,4,794.5,282,172,01012,4
b021c80b84b73f72bdaf93e3fdf37886,79,57,2,276.5,79,0,05041,2
816df546962501fe7347d42057d52aa6,93,82,2,325.5,29,64,01026,3
a79356892eff0c4324c9b8e535ba3438,116,66,4,203,90,26,05040,3
7b8bb0d968e38504fabb9cb145e8403f,36,36,1,252,0,36,05040,1
138b2aa04e460faed00e5eb5c5e7b64d,60,49,1,420,60,0,04020,2
e9ba22140dc210564293f3b34e6aec00,47,41,2,164.5,25,22,05030,1
545126f192ad318aca5980c726789cee,31,31,1,217,0,31,09030,1
4118451c9913ef35efc3d32a87ed53df,39,28,3,91,39,0,11080,1
a0856b294adede638893af9bf20ee6a6,28,28,1,196,28,0,12500,1
91225b1c8ca27b251579221bf6ffa0d8,107,76,3,249.66666666666669,107,0,05100,3
424a64d15e17467e564c738cf639200e,44,44,1,308,44,0,04060,1
89c65c154e90355a9f3d2626500c3d4a,134,88,2,469,134,0,05040,3
8deeab1d79fb53294677249fc26482d8,41,41,1,287,41,0,01013,1
1ce3eca5682b392c6d77552d0223972e,25,25,1,175,25,0,11100,1
b10ba254f838e27f22c4679005bdf018,194,104,3,452.6666666666667,163,31,10200,4
fac78cfbaa5264491871abfff9474e8a,36,36,1,252,36,0,01026,1
da22b8a7f123128453c3b7a6c9d95b7a,19,19,1,133,19,0,05030,1
e54bc9d883f8673751a736f734102239,37,32,1,259,37,0,11100,1
29f75fc659584288a57d1ba66162279a,1,1,1,7,1,0,04301,1
b0027e09c23f586375f1feee54b72091,65,54,2,227.5,65,0,01026,2
e466572cabb9a9cc921443effbe63ccd,21,21,1,147,21,0,05040,1
023d9e9e1c910454e85bd40474e574b2,175,73,2,612.5,41,134,03070,3
9c6f21440df4eb03a030fa2224eab5a6,82,61,2,287,82,0,08230,2
7a2e82d9351d07b6bfec87210b3ea8f2,41,41,1,287,41,0,04032,1
f89bcc09007ebbab63f42693b410e0d3,13,13,2,45.5,13,0,09010,1
c265591683815850e348ca54880aaee0,46,46,1,322,0,46,05040,1
cd2f42c77fc632613084a86b12233e1d,62,62,1,434,62,0,02620,2
af9a992944fe9ed625893f48c68c51ba,37,37,1,259,37,0,04060,1
b7d65e11c98ec466656bfea775167511,59,59,1,413,59,0,05040,2
18d6564dfbdfb7856b1b47b66f1fa546,313,140,5,438.2,228,85,05030,4
969bc06781b8975eb6742e01cfb3eaad,53,53,1,371,53,0,03070,1
32af96618e322949fb7abb12d8afcbfb,230,67,2,805,230,0,05200,4
1f2dcd5e8c12ab749281cb2881272952,28,19,2,98,28,0,02720,1
0e99e4f33655341a5541121cff8804f5,28,28,1,196,28,0,01026,1
98fc99c93c771325e808d3c2816d1cad,23,23,2,80.5,23,0,10160,1
b7c8e602fde34bfbed8b6215c1a9769b,86,64,3,200.66666666666669,86,0,10200,3
9285f06902ea713e0a2965a66d22a010,14,14,1,98,14,0,05040,1
28a469fb509236b3b3ff26bfb8248db3,179,127,2,626.5,179,0,10153,4
78554176190240c5a1fbad4742e431e1,23,23,1,161,23,0,01012,1
51f9f8b68e0bfd6bfd7b4e8c4dd20fa8,50,50,1,350,50,0,11100,1
1949ed146589c0ae5757a3d15d77a335,20,20,1,140,20,0,05030,1
43801344a721e5a3f9cbc3bcfcba8dec,34,27,1,238,34,0,01012,1
57bc65547ebe76a946c18b227cf1c833,15,15,1,105,15,0,02754,1
64c517ebea322f7b5b3bfca9d7f0faa1,32,32,1,224,32,0,02720,1
aed949a67972203503ca10c15f3bf66b,34,34,1,238,34,0,08230,1
9f1510bc4f752bea2aa1a711bdcd4e6d,145,110,3,338.33333333333337,145,0,05040,3
260021c848ff262e499581391fcdd363,446,177,4,780.5,446,0,01013,4
da9f510390458186f2de8e63c318c9d3,247,121,4,432.25,104,143,11040,4
11d0d77522f776db88ddb885cba3e3bc,61,58,2,213.5,61,0,01026,2
d29af1dccdc4d5904f503db446d6dd82,30,30,1,210,30,0,01027,1
7313383f6204f9798202bd5621196d54,52,29,2,182,47,5,11040,1
558d5470626704bfd4ef8fa27424ae71,31,31,1,217,0,31,05030,1
83372a4b5c15e9b66d46c489fba3a76f,60,60,1,420,60,0,02650,2
f96e9498b7f4200788cb9a1b77ea495a,177,75,3,413,161,16,02650,3
cc21efab89fedca970fe121e7f851de1,36,30,1,252,36,0,02690,1
3ec447cc0a20d0ba7cd78919bb0083bb,113,85,4,197.75,113,0,05040,3
d9eef420e665d8c615fa4488140fb47f,126,93,2,441,82,44,05030,3
634c60a06ce71717c14bf4d4e2dfe275,154,109,3,359.33333333333337,154,0,05040,3
a49f85ae9b04e890ba67f8931cee67af,40,39,2,140,40,0,01027,1
cc2fdffd44d0bb74d63e0a81b0dcfa76,160,76,3,373.33333333333337,160,0,02690,3
23532f6c6ecf886b032b8769dea375e4,236,141,5,330.4,208,28,05040,4
0b286f359730b0283ad7be0bb5b982fa,182,98,4,318.5,56,126,01027,4
7ae7b8b08de803a6de541e19f39e3b19,25,25,1,175,25,0,05040,1
ba0604513c0ef6a9ecb87c8d7158b1d5,4,4,1,28,4,0,05030,1
6da728a5a6372ce6a8e020c2e560ec7e,121,87,2,423.5,121,0,05040,3
3323ca0d68876e5aa41dd1470d958956,101,74,2,353.5,75,26,05030,3
63ac8361cf56ab2d8caf7b4771151774,164,102,3,382.6666666666667,164,0,05040,3
a0232932fad81ded1baccc6a7764d4e8,153,88,3,357,105,48,05041,3
a4716059e292a3341d531358ef6b747c,34,34,1,238,34,0,05040,1
88246a3dc6f57e3fefc44ae1b0dfd959,53,53,1,371,53,0,09130,1
f08c0951e5cf45ed85cfd4516f34c31e,75,62,2,262.5,75,0,05040,2
dfa28206addb0a425fc8ab735865d54c,265,128,6,309.1666666666667,208,57,01027,4
a6a470921f45e2e6d5b8ad900de4ff30,42,42,1,294,42,0,03090,1
8c5037ba3cec5fc348835a45adfa875f,73,73,1,511,73,0,05040,2
24c578490e678008e9decf4f3850c297,68,53,2,238,41,27,02756,2
254150678b326251390735c2cfeea770,53,42,2,185.5,53,0,09010,1
0855bbf75024c6691fbd5e65f34b7457,97,64,3,226.33333333333334,97,0,08100,3
b367d6d2abd856944b83f14ecd6028ea,26,26,1,182,26,0,05030,1
804d5ff6ef82aea9a98e7a187ce8d3d6,141,111,4,246.75,89,52,04020,3
ceb1d78f500435138a087b0c62a717d2,85,49,2,297.5,85,0,01012,2
a437866101c8e1195816675041de05d3,114,92,2,399,114,0,10200,3
4082217b9ec7cc61e9b7cd099d13319c,28,28,1,196,28,0,09010,1
8816b65aa1fe09789eab0acebd203295,22,14,2,77,22,0,05030,1
8e54034ae1592166d8899113727cdc55,20,20,1,140,20,0,08010,1
58c2b5bd92fe6d077d946efdd4c9fc2a,63,54,3,147,63,0,04200,2
6dacdf7a0097c7b3e8ca2197bc080e96,102,90,2,357,102,0,01026,3
6233b8902d1890c0523ec972c8fbe234,143,108,3,333.6666666666667,112,31,01026,3
8eea2bc4c9bc769ca190bfc77acb3f17,54,43,2,189,54,0,10140,1
2a926302e80c2e8605a746c64013bf5a,89,72,2,311.5,89,0,09130,3
caeac163047cecc2df4a66437dab7a94,46,35,2,161,46,0,04020,1
5741a1975a88d6391991d8ce503e8597,110,63,4,192.5,85,25,10200,3
135195237852c9c64f63148dd2e53c3f,81,66,2,283.5,81,0,01012,2
13ecb7e3c4438db05952fd44c997aae6,124,65,3,289.33333333333337,124,0,11100,3
e34ea69a72e3ab83f54ceabee72b4854,23,23,1,161,23,0,01026,1
cfce03f6a994c30e6c3d6361324c7886,62,54,2,217,62,0,05040,2
9a02dbeb2227ac4b6f24ac973ae31715,110,77,3,256.6666666666667,110,0,01027,3
0fb9af4d4ab7af4dd0d71d40b6ca0034,24,24,1,168,0,24,05040,1
9c9c4c9fc6b9ceaf8cac586dc355b99a,62,62,1,434,62,0,09130,2
10643b3a9cdbc495c01fe9a132749014,37,37,1,259,0,37,11100,1
02e3cacb2ba20f04aa9168436bf1328b,23,23,1,161,23,0,01085,1
30a4511546f9a6267ec98ac1b47e3a75,143,76,4,250.25,130,13,11080,3
5fc7552179f0cd028874d2202fefef6f,49,49,1,343,0,49,05100,1
5b53ee4780b8d3e7fe53fe64a57eb9b7,26,26,1,182,0,26,04020,1
b5782b010ded84cffd76cc8c387ed1be,71,53,3,165.66666666666669,33,38,03090,2
f69dd40665f6a99813c90aefca9761a3,42,37,2,147,42,0,11100,1
6ffa967d62ef6573f564e77d3a7ef0d9,247,136,4,432.25,121,126,05040,4
72be7bc6828e1c95de04c42f846b41d4,365,108,3,851.6666666666667,334,31,05040,4
16954128c559b63ba62a617f25a584ea,136,92,4,238,136,0,09030,3
e97580934491e03e0dca44458aa52315,18,18,1,126,18,0,01026,1
19f28719d899cf84d7129c24d837c053,5,5,1,35,5,0,09070,1
79ae0c5f8af04b7a34428d4a89bb47e9,192,91,2,672,192,0,01027,3
2980ab6a94403971deb5337a53188910,14,14,1,98,0,14,01026,1
94035aaabb7c9cee54df7c1394dfcb5e,49,44,2,171.5,26,23,10200,1
9cf988cc43f3965ac204444ba8c085d0,252,109,3,588,252,0,05040,4
994b238f6277d987b750fed79070ae04,154,119,2,539,60,94,01013,3
2623c4ce4b28acc873f8954030aad2c1,29,29,1,203,29,0,01013,1
eb8e9c56a5fcecfac4a1420e074974fa,167,98,3,389.6666666666667,109,58,09110,3
42957f768fe240a53b7b585aa1961706,36,20,3,84,24,12,01012,1
18604e64c441b7045fe0e90e0707a943,21,21,1,147,0,21,09170,1
c3dc0ca361eb6fcbfbd356eac5e56b59,44,44,1,308,44,0,01012,1
bc5897485c047e993576c86be6e73e46,9,9,1,63,9,0,09111,1
58fbff5a3f58e80aef4769e5b1710ba2,97,66,2,339.5,97,0,04060,3
edce55cc21fda77f204130dfb3039f86,420,152,3,980,420,0,05040,4
949e69a87eb045d9d5d01d8efe1f0af8,28,21,3,65.33333333333334,28,0,11040,1
4f4ee26738cd3898c9212f842f1a1832,20,20,1,140,20,0,09130,1
913bc48666102fb1c557a4d70ea5441b,17,17,1,119,17,0,09010,1
a56bfa237e7d7726bfc27018d4b0033a,66,56,2,231,31,35,05040,2
a40fadf260306ed078a0caae94c8e377,53,27,2,185.5,53,0,05030,1
dd593065410adf3396ad3627e953d500,63,46,2,220.5,63,0,01026,1
37d3f029eafead85aab001cd011d9684,66,61,3,154,66,0,01026,2
6e7cb1bf07a70125625c45b75cbee8a1,75,46,3,175,75,0,10240,2
76838281702ccd59ad8b37a3c3ea1db4,114,79,3,266,65,49,05040,3
ffd1ae7e92c11dc75f74f00186d4aaf9,23,23,1,161,23,0,05030,1
e26cb9b73e77d012fb87f4db168a5ebe,5,5,1,35,5,0,11081,1
2b900b827ecf28e7d9318888f5e6cf8d,219,122,4,383.25,181,38,05040,4
df8888105fc8e7e0e24e2ece2bd003d7,25,25,1,175,25,0,01027,1
ef01f0b629bea26ae372e9e53faaa64e,102,69,5,142.79999999999998,102,0,01026,3
0feeb1db008b1bb59f661d3c396cc7ca,24,24,1,168,24,0,01012,1
e2e99b44ccf888e9c7bd5e2b885175b4,32,32,1,224,32,0,08051,1
bd223915f9864b6a52fc30bac66af158,191,119,4,334.25,191,0,10200,4
4942888fe6b757e91ce5fee0b85b4f05,328,119,6,382.6666666666667,306,22,13953,4
cf476c5268b416a68a48eda8e5a53d01,72,72,1,504,72,0,04060,2
7e9be20759b65d3e61a301df4a4a283f,27,27,1,189,27,0,01012,1
fa863bdd4e05926e840b218f36c43fdb,20,20,1,140,20,0,09130,1
8e3204d7b390b7d23f7ac894ea7d48ec,15,15,1,105,15,0,12570,1
b8cff534f98915e2801a1d059446fb73,32,32,1,224,0,32,10200,1
053ea723f5a758f0ed492b8a29bcdf6b,130,91,3,303.33333333333337,100,30,05040,3
18048e7ffd1b99352652674813b0431e,138,96,2,483,47,91,05030,3
63b921f36bf64f790f5e2d597a7384cc,46,35,2,161,46,0,05040,1
59755cebf77da9fb2f3378b39c7d66c6,82,58,5,114.8,56,26,01013,3
f07d146e97e9330e0b1dd9eff492c203,84,62,2,294,40,44,02620,2
62049c2c953a1ac5659f738fc72d9d4c,142,112,2,497,142,0,05040,3
eddbe2e12cff69e400c110283218a512,57,51,1,399,0,57,05040,2
0e4500e30cd4a561f21745dff9fae4e9,163,87,4,285.25,147,16,05030,3
1343ef9770d4de8e4b0ed110293a6466,98,81,4,171.5,98,0,01026,3
b82a8bf464bd364eb0b0daf7abf5d0bc,57,48,3,133,57,0,05030,2
e98f05e5c3adccb3bd9445d33ec69850,211,109,5,295.4,181,30,05040,4
5a45c6450b523f9fc424af30905f9aa7,14,14,1,98,0,14,08132,1
5da4f2a58250a926187ccfb70464e076,69,46,2,241.5,69,0,05030,2
d710ca9cadb5bb3ee2334f389f14ec57,43,41,2,150.5,43,0,04060,1
a44db31a1988cc8af34725bb4a37d99f,177,112,3,413,177,0,01026,3
0e4a608a37d42869d2de8c81b166cd38,28,17,4,49,22,6,11040,1
d420f8da9e517fcc57faaa10ae9033ec,67,52,2,234.5,67,0,05040,2
d14fe07d4ff49ae3c6d4a005eb1bafb4,21,21,1,147,21,0,01013,1
7fc1254f0920fb990e1fd9dfec2beaeb,24,24,1,168,0,24,05040,1
b21971f542d6755a3b5f921e8da617a8,30,30,1,210,30,0,10200,1
901fcc57334a00b19753d28c7d5c420a,30,30,1,210,0,30,01027,1
acba87b5e395d171b00ad987c587bea3,271,111,2,948.5,271,0,05040,4
abc6d4a3856c2b67df062a3e0423d993,8,5,2,28,8,0,11040,1
852e3baed3e5557dae7c383dfc2cacfe,33,33,1,231,33,0,01026,1
6bd157c637d94d23359eb245cfb745bd,62,48,2,217,29,33,04130,2
9f6726788e485e6107492f964fc45f54,151,69,4,264.25,120,31,11100,3
0aca8f723df043bc8a09bb1f26d60975,15,15,1,105,15,0,01026,1
fd6c2389a6a8bbc7eb1099d2d5177ee8,168,102,3,392,57,111,05040,3
5dabcb13a4115ba3192eb523ced15884,58,39,2,203,46,12,09150,1
b061b1df105cee912c52224e8ca3b8c7,24,24,1,168,24,0,01085,1
ca5b73a3c1a00d224306191d385c1655,37,34,2,129.5,37,0,01026,1
29d95f16cddc4e272192d885278cb9db,82,61,2,287,43,39,01028,2
a95621332b88bf8af9a00c4533156570,35,32,1,245,35,0,13930,1
d9ef1b91a16fdf0afabd6de1f23f4583,102,51,3,238,50,52,11040,3
976e331b74ba2cb8ce73e541c8da05f0,15,15,1,105,15,0,02691,1
562fd2ebaf7cd02b0d1e3bae0ea45875,110,45,3,256.6666666666667,56,54,05030,3
918103989e8aaf41dd6ddc5565bdf9bd,21,20,2,73.5,21,0,05040,1
7fb74525bbe15474b0ddb7da4f371bb3,181,82,5,253.4,181,0,05100,3
5033a2bd8dc1f5a92fc179d6bb390803,5,5,1,35,5,0,11100,1
8e7a03d05d6d970a62a499d825528f2c,11,11,1,77,11,0,04060,1
5b8313749818212de9b1d767a30ec82d,61,61,1,427,0,61,01026,2
531a7ea291159ace5804ea7f04a7e8a2,39,37,2,136.5,39,0,01013,1
12f7575b74c9709fb327520b13006aad,45,45,1,315,0,45,12570,1
b22ebab69724d5a30e14bcf95e72e4be,241,102,4,421.75,241,0,10200,4
7bfff26c0bd68127d47c30b47cc49fbb,2,2,1,14,2,0,11140,1
ab9bdd999d9243d76d5ad93c777eb6e0,145,75,3,338.33333333333337,105,40,10200,3
6d9461b00b8f14a09d559d16a41762e6,47,33,2,164.5,47,0,12590,1
851cce5b3b0ee3aa24a22d358c919015,68,54,2,238,36,32,01026,2
63542acb0c0b770d535881ef8406e35b,5,5,1,35,5,0,04080,1
26e8cef65e6bf64aafd8197c7ce4e468,86,86,1,602,0,86,05100,3
173754d599a221dd14d831e3b8d84454,36,36,1,252,36,0,08090,1
34ad07814b5d106429282881e6876245,90,60,3,210,90,0,10040,3
35cf48f9b3f534d9972ba9266dda9c39,53,31,2,185.5,53,0,05041,1
799953a94511deb5f7e2081614c8bb10,115,92,2,402.5,58,57,01026,3
61e583ec8c498cd770e326e33ebd9a0e,102,68,2,357,102,0,05040,3
90b0b9e2e955ffa883397ccf52d55b21,27,25,1,189,0,27,11080,1
b62d6e0adc013768947b251889c105a6,99,78,2,346.5,99,0,10200,3
b126520b09f06f72489de6efd29d6808,89,69,3,207.66666666666669,89,0,01013,3
553198f5a29f05a89d1e9faa6f1d26ad,42,42,1,294,42,0,10200,1
19226f312b01cbcd557d53ce96533339,2,2,1,14,2,0,06100,1
b933b2e26983525a68671586c2141f8c,40,40,1,280,40,0,01026,1
93572dbd261e23aba4f5535e1f74cf87,47,47,1,329,47,0,01026,1
2c74b8048b8ea4e5703493c57f308aa1,142,93,3,331.33333333333337,111,31,01027,3
4b94b538268cb785c8dbc82e52270791,296,156,4,518,296,0,10260,4
8bf3618193518a3904a57291ea1b6a75,39,39,1,273,39,0,04020,1
0de4ee2bf7953dc9fbab47ca23019789,6,4,2,21,6,0,11040,1
69addb24f0931fa28413f9ac5b52e583,46,46,1,322,46,0,04020,1
d1921f804e6fbfc5f2eddd1703ba9c82,170,117,5,238,111,59,10200,4
ce52167293f214b53b9954c6590cf355,4,3,2,14,2,2,11160,1
5aac8500b4497401be21cfe3479bc7d9,17,17,1,119,17,0,05040,1
2e92360dba71c2bca29f210a2260f244,78,65,3,182,78,0,10040,3
070195caad59c4aaadb445b3fad1f2d9,130,75,3,303.33333333333337,93,37,01201,3
a5cc15f55ec263a06bf704d8049190c1,12,12,1,84,12,0,09010,1
dea7f8d0cb979fc116cdbb9863365c26,8,8,1,56,8,0,05030,1
96b4bdd244f8ca4829df2bd578b31316,46,46,1,322,46,0,08100,1
9b95e805fc351f82e10f4b74881af586,82,51,2,287,82,0,08314,2
1e61f7322ee7e4c4b36911e506fcdefd,32,32,1,224,0,32,09170,1
82442d5278d76a8aaf02bb46e81e80cc,253,100,6,295.1666666666667,235,18,13953,4
653793f468c7d3d05a79fa4982fefe7c,160,78,4,280,127,33,05040,3
b453ad18a2379fe794653cf8c943fbee,58,46,2,203,58,0,05030,1
1d200103dd5b7b63775d0017ac2bd695,4,1,2,14,3,1,01012,1
98fa51a70129ad2f29768b49b70925e0,61,47,2,213.5,61,0,08132,1
ab667235a45deb4abf098f8ad70c03c8,1,1,1,7,1,0,13930,1
bc0ad637f48ba91c53ec26e80f042e63,95,64,1,665,0,95,03070,3
5a55ca9ba9e1edcab44cd459c7e411ad,33,33,1,231,33,0,11100,1
f725b4123c559f21e8d4fc8102a7cbd8,53,46,2,185.5,53,0,01201,1
b51a716cc62f32950fb483f5255e0ebd,125,78,2,437.5,125,0,04060,3
2a0579bc1824712f47bd50f9577a3337,116,89,1,812,116,0,01027,3
8bd2599f760530901a7275df59d63d11,19,19,1,133,19,0,10080,1
fab9b0c383671386bd052a516a85d160,154,84,4,269.5,154,0,01016,3
587d118f0b1ff200ae0af89c1ba8c481,58,44,2,203,34,24,05040,1
888388a919ade8e96e42672ea69459a8,21,21,1,147,21,0,01201,1
8379bf29e713b72e0a0f5e1de753855c,26,26,1,182,26,0,08090,1
079d894901cbdfcb9e53e466c89fa382,78,70,2,273,78,0,05040,2
f0cc2ae6c053b8c2c03757dc6f55e4f7,114,84,2,399,52,62,05040,3
cdcb0c9e6a19f72e9b60d3ab649cb922,52,45,2,182,52,0,01012,1
2a6d863d608552923f5bd89ccf19bb76,106,79,2,371,106,0,10200,3
7f56533cce6c2a9b6e242121b872695b,91,79,3,212.33333333333334,80,11,12570,3
1b7b91e8ad7eebd8dd44a06c228b5836,1,1,1,7,1,0,11040,1
e26a79b27e07b55e18cb996ccd485d81,122,77,3,284.6666666666667,122,0,05040,3
b3270ba30116abcb8c14a51d951955f4,32,31,2,112,32,0,01012,1
284940c7c03a7d1776c7631cdaf2ab12,31,31,1,217,31,0,09130,1
3fde58792e9b183fe34476b4bc0f29db,38,36,2,133,38,0,01012,1
0249d2531b3b8b566abf7ba16e05d5ee,607,212,2,2124.5,50,557,01026,4
8d9633b57c04750833e9c5bdbd2340e9,41,41,1,287,41,0,08312,1
ef522ec602644588dc072759a8829296,7,7,1,49,7,0,13930,1
ac0df733f1cbdf4e05481cc7d8266e88,15,15,1,105,15,0,08150,1
ed058835b8f700f6f5c4001c0f5adb70,167,147,3,389.6666666666667,121,46,06100,4
1422aaf16ecce54d8442e07fa6c1aceb,56,46,2,196,56,0,05040,1
0a3169d8b5ee51e1865eb6be9d858d6c,76,59,2,266,31,45,05030,2
bbb19603ed7fee3310440b556d4e9385,34,34,1,238,0,34,01026,1
49e89dec0f6633891c70473290853502,90,64,4,157.5,63,27,10200,3
a5ca38f51d07b7e31e18125d36916d6e,20,20,1,140,20,0,01013,1
ed46931169a1ba7ff48df6beda618730,14,14,1,98,14,0,12650,1
faa9dd42a5b1de421e3686fffb6a5889,370,104,1,2590,370,0,05040,4
ee966ccdfb6368cc17db18f0a65d2a29,84,68,2,294,41,43,08010,3
ee3b86446d9846cceac434c73bd2d978,28,28,1,196,28,0,08110,1
1e3a2419491ad4367a932e9f53c7c4f4,62,46,2,217,62,0,08051,1
984d7c061a0550e23c83f976159038f4,14,14,1,98,14,0,12570,1
356fd737ddc8366ff6e58b7712d3b202,111,66,2,388.5,111,0,04060,3
1c3dd7609ae5aa9c28225d29d7193a96,40,37,2,140,40,0,05040,1
724d3fd3342707906c18460e1ff30c33,130,100,3,303.33333333333337,130,0,08032,3
06936ae4c13d921a2318fe2670523617,130,92,4,227.5,108,22,05040,3
6df246b96111299f72e2d995622997a1,22,22,1,154,22,0,01201,1
4db51e55f40d8d215e7631f8699ff762,23,23,1,161,23,0,05030,1
b9f47272d7a545563db33c882575c44d,47,42,2,164.5,47,0,08230,1
4e14547163706524dbad996abe46212f,29,8,4,50.75,29,0,11040,1
d1573a328c9c3eee3c2273749837de3e,24,24,1,168,24,0,01016,1
f4e374faa80fafc8e670e7ac40966702,127,81,2,444.5,127,0,01013,3
1f1b11bdb02e2387321afe692359a02e,107,81,2,374.5,107,0,05040,3
f28d2a6bacda929559ba02e3d2c0f5a6,129,96,2,451.5,129,0,05040,3
dd7f8eaa3360d94d333af3928678a6d5,16,16,1,112,16,0,01013,1
4bb9516e950c6d34b645e0a96e46e7a5,22,22,1,154,22,0,10200,1
6476f55b552dc206a2ef0dbc58a395e2,36,36,1,252,36,0,08150,1
f8e82339395f17f53664eea02a1685e4,88,76,1,616,88,0,06120,3
c324a2775ff540ec09b28ee1783dfa2c,231,123,2,808.5,117,114,01026,4
66e5083cf233c496d7f199735fd4e7c0,9,9,1,63,9,0,09091,1
4204a1c8c47b50a96816559816e96fd3,196,69,3,457.33333333333337,196,0,05040,3
59ff0488e329c6a3c705624d740f3f99,166,114,2,581,166,0,01085,3
05e88ca9394922c53242c816738be25f,24,14,1,168,24,0,09030,1
8e023e4cb8551646986650e5639c7b07,127,62,2,444.5,43,84,01027,3
8926e0a5e0dbfef67b8b42429b02719e,334,178,2,1169,334,0,03070,4
01a21c09e3aa7a7b33f84b2906139031,23,23,1,161,23,0,05030,1
3c981421c5c63695479e87fae1ca75dc,16,16,1,112,16,0,05041,1
114c0111f61b15ee64572ea48faaafe9,44,40,2,154,44,0,05030,1
c426908f51b3163cf603f9918c82f691,14,14,1,98,14,0,11040,1
25601c488918ea29a52c581d0a2fb962,31,17,3,72.33333333333334,9,22,05030,1
de079f54478cc424450c0fb528065fe4,51,51,1,357,51,0,05040,1
42c87a91973bc46d8f31da9f869b13e4,386,135,4,675.5,386,0,05040,4
9865ac66469e33820dd09b187d08dd91,130,43,5,182,111,19,05040,3
90995532b7ab55aaa50858272b3369fd,120,96,2,420,120,0,05040,3
aaf58f705dbe3dca73024b499113e882,167,72,4,292.25,144,23,08051,3
7394c152c80da8637002c316797fccb8,552,195,5,772.8,552,0,10200,4
cba4ee79b50ae5e3bf596bc95115ecba,120,98,3,280,60,60,05040,3
b9ae48a119ce9f5ddd38347a93fccaf1,57,41,3,133,42,15,11040,2
8298e9487ffad7a1ae7e477bd6b0a6ba,35,35,1,245,35,0,01026,1
73ead9db6a91f055ff052cb4114c5a74,69,53,2,241.5,69,0,05041,2
e67ab91e0fb4014adaac3c60c129c78b,27,27,1,189,27,0,01026,1
1bb57e754a2b2136bf0aaffa5cdf0645,69,57,4,120.75,47,22,11080,3
2616c78bca52f4b6eae6d49d498ce5ac,313,101,6,365.1666666666667,182,131,01026,4
23ab1b71d652b9839c848c45780d1652,49,43,2,171.5,49,0,10101,1
0167b70fe0ab2d36c5950962e1bd5966,125,93,3,291.6666666666667,98,27,11040,3
75c414cbae96dca0dae7ea6ec888cca1,43,43,1,301,43,0,12741,1
7bdac9e3c81493b5391ab7b24645358a,240,92,3,560,124,116,05030,4
15bd6e17ee7356663daeb8959cbea054,92,63,3,214.66666666666669,64,28,01012,3
5c3d13cb74806b3950d1d6624da5bc1d,87,76,2,304.5,87,0,08314,3
c9870a03e1cebc21da1b30bcdce0f461,90,75,3,210,33,57,12500,3
ad9c67241a4649a98056a069205b7116,259,103,3,604.3333333333334,259,0,10200,4
2a51b903df59bacfb03cf05a8aaf0c54,53,46,2,185.5,53,0,01027,1
412de4563447e85e60ec4b04328faf6b,27,27,1,189,27,0,02620,1
85e18599f0441562c76fd0cab6ff64fd,165,96,3,385,165,0,04080,3
782ce4e52f0d9da210ece4512f8a352b,96,72,3,224,96,0,05040,3
f9c610b2f2a948e99a0f7ed5ea499cf8,77,34,3,179.66666666666669,58,19,10240,2
bbca056d5a9e09d7860a85d1e8fe1aec,347,132,2,1214.5,347,0,05040,4
285d422e2d3ad242ffe10b43fc41441e,2,2,1,14,2,0,08314,1
520c72480b57c26c20587e2e16bd60ac,91,74,2,318.5,91,0,05040,3
4d5263f85a6e7160eaec0094cdc19536,57,48,1,399,57,0,01027,1
5843e9bed81f39f1de943296e94c1f5e,137,80,3,319.6666666666667,137,0,05040,3
dfbc59c1b67d0a03e54848f2efe931cf,151,100,2,528.5,151,0,05040,3
0855aa9cee3b947d09474f93f6de795b,15,15,1,105,15,0,09010,1
1c5ad323db2775f2ecb83b78fcd83cbe,95,49,5,133,78,17,08010,3
0cd3eda33fbf4fc25994913c1fb7085b,30,30,1,210,30,0,05030,1
652467d0d295401ccc8e74ec9c3c5b42,43,43,1,301,43,0,05040,1
2a028b93c3e315d2f90c9004b20aa8bb,225,117,4,393.75,165,60,04060,4
66d1138843d7ea198d2d9a751e6b321e,73,73,1,511,73,0,01013,2
afc18e886fd2354dd6c3789742bbf1bf,430,102,5,602,408,22,05040,4
1fcc0895130461c08593fa0f4bce8aba,36,9,3,84,36,0,11080,1
0bf180a1799f97a3cd3cb85ca22c7a98,92,75,3,214.66666666666669,75,17,05030,3
8771b084f280e92b0a434ced18d53c01,26,26,1,182,0,26,01012,1
3ea16ff790d6dd8addd3707bd4310ccf,58,38,2,203,41,17,01012,1
745aa129d450d3bd7e157aea6868dccc,6,6,1,42,6,0,13930,1
4d13ed14f0354d2a4fec30a1140a4238,8,8,1,56,8,0,09010,1
fa85d912bda8bf0d7ef1086927912ed9,27,27,1,189,27,0,02691,1
7d01432170ead204c6d13bd55b0e4d8a,301,137,4,526.75,160,141,01012,4
b463275040a947cfde94900931aa7fa3,21,21,1,147,21,0,05030,1
9c9f30d7f0dbc2554c8a544529fed24e,92,61,1,644,92,0,01027,3
7ded67e0fd81ea59e25c4ad36774a071,120,73,3,280,120,0,04020,3
ce309da57649c7997f5b9b8d44e79a7d,58,58,1,406,58,0,01012,2
de36694ec5dcfc05618b4da3a5b288ec,50,40,2,175,32,18,11040,1
1b8fcfed3b1618dfd6deaa8d42c06255,600,192,3,1400,351,249,05040,4
7e44516dde50844f266232a13c50e46c,262,128,2,917,262,0,09010,4
4475be8284f8e1d1120b11a8b8e6a80c,24,24,1,168,0,24,01027,1
2335a89a36a6c96d187d9bb4153b2aec,21,21,2,73.5,12,9,01026,1
913648a88f44890dd7c055a52b37b3c4,14,13,2,49,14,0,11100,1
99d51cf54402a2316c5b7bac944b0d32,23,23,1,161,23,0,05041,1
2b5eab6f34599f09fd5ddcde4781abf7,23,23,1,161,23,0,09130,1
055f46f60219fe6153b3342461a0f988,17,10,2,59.5,17,0,10200,1
417e5f9509fb5d081bd8e2f88ec0dbaf,80,64,2,280,80,0,05100,2
d1ca30c3a71f1070cec379921d327b51,95,63,2,332.5,95,0,11140,3
42cbdef67681a6c3371abaac9b6c2c10,22,22,1,154,22,0,05030,1
cab94b3eba1b71341b7838fd94aefbcb,2,2,1,14,2,0,11100,1
d7006a3e18e11a440170edcdbf6bd2d9,158,87,5,221.2,128,30,05040,3
8fb650a546580de94fb26bef3bcfced1,125,94,3,291.6666666666667,125,0,01013,3
9eafa31b419616b48ba996a3250ab6bc,120,56,4,210,120,0,04060,3
8fadb2587a06d0863b6164dfdf0e5b40,56,56,1,392,56,0,03070,2
b189597f3c592404ea1af1fd4064c7a5,133,79,2,465.5,133,0,06100,3
6bb29b9899b388f677853300c8c62914,26,23,1,182,0,26,11100,1
4e76c56093b68021281ac88688dfa83f,45,45,1,315,45,0,05030,1
26e3fb6f8b688f64f7b585226900250b,51,42,2,178.5,36,15,01012,1
6687a4c1b0f3c4f6a7a117b81cb68337,89,70,2,311.5,42,47,01026,3
bcf787f70912df8a0254ab1f04fe4c0f,19,16,3,44.333333333333336,19,0,04200,1
d078b32d9c9ed394d731ba4d7a65efc9,152,86,4,266,152,0,11140,3
03db87842388b02cac90f74a61827674,26,26,1,182,26,0,09130,1
4eb141a145d95b9a1eaa8aa98d2fe7a0,67,41,3,156.33333333333334,67,0,05041,2
912883fe1db4ca825d37c4e388a5534e,301,117,1,2107,301,0,01012,4
552d4b0864f5c3f8db0cb658e023b891,64,64,1,448,64,0,01026,2
f94d0e04ee5113a103e9b0a626e89a75,81,65,2,283.5,81,0,10200,2
0c0d1f9e222c59a8edad17d73a34c16c,86,48,3,200.66666666666669,41,45,08052,2
ed1ae81b2f689b298c52853b74dd7be3,17,17,1,119,17,0,05200,1
9c0f41a31e1d31159f2f8dfb66b0b219,18,18,1,126,18,0,05030,1
8f11a7da6383c9fd4b880b5448539d8a,42,38,2,147,42,0,08230,1
1acf8aa8c6831883a9a2556a5e85608b,75,57,2,262.5,39,36,01012,2
4529612f1c621f907ccdaabe3da738c2,41,37,2,143.5,41,0,11140,1
21406c44aa5ee5107d844208e3147fd1,246,129,5,344.4,171,75,05040,4
79d59dc48f8048fa9fe06847c36da1db,7,7,1,49,7,0,08230,1
f1e6b7ecbe183e25506937064c1fea90,111,54,3,259,111,0,09150,3
4bb4c9875bf41c0f164dcfda15f4ba96,2,2,1,14,2,0,05030,1
ef95bf3f53405fb9ec72fc5dfe1bdc21,531,168,3,1239,493,38,01026,4
2d6b21985903419e3b6310da3ad02529,393,178,4,687.75,393,0,01026,4
5190ddc78abea127a00cc07561ffb563,222,126,3,518,222,0,05041,4
8f3a606f84ca3d9f499283b74e5df419,21,21,1,147,21,0,01013,1
e01feecaf064b54a9bbf4c524323a72d,38,38,1,266,38,0,09030,1
77ef8ed747a661309d2141c446887187,45,45,1,315,45,0,10200,1
a79b9f98a59df3917040369e20759677,11,11,1,77,11,0,07123,1
7dcff9a9609e11eaaf706693db438829,15,15,1,105,15,0,13490,1
7af53b01150dc40bc4a492acc5bf76a2,50,50,1,350,50,0,09351,1
1e7e75fd81728ebc0397adc1059960b5,726,192,4,1270.5,241,485,05030,4
1e2dd72cec4e5972cc85971b666451dc,8,8,1,56,8,0,05030,1
01119551e774d4d925728160270e3ec6,58,46,2,203,58,0,10200,1
af6030fb0c1038db260e703e536a33bb,132,57,2,462,55,77,11140,3
56f96b96e7138389c5a4774a9892be59,6,6,1,42,6,0,11100,1
f8ce16ca48e2f191af93e5e582d74273,1,1,1,7,1,0,05030,1
36e9f493bf43a4bd31d56c9be5bd46c1,64,63,2,224,64,0,09130,2
b45de3f03b5ffab841c464e7ee9a7ff9,118,71,2,413,118,0,10028,3
79eed243c8a82b1270198eb3bbc71f1c,65,65,1,455,65,0,10200,2
f06b822495981dcaf10293a24029cfe8,17,17,1,119,17,0,08390,1
0f9f712efbe33a1cb6d347f8d866214a,58,56,1,406,58,0,06100,2
b6116e106b9d276b787a99f8835ff8ed,25,25,1,175,25,0,10200,1
4812cb752d4961595850280a1984e1e3,182,125,4,318.5,182,0,01027,4
bea77d12a6cf979aaba3f9180ce552c4,20,20,1,140,20,0,08100,1
b1f0237b9f6524f0840b70c4eaa30240,144,127,1,1008,144,0,03050,4
b2f05e342cf390ea1bcfcbf88424c948,385,149,2,1347.5,385,0,01012,4
73fabfa65cb968dbf3fa13c19f872c4c,72,50,2,252,72,0,12670,2
49b34dc0384134c1df301da0e94692a5,184,130,2,644,26,158,01026,4
cfdb1874633a3951a058ebfb98c6e38c,34,34,1,238,34,0,04201,1
ae0a44d33c4ed7fd0e55a8567f0e1219,8,8,1,56,8,0,09091,1
ff254c518464f2c7283bff58d1086343,92,55,1,644,92,0,05040,3
9f876422c9f1158b823c85cc5b426fb0,46,46,1,322,46,0,11080,1
30cd09d2b3c8ff2e7ae49abf0b45c83c,48,43,2,168,26,22,13953,1
fa3d99ae5e524aa786718e96fab7bb58,72,55,2,252,32,40,03050,2
a4bd7c0818ae988e23cdb1761fc8fb21,22,22,1,154,0,22,01026,1
5e2012e6dca41a084d8e4cc8d8da24bf,31,31,1,217,31,0,01026,1
6ea2b9757d340a35bbe991cacf2470e5,69,41,5,96.6,41,28,05030,3
de122f5e0f7cd4efc955c4750abc1145,211,146,3,492.33333333333337,118,93,05040,4
6da356a00ddcdf399995ca7410c18b95,41,41,1,287,41,0,01085,1
a29a64668380ff3faa187b154bee9cf7,22,22,1,154,0,22,01027,1
85c6b34787685f9070396e6876a95a95,175,104,4,306.25,175,0,05100,3
c5acde3caddedf05207ab5a696c44586,25,25,1,175,25,0,02691,1
3d97dbd1d4b550a1cd7e9ae92075a82e,14,14,1,98,14,0,05030,1
7e21092e6f4c90a4e1097ec03b3ac8d8,26,26,1,182,26,0,08032,1
359c8e60fe4b02110fb076999389403f,36,36,1,252,0,36,04060,1
85f95e4bc0c801d58583e73a1e653d50,155,105,3,361.6666666666667,155,0,10200,3
63a65ac2916ebb25474e59886ab06aef,70,70,1,490,70,0,09030,2
acfd3281f8ed2f1e5db0be4f37cab95b,25,25,1,175,25,0,08010,1
7e792017b17e168d0993ce0111a82194,19,19,1,133,19,0,10152,1
95d13564775bd840c29c4f4d93189918,86,69,2,301,86,0,01026,3
98b1a6cb4a3069d4cf14abe634def48c,86,65,3,200.66666666666669,43,43,09010,3
2bfc48dee057d827441cc5829a7b5a96,9,9,1,63,9,0,05200,1
de609df6b89e6ee0b0381801a33e7962,80,64,1,560,80,0,05040,3
b34a88d2db60cff3f906a5a53501b637,23,23,1,161,23,0,02691,1
0edfb60a04766e1421414c27a4ebf09f,26,17,2,91,26,0,11100,1
f50d777101f5701c3b7ca1f8b3450fe6,9,9,1,63,9,0,10040,1
46b09184f4dd8a0afdb1f3d2f98a5310,112,70,1,784,112,0,01012,3
ec7b4134895182dffc2b25630e67ddac,289,141,6,337.1666666666667,252,37,03050,4
f09348dd040ece7b4a950b00e4aa4545,82,52,3,191.33333333333334,82,0,11040,2
9f65c50a0fa51d7b56410256d043f0bc,216,108,4,378,186,30,03090,4
ebac31eb4c9feb7f4595a2f873d421a5,17,17,1,119,17,0,07144,1
ef1fd0d7231eba6fa6cc872024ee6e0f,287,163,3,669.6666666666667,66,221,01012,4
c61167c2792f80462888d701da517e9a,31,31,1,217,31,0,05040,1
2070c4f94bf27791ad42b75a8c2d44c4,4,4,1,28,4,0,05030,1
741409694b8079df55816f559d347fa9,31,31,1,217,31,0,05040,1
f78c31ac1ee54c4218962269516b146c,43,34,2,150.5,28,15,01085,1
32259d60779949d8ef1d143f3e9b95a4,20,20,1,140,20,0,12500,1
c0e7f2cd67e8ae748f0017578845a68a,239,91,4,418.25,239,0,04020,4
74d43ef1bbdaeb80560eaaf9ce137018,70,59,2,245,70,0,08010,2
18caec80cda31bccc88d9738b6051b9c,99,99,1,693,99,0,05040,3
2a49067ab28c2da86a653a373440801c,23,23,1,161,23,0,05100,1
4f1fe7c3b8534edac8005a7c85515663,267,115,4,467.25,267,0,01026,4
1d6e289801c50a8c17b170b6c8b05626,21,16,2,73.5,8,13,05030,1
a472f58186273779c798886498cbe8df,206,138,3,480.6666666666667,206,0,04060,4
435f05ad2b462f8537fb5702db40fa96,68,46,2,238,68,0,01026,2
73876a24da268022512b8a0db29cd874,14,12,1,98,14,0,08090,1
22b616fdc0346191ecc386840540b8de,87,44,3,203,87,0,01201,2
960d3c54b8067c32f47e74046f254baf,12,12,1,84,12,0,04020,1
56af8c081ad7160798d12a1a84e00840,20,20,1,140,0,20,05030,1
4008d0280eab1345c733833819b999b6,117,87,2,409.5,55,62,05040,3
6fec20c3d2f7846ba98cd35015ff3775,89,63,3,207.66666666666669,89,0,04020,3
0820306a955b67df270537021d7296b0,82,62,2,287,82,0,01012,2
0029751b7fcfb4dd553d7155370c0198,28,9,5,39.199999999999996,13,15,05030,1
a6b25668fe827c2d2af9a3421fe3bf3b,89,77,2,311.5,89,0,08134,3
46655122b243a8b5e56bce80aeeaf10e,187,107,4,327.25,187,0,01026,4
f8411dab884be87b42eb1eb39e677110,31,31,1,217,31,0,10240,1
1e9c80c15de4046de7ee65ac1e9488ab,168,107,4,294,168,0,09130,3
5fef028196a0acbd73aea7cf6125c0a4,195,93,3,455,172,23,05041,3
d83bdac6e771f6143b29f0eb74cb99eb,97,56,6,113.16666666666667,79,18,01085,3
3c800638b988e0bd5be0ed2db70e0a55,80,62,2,280,80,0,01012,2
82dcf404f06d818830b5513f51c3af6b,660,145,6,770,595,65,05100,4
c810273fa82dbd2b7f7d616b96c099b1,182,110,3,424.6666666666667,182,0,01026,3
d61d1e9d6dcffccd0018403ac42cd438,12,12,1,84,0,12,08051,1
0ddcb384d8c15ebb9c7a0269c3743ba7,15,12,2,52.5,15,0,08210,1
332c3395ead91178297733f0599af3a1,65,54,1,455,65,0,05100,2
d807d114e34d221dc13a73a2136bf063,161,101,4,281.75,95,66,05040,3
949461f5e9eb9c6ac790a0181f4b5800,178,64,4,311.5,178,0,03070,3
fdb9ea660e5aef6bf42802120a60cb3c,29,16,4,50.75,29,0,05030,1
742cdd9faffcb1702fbd30827a14bac7,233,128,4,407.75,191,42,05040,4
3b217bbe87dad66abe93f14290871df7,32,32,1,224,32,0,08231,1
f08c7d212cc21335f8bde970c4db79c4,31,31,1,217,31,0,08100,1
71f25f8ebf4338d20d3ac9719057b348,197,97,3,459.6666666666667,118,79,04060,4
b887af87047af03d7628fe25c3f4d163,8,8,1,56,8,0,09130,1
febb1838852695897d43a37dfae3ec7a,32,32,1,224,32,0,05100,1
07745ab3ad670b090d3a15374fe1e3e8,88,57,3,205.33333333333334,71,17,05030,3
93b852710e4b4539b86845712286b431,57,57,1,399,57,0,01012,2
f000cd344aef9b6d68dc351b6d4cabb8,35,30,2,122.5,20,15,05040,1
c2b080c9f148d57aa4f806f85fe7ddf2,51,51,1,357,51,0,01012,1
875496aa131b73a1527d6febb0175a12,70,49,2,245,70,0,05040,2
2da87adc3647b18fe9716ab5c6b93682,29,29,1,203,29,0,01026,1
e657c1b497134e841080efd625f8330f,53,48,1,371,53,0,01027,1
9c144bc80c24e5486ac9e3c327f8a185,367,134,5,513.8,275,92,05040,4
b0dc8c29116d05bfd684b35ff7892916,85,58,1,595,85,0,05040,3
1877cae87617123ee527e099bef65ec8,20,20,1,140,20,0,05040,1
bafe8324d3d3aaacf60ed42bf28700b7,141,89,2,493.5,64,77,10240,3
e08305712abcc03d52ff855fc14968bd,263,146,3,613.6666666666667,263,0,01012,4
1426e4747c1b4fe55d8edf0a7b88b534,132,96,3,308,132,0,03050,3
d44ae2c1fcd8dccc9a6bb6861f4aef57,301,77,3,702.3333333333334,301,0,05040,4
cebef8cf1dc623c7c85c3a5d322d7d91,18,18,1,126,18,0,05030,1
002a19892cb891665ec0b77d3730f237,4,4,1,28,4,0,11140,1
062cb4b9c8afe5b5ac676458a237b650,243,117,1,1701,243,0,05030,4
bad72e13a9308235a326a93633727120,88,46,3,205.33333333333334,56,32,11103,2
a4703bb994aeb51f86a279408e80aec4,40,30,3,93.33333333333334,40,0,05030,1
cfd3371fe70f74d11093053184006a39,90,52,3,210,60,30,08134,3
8b8c907a4872e12146d4dfaef066417f,85,75,2,297.5,85,0,01027,3
bea3c76b232786649e6abb8b0219d688,70,58,3,163.33333333333334,70,0,10200,2
64eade16499db9c14236bced639942d4,70,43,2,245,70,0,05030,2
f8ba17c802d0d11a005da3b772c2a6bf,101,66,2,353.5,101,0,05030,3
3c320ed258b0b0ec7bebfbceab3c4a5c,203,112,3,473.6666666666667,203,0,05040,4
0a40558648bbfbe5012fbb184e3cb8df,28,28,1,196,28,0,10200,1
8d65633840043b52da246b778776934d,252,61,2,882,181,71,01013,4
0bda95ba4eb00e855efad64ffafcc75b,142,114,2,497,69,73,01026,3
a862b18afc51473084f703fe1f77b849,103,73,2,360.5,103,0,10200,3
3c23031c181e3b4ce041ae66b4f12b36,126,91,3,294,71,55,01013,3
8848376673e05998f7374c5b6bb07276,23,23,1,161,23,0,09130,1
51d509ce241147ba3adcbf857ca9ae24,29,29,1,203,29,0,02620,1
8624731b35eb7d2aea5f0460f40fc7b5,24,24,1,168,24,0,01085,1
6c4440ac4218cbf8d9590a67340e1a7a,164,77,3,382.6666666666667,130,34,01085,3
79dac47464cefe6dcf782abdaa417a51,119,67,4,208.25,94,25,05040,3
f89a8dccdc03ef2c487a2d09c277531d,41,41,1,287,41,0,03050,1
fadc3df601ee4d3548178972676fcbf1,257,81,1,1799,0,257,01026,4
d832557c11c15ad120990ccba4b93431,10,10,1,70,0,10,03033,1
3187b7c10260ec4d841be8b94eb213f3,47,47,1,329,0,47,05040,1
c44b179dd5ab9b0c4df95ada4cd92a07,15,15,1,105,15,0,02650,1
3a3a9298fb876ff1d976140c184c28da,51,51,1,357,51,0,10200,1
2be014bb1ae54a9372fba45b8f983125,29,29,1,203,29,0,01027,1
f20e0c971dcaf0072b3e3f989c1eb15a,31,31,1,217,0,31,05040,1
021444327a21e32bde4c6513eaeca892,87,52,3,203,66,21,05040,3
3b9006cdbc85e0bd04ce77766bc12b8c,103,66,3,240.33333333333334,103,0,01013,3
548960c6550321f9e8b4810cdef22c19,159,87,3,371,159,0,02756,3
dc461482667a656979e66616e8dbd91d,44,34,2,154,44,0,08051,1
153f46c4f24433622f22314ba0efe171,154,88,2,539,154,0,02751,3
6369e00796ad5379c71a933795217593,11,11,1,77,0,11,05030,1
5535034ed99df7ed9485da12698741db,55,45,2,192.5,55,0,01012,1
dee0f1f295e47f9e51f73f645538244f,45,26,2,157.5,16,29,12430,1
ef4ad7578eb600641263fdccfa6eebfc,44,34,2,154,44,0,05030,1
9ecd8479a9a8f555e4442dfedb526c74,19,19,1,133,0,19,04060,1
ab9502188d0780c1598f3fd47da6e8fd,29,29,1,203,29,0,02620,1
8cccbfd745189561d79dec78bed050eb,116,87,3,270.6666666666667,86,30,05040,3
7fbfe8e32a43ae313e3ab347c8aafda5,32,32,1,224,32,0,01027,1
0819fb743fe2f9efd122f0a98b5fb52b,53,48,2,185.5,23,30,05040,1
be70135b269116d78337beada8372356,28,28,2,98,1,27,04080,1
4759a62ee48e0f31a455ea9d84271c7a,16,16,1,112,16,0,05040,1
e19d048f5be66261064ed7eafa309d7c,218,156,2,763,151,67,05040,4
d9d4353b8be6979cac67378c993c3ad5,22,22,1,154,22,0,03070,1
7a6c60177cac9956bbbb452438e3fa1d,47,35,2,164.5,47,0,10240,1
01dd91e8bc8ce8aa6215b98c997616ab,63,54,1,441,63,0,04060,2
c534cfe63ddab2d3a52b545b2a17db4b,19,19,1,133,0,19,05040,1
cfea0f6bfff628eea314947d8da7eec2,44,44,1,308,44,0,03070,1
60087aed9edb6c92fb7fa178f20801f9,16,16,1,112,16,0,08032,1
d3be38b7cc0f0a2bd9e8c824c73e4bd2,132,96,3,308,86,46,01026,3
c1cf9c199a61250fdfd7a5c36019b150,138,85,3,322,138,0,05030,3
5867ddbc12e4418a6523d2ab663d41b8,38,38,1,266,38,0,01013,1
1149d137f56ea9c8b38190b035ecda05,31,31,1,217,31,0,09131,1
18997cbfce4567c3c570db56eeda323d,44,41,2,154,44,0,11080,1
811b119853550b3cce5e8932d8d8f78a,137,106,3,319.6666666666667,112,25,01026,3
dff7de478104d9a7acad38d308b7b57b,203,111,6,236.83333333333334,129,74,01085,4
efe48c78876e90fe08c6ceb4092dc292,276,137,6,322,230,46,01026,4
6bec136e20cf49b5544a58ac05d51d44,79,66,2,276.5,79,0,12500,2
136499a0a620c2f1bf6e851c4eb7463a,89,72,1,623,0,89,05041,3
f02c1ee13723b0855e3500c1b5aa4767,56,44,2,196,56,0,05040,1
a676221d1820809bfc939c56675a051b,22,22,1,154,22,0,05040,1
46e0142c3dacd111f88d830075766775,79,79,1,553,79,0,05100,3
446a454f52a34488abf6db1f651d45d6,48,48,1,336,48,0,08010,1
144808b0731dde53f6f6efffcfdfc8fc,72,58,2,252,72,0,10200,2
509c99a5f1d82acedfe08d950bf17eed,130,58,3,303.33333333333337,130,0,10200,3
43118b6a3f1092ef7f1f812e69a246ce,94,84,2,329,94,0,05040,3
00b54625083cd831dc93fb05bb492394,3,2,2,10.5,3,0,10080,1
26de38750f132ac3de74de4a9aa8c480,267,109,5,373.8,236,31,02691,4
1df04c67ae63aa885ac2d2f55ae1ef99,74,58,1,518,0,74,09130,2
fd0d619d340f8ed7c2da86b261306f0b,97,65,3,226.33333333333334,71,26,05030,3
7287feb39ac6684574b0047480140cae,27,27,1,189,27,0,12530,1
91e803d8187b2723f44c61d6ba0827a2,55,43,2,192.5,27,28,05040,1
d4cc23ab2c43e04f7264bc6f1906ccbf,16,12,2,56,16,0,05030,1
be889e10761989ccecaec96690911b35,38,38,1,266,38,0,09030,1
e44db964fc2304e0af14178225456d46,135,88,3,315,92,43,01085,3
24eea98cc466665c5cb254b64b90cd39,22,21,2,77,22,0,13830,1
575498f7207b7d4d216a3611db799624,7,7,1,49,7,0,10101,1
a68b60cc384b7a25a26c70ff47a84e08,20,20,1,140,20,0,01026,1
97e397896eb7d624b9a4a9abfdb4f483,16,16,1,112,16,0,05040,1
196613ae2b2f2f1a9c053428683ef03f,32,32,1,224,32,0,01027,1
e3e16361d970defb9d3d25d9b3b4cc18,23,20,2,80.5,23,0,03070,1
9250415514cc261e2ebb1d2b3f07f8e7,77,51,3,179.66666666666669,77,0,05040,2
f47d2de2726d03cb1e3c335a23e5f18a,17,17,1,119,17,0,01026,1
150114e975218d13337dd012c54f69cf,33,33,2,115.5,17,16,02691,1
25d136bf024b90bd1b4a4f88ff335082,34,34,1,238,0,34,11100,1
5f7138b28c0e94237bfd5ddd27399d2b,9,9,1,63,0,9,08230,1
36677bc83a11ca89d2747c6db55d742e,398,178,4,696.5,323,75,05040,4
916fb3cf12dd901ce5010f87debafcd2,149,106,3,347.6666666666667,70,79,10200,3
eb07da8535bbface3ed4e9a0fa82b3ab,170,46,2,595,159,11,01012,3
899753b34bd3b85078c0803899017a6d,38,38,1,266,0,38,12570,1
5e877a6649a6ca36bd5fdab0c21e2bf0,98,70,3,228.66666666666669,98,0,11040,3
57e5ef8d9e6034e43913365f6b742124,22,22,1,154,22,0,11100,1
918cd53585c86886b62190dbe20ddfc4,81,74,2,283.5,49,32,01085,3
12bf05f2b1c5ca82e2b244da90c3775a,103,103,1,721,103,0,09130,3
05bb884b06482ec083c82c342c7e4808,604,241,5,845.6,507,97,05100,4
6a18975d1619c91de62e464b672d8928,62,62,1,434,62,0,10240,2
54ad4b8ee51762bd90b2aad459349848,111,91,2,388.5,111,0,10200,3
b9ad1ea362d844e928df3e57ec09b9c2,196,89,3,457.33333333333337,196,0,01026,3
10dfe7a9ddfe6f2737cf37cfdae57aca,124,83,2,434,124,0,10200,3
b717f3f21b3ab444dad2aabf8f22fba5,61,56,1,427,61,0,05030,2
48ebf44c09909bfdbb32a74d62a05736,175,96,4,306.25,175,0,05040,3
d80aaf286e30827b910701d1f4357b5e,28,26,2,98,11,17,09150,1
53d7802614186e25bd03a912cbee9d0d,103,74,2,360.5,37,66,05040,3
dbe89f45af4c7202858c772c49faf22f,47,47,1,329,0,47,04060,1
07ccff1646e071c46ea0b85cdc7b0b41,18,18,1,126,18,0,09130,1
e1be4d50e7a8004c26bbefe13d628cab,125,86,2,437.5,71,54,01027,3
fe6e1abb8460782bdb374cd3ec87e0ff,180,91,4,315,141,39,10200,3
82c68b9ff706861cdc3cdce1c0a01b32,50,35,2,175,50,0,02650,1
229958b7c1e6e9be82a5dbd67d916639,163,123,1,1141,163,0,05100,4
46d933e6293bc6c57539853abdcc9b68,28,28,1,196,28,0,05040,1
80eb4a9165d1c42e38b7160ddb272a54,54,54,1,378,54,0,10240,1
6ba975ecc4f603a32bcbcd64a0aa8c06,5,2,3,11.666666666666668,5,0,11040,1
beb6d1b9f4eb5acd8999a350ff91752f,78,66,1,546,78,0,05040,2
d5cbfb1fbbb0ab14985c052d1c0fcebe,550,177,5,770,202,348,05040,4
602b6089c20031ce5da9be8e8abc4c44,221,154,3,515.6666666666667,135,86,05040,4
f0b714ec637c3a73b933a20f87a03b77,52,45,2,182,15,37,01026,1
b1810172ed03a5c6415ca7b3b6e9d796,296,151,4,518,244,52,09030,4
de0338dba73377ee391badc1f3800c43,19,19,1,133,19,0,09130,1
5f0ce98abefd14c99075fe0fd6c0afe5,71,58,2,248.5,71,0,01085,2
eb21a2b39519b03923bb9f34d8538734,27,27,1,189,27,0,04201,1
6a03762a516b526da04cac811a302b2e,54,35,2,189,54,0,01012,1
26e0a085728a7e0c9bc1c25663cd5d4e,2,2,1,14,0,2,05030,1
10592e292775c5f1358c724c72de3b60,134,84,4,234.5,134,0,10152,3
b65f97e2ebe5c02a150b4faba24aeec3,8,7,1,56,8,0,05030,1
a9106d5297b55da83f35035e38377d93,30,30,1,210,30,0,01201,1
ca49f58aa36a26bfddb69c6dd50fa226,18,18,1,126,18,0,09150,1
46cdfbc705810278864ffa8f31679d1b,62,49,1,434,62,0,04060,2
8c36c92f14cb5271551703e015a89eeb,129,39,3,301,106,23,10080,3
024be805fdb152a0d6da8e6ce325e949,84,67,2,294,35,49,05040,3
55e460ad1726cc1fae084cbf084d2329,27,27,1,189,0,27,05030,1
4bc207e324d72cc795e4f4b772d9ddc1,289,106,3,674.3333333333334,272,17,10240,4
133b3f51c3a44017e830e05cb1a95b52,40,40,1,280,40,0,01026,1
14002287baf784dd06ce9665779b4477,91,68,2,318.5,21,70,05030,3
cd0808bed617524b95503391c4195603,99,83,3,231,73,26,01016,3
3e3dda0afd1a5cda0eee130cd1dcb004,48,48,1,336,48,0,01026,1
416946f3b89e6e36d78a45055dc58fcb,53,48,2,185.5,53,0,03050,1
50315157150279d2916844fe4adca981,420,131,6,490,396,24,01012,4
6f911b8f4791ed58302312d7e408b9af,16,16,1,112,16,0,01026,1
abb01930ea77cc738aed1a9aeb6a4d2b,16,15,2,56,16,0,09090,1
f5727a31025ba8f0e5331b567bd231c6,300,114,4,525,211,89,01026,4
157edfa9d369127620e192ef1e1b7959,31,31,1,217,31,0,05100,1
b544eefc0bb70e08b295ad6f62ad7cb1,15,15,1,105,15,0,05040,1
b32f88b6f8f3bdbbc432469d736558cd,15,15,1,105,15,0,01085,1
fb6d92d0e6a142253c7820f4d93467b0,310,147,2,1085,76,234,01026,4
d85b34506ceadfce98fb047d6b534a3e,115,73,3,268.33333333333337,54,61,01026,3
ba85ae76f8bc22af961f5c953bb44be4,60,42,1,420,60,0,05100,1
9d44099297027fca53d685587694da4c,105,78,1,735,0,105,01012,3
a7f6f95cd8ff4801ad836298af6c3d82,52,26,3,121.33333333333334,52,0,10200,1
fec55e96a1393d70088e9f8981aa02dd,58,58,1,406,58,0,05040,2
a5d91e2d7069f56bac58002923d1bf93,27,27,1,189,27,0,01026,1
566e3b69b8438312886b6cd900f7da94,6,6,1,42,6,0,08100,1
b10e483d30df075cecd40e484a28cf34,60,60,1,420,0,60,01026,2
c166acb305f8fe5184cc3f0fbd4c70b0,33,29,3,77,21,12,01026,1
f26303b2d022a09447adafa71b428b01,85,65,2,297.5,85,0,01085,2
ac6735ccef1f024b8ecfa65e49fc573b,18,18,1,126,18,0,10200,1
91245e4d6d8cd7ff1a28b8c1b5e80634,163,77,6,190.16666666666669,136,27,01012,3
0d714b537fef8294cd3d1504459915b6,75,38,3,175,75,0,04060,2
8d881b4a19f1e117ec338674db9232a0,120,87,1,840,120,0,05040,3
a9314013c00ad575e6531ae14ffda31f,36,36,1,252,36,0,13877,1
b0b4ffe3a64714c1fa85a60cabad0315,80,61,4,140,62,18,05040,3
bdfaba633194183ba7522179480f0d8a,16,11,2,56,16,0,11040,1
deb65dc825b957d9c6e3eb83646f2cb6,233,92,4,407.75,151,82,10028,4
8a4de50bb73ac5cd9d3c72271af581df,21,21,1,147,21,0,09131,1
055ca05c7a3744e4f4928f4a820fe262,51,45,2,178.5,51,0,02651,1
41c397cd5729e918f7dd267de7bdcee7,141,85,3,329,141,0,05040,3
d9547fa9d7df311355d038987db0dbc4,172,78,3,401.33333333333337,172,0,05040,3
42eaafaded124f16684c69b24772bf22,21,21,1,147,0,21,02756,1
bad4c5d90b8e5f65a9b47ec787ccf0bd,110,79,2,385,66,44,01026,3
dab265dab092a862a603f5a8cd4f6c01,204,114,4,357,204,0,08032,4
46c9f19a5a795d0df3a7defce4e25a9d,21,21,1,147,21,0,08051,1
95b768b296a8b4ca22339cbfa88d8bee,558,174,2,1953,558,0,05040,4
620ca967642dc62f7c37974018dfcffb,19,19,1,133,0,19,05030,1
653c70aa46c3990ab846f8a52fed4c78,32,29,2,112,16,16,05030,1
14297408ea8e8390493aa52d57b11003,67,50,2,234.5,67,0,05040,2
75110c0189a8def1e4b0084c294d88c8,4,4,1,28,4,0,03090,1
970776008d1bec8507b4273916400c98,46,42,2,161,46,0,05040,1
c0ea51be997250c099309442b7a5ea6e,14,14,1,98,14,0,05040,1
1039ff0356f08de4bf7b21fbd9cb70f5,83,53,3,193.66666666666669,83,0,10200,2
62eec52226db4f2379b36cfc9ea7e8cf,115,56,3,268.33333333333337,115,0,04020,3
923a8c53b235d3b010b0f9c3ec0c449b,104,79,2,364,104,0,04020,3
92e1b6954d005f3ab15110451d6e4b59,270,111,4,472.5,208,62,05040,4
cdc3d4b3d59ca2a1e5ad5f5636ad2a32,147,120,2,514.5,71,76,09130,3
83378c10b5feb25b629b660cba805e2c,111,78,3,259,111,0,10220,3
4516efb256ace818cf9d44318062178c,20,20,1,140,20,0,02756,1
500c6aafa9a0fc5effbafab748f969f8,11,11,1,77,11,0,12570,1
204f0869d8f2399ef208debd3b7f5585,78,49,1,546,78,0,02690,2
3f4e4e3f4b7a8468af14cc97ae36430d,18,18,1,126,18,0,08132,1
1ba33a19d187ef4e53d8c21c28fa6fc1,17,17,1,119,17,0,01013,1
bdaf4d21c0774fd6fa374095ada2af30,238,87,5,333.2,238,0,11040,4
e354785a598eac46e4d141f710dfb92e,59,56,1,413,59,0,05030,2
136c4459dd23e2cf2fffd42177384814,313,143,4,547.75,169,144,05041,4
323911b23337c1a76ed0d7cae6aeddc3,23,23,1,161,0,23,09130,1
cf65df2a51ebcb45668037371d230cd2,29,27,3,67.66666666666667,29,0,03050,1
2e72dcd36cc156d0bd02c0e0ea9a6ef1,70,60,1,490,70,0,01012,2
9c70aa4a4c1db7e98de14178fccd5221,155,48,3,361.6666666666667,155,0,01027,3
4318d634af7d965c636cec6ac24da28d,47,38,2,164.5,47,0,02620,1
69f9f6e9252ffb77553e7b089a183f40,14,14,1,98,14,0,05160,1
11fc67ed7b97a98629641788c61c64d3,2,2,1,14,2,0,05030,1
331ad116b2c199b043784db9f2164e7e,13,13,1,91,13,0,01013,1
e51024b974c448c50f20b1048a5ed793,32,32,1,224,0,32,01026,1
9ac9e2169cf26d50ec09bb0ffc36bf8e,37,37,1,259,37,0,05040,1
cda4d1fc0006adfe28e8012cf52fe5fb,456,198,4,798,414,42,05040,4
d0ec6ad242e29f8dec3d91a9211c879a,87,61,2,304.5,42,45,09130,3
056f28409b3327c276c3abfdcd9c5942,82,36,3,191.33333333333334,69,13,05040,2
f25351013dd0575dade446f36447e1cc,17,17,1,119,0,17,02690,1
fc3c8182b16b0efe191c4d6701b5972a,22,22,1,154,22,0,01027,1
53ca0f5007f7e3e5c01c3bb1c7cb98c1,45,45,1,315,45,0,04130,1
62a1c92abff6d316e27c0c8bdd792fae,252,115,4,441,252,0,10200,4
c01e99386f64e441c92657f588915407,40,40,1,280,40,0,05040,1
6e47bec2bfd6176f84cc03e3b979044f,44,44,1,308,44,0,01027,1
decc30b2ceaee8b705bba62493093f9c,166,89,5,232.4,133,33,04020,3
862a55d2965f2cf7a6e2e3d2a640b46f,42,24,3,98,25,17,11040,1
829ff3f6ef5806657e46c7029df345fc,144,51,2,504,128,16,11040,3
a66103a599d361046f098e52a201dbb3,19,19,1,133,19,0,12410,1
b4aeee15a3ea721c855082e52ed53b4b,24,24,1,168,24,0,10200,1
2f7eb8cd2ed418d202d89a10b3db3f41,2,2,1,14,2,0,04032,1
fe3cbc6dbb7627b62cecf30bee9bbfc3,53,45,2,185.5,53,0,01026,1
24f2620c684130e4ff47914ed0fca17e,157,84,2,549.5,157,0,05100,3
5379611937673409abbbc23a0e43f979,3,2,2,10.5,1,2,11080,1
c87ab4df923152b54483cd2dee0fd42c,26,20,1,182,26,0,10200,1
63cc07fbe7e222d0ea664b0b1dc737f5,28,26,2,98,28,0,05040,1
dfcb980514324bd0c07bbd10f71768c8,136,92,2,476,136,0,05040,3
54403cd72e2225ef5a6e91e4271c8203,197,88,1,1379,0,197,01026,4
2ba200477f27b955193db088ecb6eff5,134,93,3,312.6666666666667,134,0,09130,3
40d9034bfa844082d86f507845c32710,17,11,3,39.66666666666667,17,0,05030,1
d199c7339434d40672e57b4247244e12,39,32,2,136.5,22,17,12590,1
9a4b2d0ac4ff88cc53cc0236c4b3a4da,26,26,1,182,0,26,01027,1
34ea4633a153b0ec14405bb2cc416da2,14,14,1,98,14,0,04060,1
520b680e176869e5f53c65e0e95b34b8,81,59,2,283.5,33,48,04060,2
8f438fdec0d2685a26763acacb75c716,27,22,2,94.5,27,0,04200,1
0e8904daaceed26db2f83966786b1892,61,34,3,142.33333333333334,46,15,11100,2
ab6a3a8264c0637b480133c9632196f2,44,44,1,308,44,0,05041,1
9c7d236d5fe50308d176056a94f4c926,19,19,1,133,19,0,09010,1
06531b8a8633ddb370a0c12cae19c618,70,54,2,245,70,0,05040,2
8a30838d6aced1d38a10de252f72527f,42,32,2,147,42,0,05030,1
b6b7b94224b342191ddf563828aea1fe,64,35,2,224,64,0,08250,1
5396aabbb93f6517e0bc6567654c57c3,21,21,1,147,21,0,01201,1
1fcfa9c0b1d5d13f54166b550a3e0cee,18,18,1,126,0,18,10028,1
a79fb6079755ef968ea19ad29cabfc8d,6,6,1,42,6,0,05030,1
206063da3be5ed8c74ea950dd7e1a8dd,18,18,1,126,18,0,09170,1
0dff2029223a4a7f7d11ca471b0ad6a5,81,53,3,189,65,16,05040,2
08bf7dfe45331663cd535074a5d64e91,32,32,1,224,32,0,01026,1
c5e671ec943868e1a2564bd5b761490b,63,53,2,220.5,63,0,03050,2
d513a8b7ed400e7d819754384d50c2b3,87,66,2,304.5,16,71,01026,3
653d8c6695a285327cae3907f2f39494,22,22,1,154,22,0,01012,1
7ef70d3e2ada3b0802af6a016aa460f2,162,109,3,378,102,60,04020,3
215e1c13320d18ad5061b444b97de2db,220,125,3,513.3333333333334,133,87,05040,4
5185735739c98c397c76eb58e96110ac,829,235,2,2901.5,65,764,10200,4
c93ac4eca15ca071fa0c51e68854f79b,96,75,2,336,96,0,05040,3
93ea7c5e719f8ffb6fec082543f9f90b,37,35,3,86.33333333333334,37,0,02691,1
8184d6c77f14a33e574d4d4e12162b3e,29,29,1,203,29,0,05030,1
0f99d785c237dc806cebf343229c9400,74,55,2,259,74,0,01013,2
caf785acb8cd6c2b5a1640af8bedd94f,57,42,2,199.5,57,0,01027,1
20ba8c02db8cf0fd8f576b014b2b78a0,247,125,4,432.25,139,108,05040,4
7c9a14b1249c9a66d8266603cadaeb70,42,42,1,294,42,0,05040,1
f8a5d253a1fa1f53313b64d765f6fafb,271,141,1,1897,0,271,01027,4
5b012bb7752ae8f889e06f1fd4d71f61,81,54,2,283.5,81,0,01026,2
bd968ce9328fb2d5499df65c5b03b047,15,15,1,105,15,0,01013,1
5bf5f4d2a15cb33a9e89f5aa1afd37cc,27,21,2,94.5,27,0,01013,1
7bb40e6d4f248dfbdc8b28ca15f83033,118,66,4,206.5,75,43,01012,3
333d127cea37c8620e27fc63b0305c66,114,114,1,798,0,114,09130,3
56d7141dda9cdf19187d14a90e292ed9,161,81,2,563.5,161,0,02650,3
0ef999bea5094c46f0a6a2ed7e2ef8e7,29,29,1,203,29,0,08032,1
c31e29d206a8ae87f4e54868c3f2c068,326,103,2,1141,270,56,05040,4
9f235cdff5d2ed920b5d809e1c45619d,288,128,3,672,288,0,05040,4
743803db3312132fa46fec55c0b44d0a,159,129,2,556.5,159,0,08090,3
7ab0a4fd6c0e205c8061cb9282cac511,271,91,4,474.25,201,70,05040,4
cde4562677d2322f5c0782c32c1f6ae5,65,56,2,227.5,65,0,05030,2
9462d534b6f02354f2abc736d0fdd466,74,68,3,172.66666666666669,74,0,02650,2
d178ae091b12e71ba1991a677e2ebeed,7,7,1,49,0,7,05030,1
098d7cff26b5bfaf146b08bb63e8c21e,80,47,3,186.66666666666669,80,0,05040,2
4fdb191528bdfa27283824597069004b,23,23,1,161,23,0,02751,1
1a9207fb63097d61f2e6817508c81fce,6,5,1,42,0,6,11040,1
f5986473698617077334c0a5cfffb9eb,198,96,2,693,47,151,05030,4
db45b15e1f56f191e7ef07349fa2d6a0,214,85,5,299.59999999999997,214,0,05040,4
d29dfa65397045bfd9874ab59f9a6952,65,58,2,227.5,39,26,01012,2
ab9b859a7a737c2d483f7ae1507e6846,254,122,4,444.5,103,151,04032,4
12508ca41ff843755ef820d9a21ce726,80,60,2,280,40,40,05040,2
27d76b388ffddf08aea1ba4dd9d5f30b,51,34,2,178.5,13,38,05040,1
1416758510ac60230dbed23ee62f0dac,50,50,1,350,0,50,09130,1
a9d64cbd583d2dc72d23f85cdfbe1006,76,61,2,266,45,31,10200,2
c37a9945238d15e963fabe9e1a357665,98,72,2,343,98,0,10200,3
5a01be7739484116046fbf5323bb73fc,147,70,2,514.5,11,136,10153,3
76546fa73599451e86f8f7c4696ebcd9,339,147,3,791,339,0,01012,4
7d3ebba20c22388fea134ec37aa70465,42,26,2,147,30,12,10141,1
e208d18dd789089ab2e249ab23d46d98,62,40,3,144.66666666666669,62,0,11140,2
2b661d953e96cef7ed9d0fbb0601bfbe,58,43,2,203,58,0,11040,1
fb33933e04570e6f8a844388a06f2110,16,16,1,112,16,0,05100,1
9d68e925535a8fc6944d089a26f25305,2,2,1,14,0,2,05030,1
e662864248a7c0a3d3ad675572e822da,66,59,1,462,66,0,09130,2
75bfde4dc6ea46dc8e1296e099be7463,108,89,2,378,59,49,05040,3
4027a4f138cbadfcadbcd63c3273c2e4,108,29,1,756,108,0,10028,3
b7b143bca6536fafc4b8bcad0f538104,128,71,3,298.6666666666667,85,43,02620,3
0ccb2b0c01d712da16b4b695c396bbdc,33,26,2,115.5,33,0,08312,1
272b6914889418f8928203ae960975bf,15,15,1,105,15,0,05040,1
6f9632f3a284859e0c4a3b4bec0f4237,64,42,3,149.33333333333334,64,0,01012,2
c20476fcb6623fad21dd1e8cd29f4dbe,133,100,2,465.5,96,37,05030,3
4293e19096f415d22216c55e2f96c4ae,156,79,3,364,56,100,09150,3
2c10e649f528356eef5ccfc7ae1603ef,12,12,1,84,12,0,05030,1
b8c20e48a7a69bcebc2779c0675ef09d,52,49,1,364,52,0,12670,1
138a6e2b5f5d8da37fec3d151c6f87a2,224,108,5,313.59999999999997,176,48,01012,4
5c29a7f307c9f708af079c2dc4b1ef23,191,108,2,668.5,191,0,10200,4
c533f974da1307340e384866a6f2b691,168,117,5,235.2,151,17,01027,4
644d2f94cc1c1ffa40765f6d04847225,53,50,2,185.5,24,29,05030,1
3878e00be9e8a7a2b470d6fcdc1d07d4,154,99,6,179.66666666666669,150,4,11100,4
c31fe01b5084fd7e273bc0cdf5a3d160,85,45,2,297.5,85,0,05040,2
3c1c981ad44655e9d6e8093666d505cb,30,20,1,210,30,0,11100,1
43171ffc2fada02e5c0a42f93320a33d,21,21,1,147,21,0,01013,1
420b829e334805e2747658bbfca0429a,1,1,1,7,1,0,11040,1
a6691b0d15117be3606ea5980ec65f67,40,40,1,280,40,0,01026,1
18bc3a5361185ebdfa7541f0b7242d7b,21,21,1,147,21,0,11100,1
44254f5f7d59c83b04e16ce50e6ef21d,9,9,1,63,9,0,12430,1
03b6193bfa268745f0b008025abe189a,111,63,1,777,0,111,09130,3
e3119a0c3416698418c3935efbfe06e7,103,103,1,721,0,103,09150,3
bd5239d64513e861e2be068c6134f3ea,77,43,3,179.66666666666669,56,21,08031,2
6ca8a5ae65d132d9cf90b5bce86f8a33,15,15,1,105,15,0,05040,1
16882de9d1d2b5e8b73753a1b8b62ae0,85,70,2,297.5,85,0,02651,3
d12fd60e680402164fc426fbefba1963,24,24,1,168,24,0,05030,1
3aedb8093554abfcd478bb919d2cafc9,46,37,2,161,46,0,09010,1
e712c96b0adb1242c8f8e825f5389945,51,51,1,357,0,51,05040,1
8751c8328c83f80e57d4e0ce1b6dfe65,262,122,3,611.3333333333334,204,58,11100,4
3c279ce4925285585b38d54d35973bdb,143,90,4,250.25,143,0,11080,3
074d307272e8af9a626206620cd70272,235,97,5,329,171,64,10240,4
081ead9b9d6252c24a80f3598d7e10b3,63,41,2,220.5,31,32,09130,1
77d8d7b0d4cad6d2102527d86abada61,41,33,2,143.5,41,0,11040,1
36b4ce46fbbe52f9e0d2f10b09d0db64,32,32,1,224,0,32,01013,1
0cc21fc36cf3878b677a9d2ea58f8f9f,15,13,2,52.5,10,5,05030,1
c4eada4df0bb08f316754af0172c4104,112,50,2,392,21,91,05030,3
68cf6d0f02b518e0869e7d2d4f76101a,160,92,3,373.33333333333337,160,0,01085,3
c095187d9524b7f61fbf93bda81f0157,111,85,3,259,111,0,01027,3
1a6b9e25f65b96f58778c46c2a9cab85,478,155,4,836.5,317,161,01012,4
4ee98fcf9ba1e2b3759b9dd0d5f1c6f7,19,19,1,133,19,0,01085,1
1d4e7cac9c7d6618ac724b27247bf71f,28,28,1,196,28,0,09130,1
e7f65e91ca63b37d19b7aa93070ae752,22,22,1,154,22,0,01013,1
fbb0464fc41df8379c5a7052f8f60173,14,14,1,98,0,14,03050,1
ce0d113497db49f2780be98ec7583f35,37,37,1,259,37,0,11040,1
92de7d6651b0a349c8ad7eb23605de2e,31,31,1,217,31,0,01026,1
2013e61a4ecffebde05b347cc1a3a042,88,64,3,205.33333333333334,88,0,05040,3
25a1659bc6ac070b617a8e0632426f87,229,101,3,534.3333333333334,229,0,01026,4
7eb694c0c204cca31e18501d8e8e1929,29,29,1,203,29,0,11060,1
86b1a6ec124402af362061475cf5057e,27,27,1,189,27,0,03050,1
034d61b236390d71b99935bbfe3cbde6,94,94,1,658,94,0,11100,3
e9a6e03c90cdc1d9a562dde3a349f824,104,75,3,242.66666666666669,104,0,03050,3
abac8f00adbee5586e21cd527f54cb13,43,39,2,150.5,26,17,01013,1
1b2feab597c5575dbc965249ac2d7a8d,30,30,1,210,30,0,01026,1
aff5532fc355a4fc6715764d76b4c732,38,38,1,266,38,0,11140,1
563de343535178de02d810d6d76ac121,131,66,3,305.6666666666667,131,0,05040,3
7dc644217f3c5210824404dff503158a,74,50,5,103.6,65,9,01026,3
4b9a3660094ffd718908596f5eaf0d0a,85,54,1,595,85,0,05040,2
0d725ac3dcb10083dac84e8f01d8238f,113,59,3,263.6666666666667,92,21,01026,3
c8397f137e184b7c27ad2c9e9bde8c9b,119,56,4,208.25,119,0,01012,3
13cec7da9d395fbffc0fcde395fd0bf8,78,62,3,182,78,0,03050,2
309871ef70460abc7869e36e4652a916,48,48,1,336,0,48,05040,1
f4fcf66b0cba513487aed5a946d2f490,31,31,1,217,31,0,01012,1
2cffe9b2018b635dff455e4eafbb6b31,295,121,3,688.3333333333334,249,46,10200,4
95f6f22e5aae63eb573510b9d830cae4,39,39,1,273,39,0,08010,1
e8933d30f1d99a0551221ccb777eade2,35,35,1,245,35,0,09110,1
00c2e7e0817d3dd043f6626a8223956a,36,36,1,252,36,0,01026,1
fad5505d486b4069e6acd9aeb4b2d2c2,56,51,3,130.66666666666669,43,13,05030,2
5bc79143e6c3435c96855d8334406da1,385,164,5,539,248,137,05040,4
300837cfc4b3efdb7ae38af34a3c1cbf,27,27,1,189,27,0,12570,1
d36598fd1047894285851aa7400a43fd,161,101,3,375.6666666666667,161,0,05040,3
a219cc66630cb77b8a7e315ca650bc65,37,33,2,129.5,37,0,04060,1
044f65aed5c0c9a70570246e057a8f89,48,43,2,168,48,0,01012,1
25d5585dea2e919d178a5df6429a5bd0,27,22,2,94.5,27,0,11100,1
61414382e4a5f7b141c217f5a511d592,27,27,1,189,27,0,01026,1
88fc983e5a66ccd3723fe366784330db,321,98,3,749,247,74,02690,4
e14d7eae0c722c720199d910ac43e5a2,25,25,1,175,0,25,05030,1
1ffd69dae77014803f7ea7d54a9084b7,37,30,1,259,37,0,07131,1
db92efbf7c01fc8d5cc57f73042270a5,30,30,1,210,30,0,01026,1
8b283b31ef8f3fe46581f62970ccca16,63,52,2,220.5,63,0,05040,2
6816db30c2941aec0596e7336e9e2a3a,18,17,1,126,18,0,11040,1
015debfa4398a9bbb5f8717560d78740,119,67,4,208.25,119,0,05030,3
7b7b6eab09fb32b83a77e1a6f1f3199c,20,20,1,140,20,0,01201,1
1fe1eaf93430631cc8e2b676e1893bf1,64,54,2,224,37,27,10200,2
29c41b1bfd41dfa339ecbce6ddf2b60e,32,32,1,224,32,0,05040,1
7e5caf9d42310db3a334f9390d4f62b6,60,37,4,105,48,12,04060,2
b4f635f4bc134a9d587c4e4cf2d30048,23,23,1,161,0,23,08150,1
8631a37639ecda38d0fa9f6bce2d7885,127,80,1,889,127,0,08150,3
e9c3ad34546932097ef4871393a5531b,37,37,1,259,37,0,01013,1
fd8fd45e34c77d6b3c380f730fba3aea,68,56,3,158.66666666666669,68,0,03090,2
39bf29cace5dd8cdc063fd8e415f7bb5,125,73,4,218.75,85,40,09010,3
df49cf16fb07c4c84c1accda4bfc9742,36,36,1,252,36,0,10080,1
8fcc6173dabc00f6aaff3a9dfc2e15ed,75,59,3,175,58,17,01027,2
5723d04d33006f199594f208534c3c21,13,13,1,91,0,13,05030,1
34b8148fa249873c24d062b31bb4e11f,71,65,2,248.5,71,0,01026,2
77a4330e0f3eb76dd66d34081e030622,202,48,5,282.8,190,12,09010,3
72831c692eeef9aa4d743bd8692dd670,69,59,2,241.5,38,31,05100,2
c60b34d547d7f7516c6ef2069afb358c,97,70,2,339.5,44,53,05040,3
3b8417dcdb5edddc49befe6cfa581061,99,72,3,231,99,0,05030,3
428ccb4dc534113f1b1e0aafd2209eb3,11,11,1,77,11,0,05030,1
e039636ba07c5a33d4151704fe21a927,23,23,1,161,23,0,01085,1
f6f7310250724f2286425e5460ce9963,199,67,5,278.59999999999997,181,18,05030,3
02745f7d1837e132d2f3014861a028a9,155,112,3,361.6666666666667,155,0,01026,3
3fb26b96227c4bdf54138bf20ea82a5b,222,118,2,777,163,59,05040,4
a51f140a746669bbe8fa01ff35e3e040,66,59,2,231,66,0,01085,2
4ddd3d078a5ffef77f28368dcfdcf164,510,117,2,1785,510,0,01026,4
9033692bde20b4f0e3f87d022237c1db,136,56,3,317.33333333333337,136,0,10200,3
7ee6abb708a486a7f37d3b52eadfb8ce,29,29,1,203,29,0,05100,1
2b6e07467a1fd630115cf141e60ddfae,417,129,4,729.75,357,60,05040,4
3433666c4b8f2df29fab5c9105284824,87,56,3,203,87,0,05040,3
057b53b22b2ee039b2b7e25453c92816,36,33,2,126,36,0,10200,1
f5a7a02af866b569abf6868419cf5d53,166,111,4,290.5,121,45,01012,3
7eb9a0f0e0a6eca80e92bf5c64a56f8a,20,15,1,140,20,0,08312,1
d62b222ccf35f971fb66e9d2f591e981,64,57,2,224,64,0,09130,2
9e2976c2fbd86a02992f8dd506dfeaa4,26,26,1,182,26,0,05030,1
d1c84a491d376f9404ac094c18374f86,68,50,2,238,1,67,10101,2
dc373ac7ecf512a436627de3222b0a11,122,75,4,213.5,122,0,05040,3
28fbab5319a45413447f59a64ff7052a,126,98,3,294,55,71,04060,3
9d14fd189d1735515bad5c2d9f2ebdde,387,206,3,903,302,85,05040,4
501ac3009cbc17e3f322ca1cc5c31100,29,27,2,101.5,29,0,11040,1
0ef084c80c4800f5f2f093fc4d2b45f4,80,58,2,280,37,43,03050,2
4e9d2eb26839fdb993ee29c67ee6c94c,113,76,5,158.2,69,44,11040,3
be1b722fbc54e747ea37cc53a47e3773,142,82,3,331.33333333333337,142,0,05040,3
5b1f922ed7ffe040d28e88bd645c5d4a,20,20,1,140,20,0,01085,1
48424958b56f888f4eb32c3ec3f4db60,9,9,1,63,9,0,12590,1
328cb3fdaeda394d1d803662d0e6ae5b,86,86,1,602,86,0,04060,3
2007a852db5b0c39db176cdd7d71fe3a,31,31,1,217,31,0,05040,1
efc8bfd7a62fb70f75df60e86274b436,16,15,2,56,16,0,11040,1
e67273b8080ccc0ecbaea4256f3e45a2,13,13,1,91,0,13,09010,1
431b02cc175392864ff4edfee2fbfa91,54,45,1,378,54,0,05100,1
a16537492fbd95686940850b1c172260,52,52,1,364,52,0,05040,1
d43b5af1e01856e64a63b15318b95519,156,87,3,364,108,48,05100,3
6ab887a25f1f4552abc4fff46f4dae70,9,9,1,63,9,0,11100,1
5c7bbcd83e395cfd42a4fe38b07a6ba1,170,89,4,297.5,170,0,05100,3
38968b553808f03bbcf6110251d9f0af,52,44,2,182,52,0,08452,1
94501f2bdfcabb2cd3e26d06f43d4001,50,39,2,175,50,0,10153,1
ee58f853884f7088cac12002d199f639,85,61,3,198.33333333333334,48,37,05030,3
f5c398e9b562dcbf3dca595c4e89d219,30,30,1,210,30,0,05040,1
1bde248ee2f1833080b49bb319bcff12,37,28,3,86.33333333333334,37,0,05030,1
3bfd5799f7daa80aa1d46834d4059d58,114,86,2,399,74,40,05100,3
d66c4df5138a9c3091ad58c617c7e4e7,19,15,2,66.5,19,0,09190,1
7ce48644476220e1a67425241bdb23ac,41,33,1,287,0,41,11180,1
166609698d4a669f3e32324756a61a1e,25,25,1,175,25,0,01027,1
6720f40dc1074238917c27ded9ae9f5d,36,36,1,252,36,0,04060,1
dec540ee7b0401d9e884fe7dbbb00cb7,33,33,1,231,33,0,04060,1
420b3c58d43eec852fbe6f0dec8bb12c,47,38,2,164.5,47,0,05100,1
6a191d7523892374ed4808b960f27584,23,23,1,161,23,0,10080,1
b15ca9f39abcc52e3e0fe9056de826f6,72,61,2,252,38,34,09130,2
9b8eaaa5992346b34d604adca3bf5cb0,42,41,2,147,10,32,01012,1
bb50323f6e9b8da15a8a33e50267af52,53,44,2,185.5,53,0,03050,1
e77396af69cb4b240d8cb6667532a0cb,25,21,2,87.5,25,0,05040,1
8e6dd0918926ec5f2d9a2409bdb3017d,49,46,2,171.5,24,25,05100,1
d265dc1a2b352749c8fe48addc10e7a9,58,56,2,203,58,0,04020,2
490c9ab13702f4549e98d62f7ce2a672,244,94,4,427,244,0,01012,4
0ee5424766d7dacf3a0b509345ffbaaf,21,21,1,147,21,0,05030,1
8d773ed339d3ae5c9a0beb92f4c042cd,54,40,1,378,54,0,05030,1
0cfa7e14eb33c7b98c1e42e6b9e537f7,11,11,1,77,0,11,01027,1
cbbf41d925fa6663b5fe9380bb12b29b,20,20,1,140,20,0,03050,1
31b1099d8dceb63817985c18fee99aee,7,7,1,49,7,0,05040,1
b43839b1c45d089ec1879175fd6a15b3,59,59,1,413,59,0,05040,2
abc2ebb1e53da65ce0c00d4ea4cb85ac,483,186,2,1690.5,350,133,10028,4
de5682d89f477de04b239e673c65dd5d,13,13,1,91,13,0,09190,1
6b4eb3abd53bf816300c5473ec7a8bbd,51,44,2,178.5,51,0,04032,1
b7b502003d00ce0172d027ab60213a96,44,32,1,308,44,0,05030,1
4313cc046f192f13093c2cc865682283,69,66,3,161,3,66,09110,2
b2755185b43dd72d125c3346c0445630,13,13,1,91,13,0,05030,1
3d801ddc130c2b8da4f1b349cc209859,54,54,1,378,54,0,01026,1
4b6833ebefd84ee8f834e6f7edf62bb8,13,11,2,45.5,11,2,09010,1
9ad92beae22fd6a6d9b3e9221347afb1,166,34,1,1162,166,0,10240,3
ae4459948a80aebda21a823f6673ed69,74,71,2,259,12,62,08312,2
df43f1764fb324f6772d36002188f660,42,42,1,294,42,0,01085,1
8a1182bdd6e532236a5bddb9a232dc76,37,28,3,86.33333333333334,22,15,11040,1
05b6971c2b1085949d0eac9f55696a27,18,18,1,126,18,0,01026,1
8730377c79cd335e41b969ac82ac04a4,131,75,3,305.6666666666667,131,0,04032,3
fbe0826ad7d543a6ad4ea898024b3dce,20,17,2,70,20,0,05030,1
bfbce277af6a11dc5f0871d40964b5db,11,11,1,77,11,0,08132,1
915f1b73b74f4d5a8de432e0f6ad0c3e,35,35,1,245,35,0,10200,1
5d403eb8f6c4cdb09f2afe9f809af832,12,12,1,84,12,0,01012,1
ecf4e8f98cb1656372c958a771daf0f7,12,12,1,84,12,0,05040,1
3b24e37de761dcaeec16c5aa640a63b7,138,101,3,322,85,53,01026,3
96cdce29ab1ae1c6c876605402e577aa,35,35,1,245,35,0,05100,1
880d43887d1187eeae8db50bfee3d984,19,19,1,133,19,0,05040,1
8332eb8570e30979a4762562aba799fe,26,26,1,182,26,0,01026,1
9d714af6925fa127b02dcf3949f1bd94,34,34,1,238,34,0,05040,1
42903249d9461d8b1a6a48aff89d3a08,289,126,4,505.75,289,0,04020,4
05fc4743c3bbfca36395ab588006145a,42,18,3,98,42,0,10200,1
34b67546fff98d6b9b5a1a9f2ef00116,21,21,1,147,21,0,01201,1
36449c8aec16aa844508d5aaa5203b26,145,91,3,338.33333333333337,145,0,01027,3
df663b810bdd0553207dfeda02b2bf31,20,20,1,140,20,0,01012,1
20bdc1215f2afe60002b29c47e0920ea,195,107,4,341.25,134,61,05100,4
e00b4a618e13dd893a316d86e0ac3ca7,80,43,3,186.66666666666669,80,0,05041,2
3d5d6360b294261351f3ccc375a8dc93,197,90,5,275.8,142,55,10080,4
13146153bf3a13dd53e3975ca327f886,37,28,2,129.5,37,0,07121,1
799988f9a4fb040d63aba0bc4896f49d,58,58,1,406,58,0,09351,2
d0b8ecafa6897b0f23fa7c50763e4013,68,62,3,158.66666666666669,26,42,01012,2
e07911457b7b3bb778126a496574352f,16,12,2,56,16,0,05030,1
7026ec6400c63c0f1e0de0d235bffdc4,109,64,3,254.33333333333334,109,0,10200,3
a2140a1d35aa5619f37beecf34f2fdc8,98,64,3,228.66666666666669,98,0,05040,3
ef47d1f8f77d8ead7e3747e1a0d4db6c,267,144,4,467.25,234,33,10200,4
197e53b77536726a4f203847f7e0e6a9,32,32,1,224,32,0,09090,1
d01a1e2c296b21196f95e0b57c8107a8,38,36,1,266,38,0,08150,1
c691db721d3c6bf8288c9731fc2a29ac,151,104,4,264.25,122,29,03070,3
52f9b74e53829fe92ee6eb6c5f5c4034,25,25,1,175,25,0,05030,1
f7e3708c2fe7354c1f156578e8314b90,146,97,4,255.5,146,0,05040,3
8fce502ec125ecacf864d547ca5de45e,76,58,3,177.33333333333334,76,0,01085,2
ce9e887c200fe781a88cb46c7bc4ec1e,174,127,3,406,174,0,01012,4
cd67339486b28dc09da9e487da6cb609,314,120,2,1099,314,0,02691,4
74f99043d165cc9610b7c1f204fad868,63,53,2,220.5,63,0,09010,2
bdc2d8947e8756d9e7b0852efd78c594,337,139,2,1179.5,337,0,05041,4
8fb5997a3ef142448e8978f914f6e86f,409,150,3,954.3333333333334,340,69,01026,4
6a306589f304826020ff6758e121e70b,51,43,1,357,0,51,02620,1
6cbd32a95eebd0aaa6e3b98da2ac3cc0,2,2,1,14,2,0,05100,1
9ceaeb956c263160032809553d4e621a,34,34,1,238,34,0,09351,1
c3dc042322d22b63f5e2d183297d9f73,108,80,2,378,65,43,01027,3
d926dea4a50973915f3b6db8d98b81ca,359,157,6,418.83333333333337,250,109,01026,4
d2ffd2dbdff9fe4bbbc77d0a555a5a46,58,49,2,203,58,0,04060,1
4e2fda3035ef1b4155bace87fb4dfd42,31,26,2,108.5,31,0,01012,1
fe603fc6ee4b810ad24efab374ac5959,263,120,4,460.25,263,0,01026,4
f7806b68aa28eed7c35fefb9b93d4b2b,30,30,1,210,30,0,05040,1
8fd53c8acd46a6c3c8ad480901c61403,16,16,1,112,0,16,05160,1
138608789ace1c8a8ad3bf7e5fab6057,28,28,1,196,0,28,01026,1
8a4dcbcd844f4d23df3820225d492959,25,25,1,175,25,0,11040,1
7f4526afbf78081d8b905e05ba188f01,41,36,3,95.66666666666667,41,0,11102,1
4aad94d677d6749d8815b55a65c6d0aa,261,104,3,609,261,0,05030,4
cd5aa5b3cc70129acab4e0ff75e0a48f,216,108,3,504,216,0,01085,4
7c54eb0203b971036b73651d319959a4,125,91,4,218.75,102,23,01013,3
f6d7c6ec16cb601f5ca0304002d3e7fd,25,25,1,175,25,0,05030,1
5540072a6fd5ca0e2dda1629de816234,106,44,2,371,24,82,01026,3
5b0d2f7cbff8f830bb469d89844664dc,20,20,1,140,20,0,10200,1
020908c019d48753b8efc443ebe247be,294,159,2,1029,150,144,01026,4
2f440ab67810f87d6f7bcaf18b187e9c,2,2,1,14,2,0,06120,1
87b937f854fdcce0e37942ff03de1aae,64,46,2,224,64,0,05040,2
a11d9857757f5670a3397c71d5539a7e,24,24,1,168,24,0,09090,1
12eccf69f79289247b735efb4cfecf24,27,19,2,94.5,12,15,05040,1
f7fcbbf0a02dd9838326bf83a99d0477,189,114,2,661.5,189,0,05040,4
4285c79753e93e7ebfa56d3c83d6fa14,44,44,1,308,44,0,01085,1
c64372621e2f6d5ebf467fb44b57246f,79,46,2,276.5,64,15,04060,2
9a89741eef4fa825888413c12a915ca6,92,72,3,214.66666666666669,38,54,10200,3
1a0acd21d3b93504d9ab3f7a2ee312e9,30,22,3,70,30,0,05030,1
833cfe058aed53db9af09e7095b93090,26,26,1,182,26,0,01012,1
b0b438821924ac693bafc42ec0eb1df7,23,23,1,161,23,0,11100,1
2c8d77a85f4b65bcf65f176237dc0309,62,62,1,434,0,62,05040,2
5f3d6ba080b7385ba582a711a6364ed7,439,123,2,1536.5,439,0,05040,4
0e19218628b139c6ac162a52cd57c519,19,19,1,133,0,19,08231,1
1897206274e17cb2c7468e09bc27bf93,155,115,3,361.6666666666667,66,89,01026,3
62710166ca9849ff86486d9323152978,30,30,1,210,30,0,01026,1
70430790b4a1945fd21843ff876fbf24,27,27,1,189,27,0,01012,1
cd2b4cc7faa97a15967ffaf976a8fad5,198,90,2,693,198,0,05040,3
f726b7e1a5aae5727ff7a0b8aeec498a,21,21,1,147,21,0,11100,1
9bce0338741758c3234208d93f2ef000,186,84,6,217,169,17,01026,4
d9913b112058d3d96a998a8001bda078,105,73,2,367.5,76,29,09170,3
defefdf5d592cc9decc43675b468068b,41,39,2,143.5,41,0,04020,1
b30a68337c6f7a363a39c9f04b761ea6,31,31,1,217,31,0,01012,1
9cd3e54aef15e12bbfff91a38b791d77,360,162,6,420,303,57,01013,4
f3fd2050a9f9e8c6fc54eb66fb904b0b,43,39,2,150.5,43,0,05030,1
8b411c5ac61025d57f906ab01408917d,10,10,1,70,10,0,04060,1
8e9de3d024b7122750a20b7be29bb6e3,178,104,2,623,58,120,10101,4
629e4e90ef84b3af2b3f54bbb00dabda,206,100,3,480.6666666666667,147,59,05040,4
cd16f7e1a7c12b1c5dadb72366cda662,56,56,1,392,56,0,01012,2
11afd1c9697f7990abd2f5ac572c056b,84,60,3,196,61,23,05041,3
2641fbe3954f7d3fed22b48b93f25153,63,47,3,147,49,14,05100,2
4cfeb5599a342a2ff82fa48b9673fc30,72,67,2,252,72,0,10200,2
d8f9cd5c2733e6e4d84cc5bd0d5e524e,23,23,1,161,0,23,13490,1
637d9cfaee02649f97333139bf493cf4,52,22,4,91,52,0,01012,1
0a635e48a158ac39d45a4d4d1f3949c1,37,37,1,259,37,0,03050,1
01eee73ab8d528c94552ba07fdcbd23c,12,12,1,84,12,0,10220,1
d0eedca7d244a641b796e1b904471f6e,74,47,2,259,74,0,03033,2
a5c0927dbce710b02eac666583c299d8,94,72,3,219.33333333333334,94,0,05040,3
703b64fd9f2a85e0d9ecc66fa31d256e,12,12,1,84,12,0,09010,1
9c4008d6eb2ef98f4ceb3128e02f3311,126,81,2,441,126,0,04020,3
375185b538e44c80ab77bc9f03436c23,50,50,1,350,0,50,05040,1
c205eaea03bd5374542e11cb3429f1fc,21,21,1,147,21,0,11140,1
0d954bb17699f316344e312802c71445,51,39,4,89.25,51,0,08134,2
f13db1f07eff7b7dcac1dd0c7a67b6ea,73,53,3,170.33333333333334,61,12,08090,2
705e38f3841c4af4b975221b2ff84c65,18,18,1,126,0,18,01085,1
8615e664b5da1260a85d16da6b769beb,27,27,1,189,27,0,02650,1
c1242ede9cbf3d21b69c3188da615676,95,69,3,221.66666666666669,70,25,04020,3
57b8087c40adc79eb45018865be83b10,46,46,1,322,46,0,10040,1
610a5c43c1add0300f441606c5675077,47,43,2,164.5,47,0,08010,1
0c227f425ab8862dcb3700e48e613e5f,44,44,1,308,0,44,01012,1
8f05f3fb9721e26f660992e14f90b506,23,21,1,161,23,0,10101,1
9cc417c49c3e63eed1340725b6018791,351,132,5,491.4,297,54,10200,4
28ec84360bc9cd29f63606a1a4939226,97,82,2,339.5,97,0,01026,3
2db2a3999675fb87446c4a21a9bd75cd,51,33,3,119,51,0,09130,1
c625db6ad847cdb14710277b628988bc,27,27,1,189,27,0,01026,1
bb391bc4007d278bb06ced7d07e74490,325,122,3,758.3333333333334,325,0,01026,4
2bcbe020c94ff1ba25685cc3da274989,16,16,1,112,0,16,12570,1
00a8604e07f2ea689b011c5cb20118f5,212,103,4,371,146,66,05040,4
1af65b849866c5416a4841ec65e40d2a,329,141,4,575.75,222,107,03070,4
9faded887f121fc5ef8eaa05d3a3d779,21,21,1,147,21,0,05040,1
921e37245a77111b64d25e61191137cf,33,33,1,231,33,0,08090,1
31cd9fb8dbe27087ff1b208e9fb765da,22,22,1,154,22,0,01013,1
2ec659da5e3e5f8b88d532496a321f64,132,94,2,462,132,0,01026,3
a8030652eb5efad56e2c7946f1b5c1b5,30,30,1,210,0,30,11080,1
d7e06decbbd57f60aafd915302fbdb5a,2,2,1,14,2,0,05030,1
49658d43a292ba65a907ed32bbc0f771,97,80,1,679,97,0,09130,3
c066a1dce2188e22d1dfeafaf4cafe98,151,91,2,528.5,120,31,01012,3
1ac3ca828229099a3299c70186aab733,124,81,4,217,124,0,10200,3
981eaee532f18be402a428a1da8e5c0d,334,125,2,1169,307,27,01012,4
6b62c8118a1cb0ecd89a6368d916be48,77,64,2,269.5,53,24,08010,2
628acbe59938909c4973efabf54ffe2a,48,43,2,168,48,0,05040,1
62b63f3f6aaaecee7a5acac4b81883a0,114,82,2,399,114,0,01012,3
78a5eb2d4d16cafa3a34d3a909909f05,61,51,2,213.5,61,0,05040,2
85ead75dc3383c6b2b08e0157f3e4904,18,18,1,126,18,0,01012,1
4424309a02bda4ddfd45934b444008b6,95,63,4,166.25,59,36,11100,3
8a76a659c9f8e248b28fcb79872b65c6,150,100,3,350,150,0,05040,3
f8f0916190af091bb053e32a15b646b7,304,163,5,425.59999999999997,233,71,10240,4
35ba9da56a321935682ea6323400ce1e,24,20,2,84,24,0,05030,1
b17797ccf7a5bb056ffdcac07d7736c6,13,13,1,91,13,0,11100,1
7675b1475bac15b29bc83e9ade648d3c,23,23,1,161,0,23,05040,1
76b597b16e893db2984532d16b6100b6,172,102,3,401.33333333333337,172,0,05040,3
ffe02b2e8e866740f8c8262a5b0af436,317,155,4,554.75,255,62,10200,4
1abf70efede2dd459ba9f60ceff7e1b2,69,59,2,241.5,33,36,04020,2
504d17def6edc33b45eb5fff0ad5641f,146,91,4,255.5,146,0,08010,3
64a967aaf51a71cef4e5c2c427899521,29,29,1,203,29,0,04032,1
2d86ccd4ba9f209695fea4fa1bd053f2,294,118,3,686,294,0,05100,4
dbea0dc923b0745236f1203f85d9c58d,235,80,5,329,183,52,01026,4
dcc9da5cc806aa1eb14c55eef56394aa,31,31,1,217,31,0,01026,1
f8ca1710e748ea25cb38892ab8dc4287,45,45,1,315,0,45,09130,1
aafe3444d79ba5751fca2e86dcb1e28b,132,86,4,231,84,48,10240,3
4cb2f3c51643e75a05cf033634144ab0,27,26,1,189,27,0,12610,1
f51cacb55541c22bf6c9328cd21efcd8,16,16,1,112,16,0,03090,1
d2b9d78ea67e2015b14a862bd8ccf38f,355,138,2,1242.5,69,286,05040,4
884ff92bc27f8d33f697344885f65920,52,45,2,182,52,0,01026,1
8efc35faa14ce8c4636a34189f119f1a,55,55,1,385,55,0,03050,1
9b32023f367f2a96ea61212b98bb6897,42,35,3,98,42,0,05030,1
12176819e1f46648913481f3e05bc87c,23,19,2,80.5,11,12,10080,1
93208e6ebea7776f99bd7280f5bc3022,24,24,1,168,24,0,01085,1
afea7aca7a05500ee0dbf99a86665dc7,214,91,3,499.33333333333337,113,101,05040,4
4a2049e9b7c00fd19ae1496ec9059ec4,28,22,1,196,28,0,10240,1
25eda77f319f1cb3b361753aae2eb6ac,23,21,2,80.5,23,0,13953,1
8d980a68b3aa823e1ee14036e00b722f,109,68,2,381.5,109,0,05040,3
772beb9b2d318166e4a0f67655ea4f8e,32,32,1,224,32,0,13490,1
7ca0e5284a8e2541877c88654b365259,20,20,1,140,20,0,01027,1
fd20ae50dfd3cb5c7717d8afecc5ac21,83,58,2,290.5,83,0,08032,2
9d23b279fdde8906250e0b2c7d404d4c,140,63,3,326.6666666666667,140,0,05040,3
30e153d0b5d8e1cc7818e3953d9a966a,27,27,1,189,27,0,10040,1
a429fe17f5f4e828fe2494bdfc16bec1,172,102,3,401.33333333333337,130,42,04060,3
e27669b6ff0abbeab8fdb94a84081200,96,81,2,336,54,42,09150,3
c6a55739189cb22edf03466b2d3c795b,50,38,2,175,50,0,10200,1
f4fd1804fb30c65486c4a1c9fa300389,283,140,2,990.5,111,172,05040,4
c45a8dd5edfcbeadf243fc13fe8bd29a,31,31,1,217,31,0,03033,1
4398aaad6332c914b0a67eea427b2858,23,23,1,161,23,0,03070,1
c99c33c98e9ac8f0f59adbcf33b69ae4,27,23,3,63,26,1,05030,1
543087cc04b7f8a72372e82c157b0c7d,33,25,2,115.5,33,0,01012,1
6a2adcd9b910eb81256fd2d4a69afe68,206,147,3,480.6666666666667,148,58,05040,4
291353e72af091daad691692033eacb5,53,46,2,185.5,53,0,05030,1
e280f39ce2aa55b9d110f2c139d0985a,120,79,1,840,120,0,03050,3
389674d322518a2391ceb006cee8b135,270,109,5,378,230,40,05040,4
0f89bd0f1cdefb02144cbf4b27a14147,32,32,1,224,0,32,01027,1
4766b0ec2779030c9c40cdf85fd057ba,95,61,3,221.66666666666669,61,34,09010,3
eedcec0ba9cc2a01c3345649ab0e072c,106,41,5,148.4,81,25,01013,3
0f395d90cc4c80ab86dd0be43dbee64f,28,19,2,98,28,0,10200,1
8e3729515b81cf26ff1febc95f11f96d,19,19,1,133,19,0,01026,1
5a45751e5ee5c791f53b48b302ae72e0,55,39,3,128.33333333333334,55,0,13930,1
f9ba9f49996d7e638866790689c694c6,29,29,1,203,29,0,01012,1
132945ad1892d471b969a391ccb21285,81,58,2,283.5,40,41,05040,2
bdf9c7488dc7d455f10d34a2b63e3883,107,78,2,374.5,107,0,01026,3
63229497deeb08eb16cd9cbeedf1996d,20,20,1,140,20,0,05040,1
da138b2a24f57c91ee0125b1659c3b4c,48,45,2,168,48,0,03070,1
af6c94e911d07d931d0e62ab21c7cb9e,253,79,3,590.3333333333334,207,46,01026,4
b34702c0fd78703aaf82807f0cc783b8,124,65,3,289.33333333333337,53,71,11080,3
7ac44b8dd55a8bf5a18c286fa1cea2fb,35,35,1,245,0,35,01012,1
36fc6191b271bdc4276c8d7ed0443672,176,93,5,246.4,118,58,01013,4
44085a23dad13ebbb4a0b6ef30d88b28,117,77,5,163.79999999999998,50,67,05030,3
500500618d9d8a3aef76fc13a8408cfc,82,64,2,287,82,0,06100,2
c9fc68b1d5a9ac39ad866e92ce95f4de,31,31,1,217,31,0,12500,1
7b07b74be54a922b56e8b9999ff3b41b,101,57,3,235.66666666666669,101,0,12650,3
15fd37e365beace87b4ac31a022bff21,37,27,3,86.33333333333334,28,9,11040,1
e6b675c4105c2caf9e5d08bab5d5d7a1,7,7,1,49,7,0,09010,1
dda55e1f39463d61f486a3112229dcfc,210,81,3,490,210,0,10200,3
2373f1d914c41883eef18304c35fd3b7,39,39,1,273,39,0,05040,1
0e0ccbdc0226eb452396d4478f421d78,132,103,3,308,95,37,08314,3
4865b72bfd9fe4fab819517e8621010c,100,87,2,350,58,42,10200,3
40abc280e9325183eaceb6bc91aedb15,96,54,2,336,96,0,01026,3
c429f21ad529c810acce5940b1ae52c7,96,71,1,672,96,0,01085,3
38b54dda5ea3a49c0699e1b3abdff7d0,70,48,2,245,70,0,01026,2
b2abdc8ca4bc4557fa15a26bac83587d,156,65,4,273,156,0,05040,3
fba0f6cd68dee277317e3d14dac6ca05,106,84,2,371,68,38,01027,3
e360e474b326e1ba8ecacb782bee89f5,190,76,1,1330,190,0,10140,4
b97d334c9b4fa0bb1a26f49c2fb59fc6,12,12,1,84,12,0,13580,1
2935e49e7c0fee068d81e622ffa48173,13,13,1,91,13,0,04060,1
64fb0f7e976735c066f8ffb04a784a1b,138,68,3,322,88,50,05040,3
9824e4ff2d32b49e1cf87bb55a382d9d,13,13,1,91,13,0,05180,1
e5a47fd7ef7c4b514e5746ad52eb7f37,54,47,2,189,28,26,09130,1
bcef15e0cc5771bcc34dbd86e6464140,40,36,3,93.33333333333334,35,5,13490,1
20cd1610630f8cc2c8989e2eebd80149,105,81,2,367.5,52,53,05040,3
740d12548679c0c1f1762682ad14863a,40,40,1,280,40,0,05100,1
9d6a289f90a79af5a4e281d92915bd06,147,93,3,343,147,0,01027,3
15cf6599cbd104d040ea01e7ed7d955b,12,12,1,84,12,0,05030,1
a5c1edd1ad08e004c4f915d388d233d2,29,29,1,203,29,0,05040,1
7cb85b450f08513bd531b72bce701ad9,624,122,3,1456,624,0,05040,4
4b2e0cef83ae58408c3efdfc61651ec2,194,109,3,452.6666666666667,194,0,11040,4
44522a151feb732138b3debc89118340,76,76,1,532,76,0,02751,3
d8cc7550832cf7ab72ff242ad2e972e7,39,39,1,273,0,39,10200,1
63f889f88d087771191f1a1840dcd864,15,15,1,105,15,0,05030,1
7040f76a6d0fb9d217b53c9513e974c0,42,32,2,147,42,0,09030,1
9847762f0471ba0c7bf487ce835a5a74,393,144,5,550.1999999999999,339,54,10200,4
c0aebe0cbb54a5e8e2269ef478427913,26,26,1,182,26,0,05100,1
60d3771a063f242edbd0a697686c20bb,112,94,3,261.33333333333337,112,0,01027,3
096d047d50087bba1e72c218f087a6c5,23,15,2,80.5,23,0,10200,1
742b8f75e9c27c0a01a055b941a5630d,24,24,1,168,24,0,01012,1
7a1e53a94ce35d1742768baa021f57de,292,163,6,340.6666666666667,263,29,01012,4
8979b49361681803c38dee66c03967ce,289,126,1,2023,289,0,01027,4
7cb11cd24dbb1d2ed3d25f0115cc1805,4,4,1,28,4,0,12670,1
b044977c28a854997be489b62058e180,418,158,5,585.1999999999999,329,89,10200,4
7a5393bb2eb756c515b63b6f9a299c10,110,80,2,385,110,0,10220,3
70ed73c7149010f0ab6cbf818d720f95,21,21,1,147,0,21,08230,1
ca27d7244ff9ffb9dea52378cd589abe,47,43,2,164.5,47,0,05040,1
036b2e76ad3cb60277cdaf66df55547a,33,32,2,115.5,1,32,01026,1
2b0146ed48c1a0767f29a6bf72be951a,76,58,2,266,76,0,10200,2
db71a02f592b9bf384a178548045bceb,23,23,1,161,23,0,05040,1
7ae03d86368a667e43a0a02a3361a19e,12,12,1,84,12,0,11040,1
3c8e53f783d0ecb00b0391ade5c37eeb,141,94,2,493.5,141,0,05100,3
a9062ad07c3b6c6ca9bd9388a6a8b117,75,52,2,262.5,75,0,05030,2
4100db06ad01e6dfff653c0b8384e85f,4,4,1,28,4,0,01012,1
82e4066a66d726dcc3a8be521561d224,79,79,1,553,79,0,13830,3
ada2c4c9e3932cc3bc9f9b12d7b3d55b,30,30,1,210,30,0,05040,1
96158f0afd1f998bdf72c93c3e45a623,51,51,1,357,51,0,09130,1
2a8c7f41f2af9d6b4b997317d9b8b33b,159,90,3,371,112,47,01026,3
e71109ac366cccb843cbcd1122dbd1ba,104,87,1,728,104,0,01026,3
fcc64e490561c3d697dc2415a6ca381f,216,81,5,302.4,185,31,02690,4
b97fef37bde97d9bb44e3871484fe23e,15,15,1,105,0,15,14301,1
6d9ae91834d26cdec5991e0e94a83a07,325,134,4,568.75,191,134,05040,4
ef7ec7fc9ce15b304114a95626e3e567,48,46,2,168,48,0,03070,1
c61a44fde6098bb6efbfd6dc64dd45f1,195,94,4,341.25,195,0,05040,4
411214901839a45e64556c0ade647f92,105,88,4,183.75,47,58,01012,3
74e201eb60742b97418b29ff9da97eec,289,104,5,404.59999999999997,288,1,01026,4
0357d191c21fd0c6b65d7f29ad4771c5,28,19,3,65.33333333333334,28,0,11040,1
dcf12011dea98c3b30ca8a0a0a993c60,36,25,3,84,33,3,11040,1
7e6724f3e968816f6e815120cdc406b2,25,25,1,175,25,0,01012,1
8ab78636f084df368e64b4697a5214da,33,33,1,231,33,0,01012,1
109ff4355b5fcc06ad082037c2ac457d,195,82,6,227.5,149,46,01027,4
07d0f2e72bf07722ca7aa325aa8aaeb2,137,74,4,239.75,137,0,11040,3
221d05b9be1306130d526a64d3534255,358,103,6,417.6666666666667,320,38,05040,4
1284f047300556373c7b0a17731a132c,102,68,3,238,102,0,02691,3
e8f5d02804885be8a6c15ecd7780bc8d,126,78,3,294,82,44,11040,3
d00c5ecab488d7967d337f1af92f72a2,10,10,1,70,10,0,12410,1
af82a61dfe04fc4dec6d2ef25fb246c1,87,76,2,304.5,46,41,13877,3
6797bda3038679b86e65321d0926218f,77,61,2,269.5,77,0,01026,2
aa1e485ebc5d9b742ea4be6dc657fc61,84,70,1,588,84,0,11100,3
f4619cff83c08aa076f4f23bf4b25e3f,135,60,2,472.5,135,0,09130,3
e0fdfc66959f318f376b7585a4ff89fc,40,40,1,280,40,0,01026,1
51cca737094900d59a58078caf7ab78f,73,64,2,255.5,25,48,03033,2
f64a8b518e08c13efcf9596256555f57,177,91,4,309.75,150,27,01027,3
89e72c81fe2c2dc2582b7ca2043849fd,131,60,5,183.4,131,0,01085,3
81211d4b5fb16c0c659a461271b98efa,57,45,2,199.5,57,0,01026,1
fc60cb42cbd6a7d2ae3f47d6bdbd109f,11,6,2,38.5,11,0,12470,1
5cb193c0e7a72217e936afa79205d410,112,101,2,392,80,32,01026,3
9cf2dca1051f8704ac43e5b8acce48cc,37,23,2,129.5,37,0,09170,1
53c96fa8b1592b96821ed03fc40c5f25,8,8,1,56,8,0,11100,1
e504b2f4a5dfd57489fe59390b8578dd,33,29,2,115.5,33,0,09010,1
1ff7368c83e5d384f1ae3ce46781182e,98,86,2,343,71,27,10200,3
1269042aef664d6e96b90df750703d24,21,18,2,73.5,14,7,11080,1
83ad867456790a61ed17d88a0be1c7b4,9,9,1,63,9,0,11040,1
638ab6c9f21acb26a6f6aac297c8a536,15,15,1,105,15,0,05040,1
4c8e1c47ee38bcb3bf0f628350c728bd,22,21,2,77,22,0,05030,1
23770c80e3eddc96fdc08d256e4e4931,38,38,1,266,38,0,08052,1
0ea7ea792b9d340ffd67a4268066ebe2,28,28,1,196,28,0,01201,1
4f5a26a943ed43a36f36d37771d53fc0,68,58,1,476,0,68,01026,2
cd23f5d8fd7808ef0816bf64d7c258dc,88,47,2,308,88,0,10200,2
a56d4825cc44b585db7b1c54d8daf3ed,55,44,2,192.5,55,0,02691,1
a6e0c847b947fe9beb8d739647774abf,230,131,3,536.6666666666667,197,33,01027,4
240fc96b5e946f0229a091adba10af71,15,9,2,52.5,15,0,05030,1
5c5837880f829ad695a29f906576df73,36,35,2,126,36,0,02610,1
1fe3a9b049c81905ffd5901291b1a759,15,15,1,105,15,0,05030,1
fd3e3a3b336cc110bd94b3edf73433cc,35,35,1,245,35,0,01012,1
67d6438e9350833050bc9abe8dcbf6d8,12,12,1,84,12,0,01012,1
35e7b6a9cbe1510e75d8a4cfc946e34d,211,112,4,369.25,211,0,01026,4
b3f0f61584ae26f50af314c8bd036b90,44,33,2,154,4,40,01012,1
18cba92311a482e6acbd41aac054446c,12,12,1,84,12,0,10200,1
30bbf47d929cdfbba6650afc04e2789b,64,55,2,224,64,0,01026,2
9dc773c0ed70825d8696647d24e2635c,3,3,1,21,3,0,04031,1
efdcd3b9982d115879283995d947324a,238,121,5,333.2,211,27,10200,4
82f2e53edf23127d7ea17fe5ef286745,25,25,1,175,25,0,04130,1
5dcdb46f589f67e699f85c5f59c50bc1,27,27,1,189,27,0,05040,1
e684e7d4a11d59876466480661e7b2c3,370,136,6,431.6666666666667,311,59,05040,4
6f9701976b6dc16c786dfa57d47674f1,33,33,1,231,33,0,01026,1
154ee285cd0419afa869de411070844b,144,68,3,336,88,56,04080,3
97dd80c57642540b47e445ad09f0ae53,76,57,1,532,0,76,05100,2
bfe96630bd586c2df4d183b6976bfa6b,191,85,3,445.6666666666667,191,0,05030,3
f660d50cde2a5d1abeabc724d0657b73,278,147,5,389.2,206,72,05040,4
c125bb7df6e93135c416ff1e9b9d4b26,91,61,2,318.5,91,0,01026,3
aa69407e1e7b9c10d5212d1a7a76489b,119,88,2,416.5,119,0,01026,3
dbdd9577435b89d9749de98776d5a7b9,53,41,3,123.66666666666667,36,17,04060,1
d13ba683861c7a63824982a68e24fb1d,112,83,3,261.33333333333337,112,0,01026,3
253444607ee7ebf98668adbd12d2ce44,74,63,1,518,74,0,01012,2
a70235b23901bf0f68aafc6cde73b83d,25,25,2,87.5,25,0,05030,1
14e55b2501ef0f395e95cf881852700a,69,69,1,483,0,69,01026,2
05d2b989bfc0dd2d623675ff0f6230f6,33,31,2,115.5,17,16,05040,1
f89b427ce8b91ea7676ffc183fcf9f87,88,39,1,616,0,88,05041,2
8301dbd0e990407754cbecf6e713ca41,114,78,2,399,69,45,04020,3
a5ec4ea8e95cd23e0bd6b91b9837839d,121,80,4,211.75,107,14,01016,3
9184d72af8fdcb394cc5ea44d9c71e9c,20,19,1,140,20,0,01012,1
1af49670b02df1b80b799dcc6c4f0954,63,62,2,220.5,63,0,01027,2
9a310a9c51d5d4d2e77ad49343d382a0,74,64,1,518,74,0,03070,2
be7557652665d9be966584b1aad5944c,71,71,1,497,0,71,05040,3
585fcce8c0dcf8461decbf4379c4a0b7,32,32,1,224,32,0,10153,1
91c4455b9163d862a43589f427ab0769,9,9,1,63,9,0,11080,1
5edf79d75caa1ee75e1d6dc66dfb849a,48,37,2,168,48,0,08314,1
597c66cac3f87c050c6f8bacfe148a5c,55,40,3,128.33333333333334,55,0,05030,1
8172f0a58bcf034a298b3c9d44d3fb90,60,57,2,210,33,27,01028,2
5ad856c497f8998ce85cbed25e22050a,100,78,2,350,65,35,01026,3
660e765235d54efe1044339523473fbe,173,109,2,605.5,65,108,04020,3
3eb66fbb9281712b9178b1b8e635a99b,52,52,1,364,52,0,03070,1
49f67dbda9cfb1d645e69bc644b8adf9,121,95,4,211.75,121,0,05040,3
63f89b023307f26d057c801609f504d9,17,17,1,119,17,0,01013,1
560f4c7731e121e7ffb7796232c7e1c8,6,6,1,42,6,0,02690,1
3bcf2c0cb84d7352d170e3765d8c8171,19,19,1,133,19,0,08230,1
88a2b4182281d3488ebad4ee3b4d3266,397,133,3,926.3333333333334,397,0,01026,4
06e6fb6aa4b150e785213ed91dc49da6,147,88,3,343,147,0,13830,3
80a11d7c29113d9147d733dd9fbd8ae4,27,27,1,189,27,0,01027,1
697abe89db72eb546270b769860e4b5c,24,24,1,168,24,0,08032,1
f992c0b616f35cb1a5d2ef105b00df37,327,52,3,763,327,0,10240,4
613169d4d5af1b5a570f2d6facaba1cd,35,35,1,245,35,0,09090,1
74829a3b38e470ba45fb48a9a8c04806,38,38,1,266,38,0,05100,1
dda8320a8d9976f371bc4d58988f5e3a,87,53,3,203,87,0,11100,2
985019a0900c4006f58f3d58f746fbfd,10,10,2,35,4,6,05040,1
67a97dfcbf522200e9b105847639aee7,30,30,1,210,30,0,01026,1
f5d005b397d1b1f8bfeca1a3d28672be,14,14,1,98,14,0,05040,1
f20e00e117bf55da41e5fb195a307072,27,27,1,189,27,0,04060,1
aaf4940bc8ab50c37b6cb7122adc4279,30,30,1,210,30,0,02650,1
c8b410ce26ee650ee2afb48aef2c1ff2,334,106,6,389.6666666666667,191,143,05040,4
f403d10f520afb612241a0f6b0a28f46,1,1,1,7,1,0,11040,1
d4206a71f954b792e4456a001147e55b,9,9,1,63,9,0,11100,1
0603359a8757ed17a16126a241495f4e,23,23,1,161,23,0,03090,1
868f4011431f6833209d22caae007b66,33,33,1,231,33,0,03050,1
61fc5b20ab4d50c2f1ed490c1e26d4d7,27,27,1,189,0,27,04060,1
ed31dc39378867c5b904ae6890bc1c7e,43,43,1,301,43,0,01027,1
1e14a4dcac47a6181418eb0e9dd98635,272,74,2,952,272,0,01026,4
927ebe1cfdfcf5cab89b1ac7f777cfd0,12,12,1,84,12,0,11040,1
62b2772f3428f8688c19701b2a21b436,256,131,4,448,256,0,01026,4
d7c67d14d5f86b62ce80df5748e1e019,86,48,1,602,86,0,05030,2
f08f3fb9c3b0faae45cb60ef03e4a527,123,59,4,215.25,101,22,05040,3
edc4cf322a2eae16691c2de6e471804d,27,26,2,94.5,27,0,14301,1
de28a0e8d223d33762e42b871589ec8b,88,57,3,205.33333333333334,88,0,10200,3
cc65e45fdfdc708d2689825acfba351e,36,36,1,252,36,0,09130,1
5d8a64e8a88868c8d2849c011cee71ab,31,31,1,217,31,0,01012,1
56d81451d59a011e35cd9181139c6c02,5,5,1,35,5,0,05030,1
ab7e764f60845bccebdf03e0bd7622bf,25,22,2,87.5,17,8,02620,1
b19e45f0bbce3a62a4242954ae9ebcaf,20,20,1,140,20,0,05041,1
18d1deca0a4c5f1b29a49e73c243ac2c,15,15,1,105,15,0,12410,1
63bd9c1b5081d08f8883068f34ee1d50,32,32,1,224,32,0,03090,1
90e745c78c5dd7de6bf3db66419f4521,56,56,1,392,56,0,03070,2
21e66c1b81a40b9a7926566e168f3cb3,101,79,2,353.5,101,0,10040,3
7a636f406f2fddf3969cfd527a1dc9c9,92,75,2,322,92,0,01027,3
136d9bcea37808dee2cf31416364ed94,66,52,1,462,66,0,05040,2
9f1fd3c15291cf935cd5a722dd5be02c,58,40,2,203,58,0,05041,1
023c9bb68b6527dd26102bcbf27802b7,129,47,4,225.75,129,0,09351,3
cbab3b640a7aea925187d0ecc0c91699,27,27,1,189,27,0,10153,1
fe09825f3d75c0a6c506da117ad71f98,81,81,1,567,81,0,10200,3
2bc783e1da49ec9e5ebec9342c2e5523,107,96,3,249.66666666666669,107,0,05040,3
f8272dd51ceff3139aabe52b1fdc7cd6,155,90,3,361.6666666666667,155,0,05040,3
5a219b7220cab9ec4f968eb75334f94c,35,31,2,122.5,35,0,13820,1
321bc910fd20b86f39cfd54640804489,100,82,2,350,100,0,05040,3
3a1a93267a9ee05f7d08f0946885762e,10,10,1,70,10,0,11080,1
c9ae585de280c7bf4717c4011e673150,103,83,2,360.5,52,51,10200,3
66e96d51002ccf5d29da4722225da71e,204,114,4,357,204,0,01026,4
c032339a76ec9291fccd9dd7136117a4,116,73,4,203,116,0,05040,3
f360050f3742af3b72ccaa511bad3438,40,40,1,280,40,0,05040,1
7de4a5951fa095842f4523fde707dfa6,33,33,1,231,0,33,01026,1
e4e65ffd934deaa33447eff9dd1b23f7,40,40,1,280,0,40,13830,1
fb42cefc139807e5167622d1e290700a,280,126,5,392,280,0,05040,4
d40982a2c56650b9f824d9aea33935a4,57,45,3,133,43,14,10101,2
0d654669ab00564b71c8bced45891540,18,18,1,126,18,0,12501,1
a6c6cb38592ad803a69201fcadbbd33f,59,38,3,137.66666666666669,31,28,05030,2
cc3fc74427df02685a4cc86dd8d44b1c,17,17,1,119,0,17,07144,1
58c398f348054c39baee3101bae096cb,22,22,1,154,22,0,01012,1
89ad6b56829ac83f2852cbecf561fcf9,24,24,1,168,24,0,05030,1
acc5f144fcb69dd7c7909d08efacf6ca,679,181,2,2376.5,378,301,04060,4
eba03f104d2029f23ace8f0e6befe783,200,116,3,466.6666666666667,200,0,01026,4
049aaaf8dc444362c867b35b022074af,21,21,1,147,21,0,10152,1
0f40b6e48b42aa8c10e30327a5dba667,112,94,2,392,61,51,05040,3
b167b272a93146a4f22fb6a90c815da0,238,137,3,555.3333333333334,238,0,10028,4
9fa4c4f171a3258a46670ce61705317f,28,28,1,196,28,0,03070,1
e14e944f0b27c803b3628331d4f6e7aa,30,30,1,210,30,0,11100,1
f838028b1b8506767d305060b4542213,211,109,2,738.5,58,153,09010,4
2d3d4029e5150367b7c8b60815d56991,120,88,2,420,120,0,01026,3
044f36ebc91a4654fcfbc5302f527f7e,121,73,4,211.75,88,33,03050,3
45421570844da12ded6c5d3b247e1b0a,144,73,5,201.6,128,16,01027,3
3d34c80aa43cf66c22c3dc9a91ef1f17,75,52,1,525,75,0,05041,2
f977299db1bf06334f4e0cbd44c7b4e1,49,45,2,171.5,49,0,05100,1
2f0bf4d119aab201139ccc226c82a5e6,56,49,2,196,56,0,01012,1
ea10f0190bf12fff4819af4438c9289a,112,69,1,784,0,112,01026,3
52aa4e37a67a6b7bfc7c215e995dd3c8,43,43,1,301,43,0,10200,1
a1a54244d797f0adbb7b78de9a950339,65,49,2,227.5,65,0,05040,2
093c0d419e980c8330ff8813a82b46ed,109,54,2,381.5,109,0,05040,3
b03fdc9d3cb05beb1c0d36f095d8dd04,21,21,1,147,21,0,08010,1
acf9f7eb3a1bf7008bb6c2961b862e74,76,52,3,177.33333333333334,50,26,05040,2
468be62ce04784be86d713baeb81723b,35,35,1,245,0,35,09030,1
6b268774348c58c959d0b21fde28338b,112,87,3,261.33333333333337,112,0,01085,3
875254984bf801a078d78ce58cd161d5,139,79,3,324.33333333333337,83,56,11040,3
62f7a43fa86ed564094739cd927160b0,48,48,1,336,48,0,05040,1
7c865e6cabb0a068ed1463f412b6c3e9,30,30,1,210,30,0,01026,1
956969b80e616bd222fd6b6a1ef0a694,248,87,3,578.6666666666667,248,0,09130,4
c463dc3465da02c28bb14086304e5286,60,50,1,420,0,60,09030,2
6271739de0c3157626fbe3b34aad1fec,36,36,1,252,36,0,01012,1
d8ceb140d2fc36526f085284f0535485,70,50,2,245,33,37,01026,2
0afb8c3e20d5ad692a8d7609cf77580e,40,40,1,280,40,0,01013,1
22176913f3a68541dd898a4acda2e3e1,15,15,1,105,0,15,01013,1
e0f10c43c0c0a7acf3d4fc7e6c8437d0,24,24,1,168,24,0,05030,1
317240175578c9ea88c57321524f7e6d,368,101,2,1288,1,367,01026,4
39434dbf18735d688bf65726b66fd6d2,71,71,1,497,71,0,01026,2
5a285648d08e5cde5307d0225ebb3136,255,129,2,892.5,255,0,05040,4
883c906436c5be14328f453daf9a78c7,19,19,1,133,0,19,01085,1
445a5713d6114ceab9b7da54cba98493,12,12,1,84,12,0,10200,1
464af38891eb271209fb1d47ae25a83a,165,91,4,288.75,135,30,06120,3
a929375aee58c108f5221fa336deb874,52,38,2,182,52,0,04060,1
e92d03915409dd130b89c5b4c19d2699,231,116,4,404.25,175,56,03070,4
b47c5ec971fe59e3c8bc6f80892533c2,37,30,3,86.33333333333334,37,0,11040,1
585ae7f929e096b2f2740af13283ca1a,24,24,1,168,24,0,05030,1
a2a483938056847ac657231b007fe321,5,5,1,35,5,0,05030,1
8d8e8650558bd372b3b84ba31b39b6c0,42,42,1,294,42,0,11100,1
a778f807d9a33efbc24d2706b70b3eb0,34,34,1,238,34,0,01026,1
7a517e383eda03d7b60c30aa9521c2c0,164,70,4,287,123,41,05041,3
a0ab1939d8d2f0ba47863c53db7e048b,160,100,4,280,112,48,05040,3
d7eb2e2a17de243ec13f4a014b0d9320,76,57,2,266,43,33,05040,2
b1c81df078eda1dbd1c51892ea97c6e9,236,143,3,550.6666666666667,236,0,01012,4
8ee58b07a39bc7b83e3ca283f50e355e,223,99,6,260.1666666666667,204,19,08051,4
e8a0f12037f5dc9900105e65c8869dc3,38,38,1,266,38,0,10200,1
21e36125a77efcbc4c07dab1693e01b7,372,175,4,651,206,166,01026,4
3436f8acf63ad0b1497eee031e44241d,84,54,2,294,84,0,05040,2
1003f82c854e12d62641bf07c14de02e,130,93,2,455,130,0,05040,3
e25b5ecd317e27a71d86173971d3694c,330,183,5,462,283,47,05040,4
cc2a38c0fb40d2aaaf27ca98da0bf244,2,2,1,14,2,0,05030,1
a651330daa9d5153a2076e963064aeb3,14,11,2,49,14,0,12501,1
431ba62fe4ffa0f1a9f2f7616dff5589,32,32,1,224,32,0,01012,1
3a5f6b0adf33f6ee90cc6e05d4b2ae40,335,142,3,781.6666666666667,169,166,05030,4
368e0de17aafe2af4497972bd72ab1da,11,11,1,77,11,0,05030,1
1c79446981c70ba3900f194b094d51fd,102,43,4,178.5,84,18,05100,3
52f0213ded38ed01f7c4386a1203b73b,30,30,1,210,0,30,09170,1
914aa64832a5bafe26a2f8b9e62a9842,39,39,1,273,0,39,05030,1
0cd56fe66009ca54667b69d8c62926bc,29,24,2,101.5,11,18,01085,1
d84c132e9b69b37d4961eaf49df10d95,92,77,2,322,34,58,05040,3
870f23f80364a6194e5156c8e44de84f,30,30,1,210,30,0,09130,1
68399ccd290796690b12560d96abae94,76,60,3,177.33333333333334,49,27,04060,2
623e766d61f31cca4804d39828c3057d,287,146,4,502.25,220,67,05040,4
5d925216216efd4ff91dd7594368f2fd,79,69,2,276.5,17,62,09030,3
840199b24e047fcc80873e461db1bf72,50,49,2,175,50,0,04080,1
c6fee635f3e21c7998b56791f767f73a,6,4,2,21,6,0,02691,1
6e5b0e939a5a143ef5bff3687230fe25,108,73,2,378,41,67,10200,3
02ff8a954bd520a1efeb2482c3547c14,51,50,2,178.5,51,0,09130,1
8521e0a21fd634205d63c20e0297a655,40,29,2,140,40,0,10200,1
e4f44538d3f4db89e1981a7cad38f4b6,37,37,1,259,37,0,01027,1
2ac5c8c21084a327e401ae63779796fa,272,151,2,952,272,0,05040,4
363f5a71f2fc975557206d8f86a5e998,19,19,1,133,19,0,03033,1
745b60aa1b985003e6f09a1ef33ee751,13,13,1,91,13,0,01026,1
da0581ce279acb35a63c43f0ce871c65,18,12,1,126,18,0,12670,1
36d407e5e7ecc24deade177d0782d66f,23,23,1,161,0,23,05040,1
b0880ebc60300eb0129918b2e2bab6a4,35,35,1,245,0,35,01013,1
7dca3a89209c99aece8827d8a03298d6,46,35,3,107.33333333333334,46,0,10040,1
4b70a6ca7ad5864c8b577fbc101c2e5a,151,51,3,352.33333333333337,151,0,05040,3
9b5f9a177569a65c8c3cdee53f3b2a88,71,61,2,248.5,71,0,04060,2
4c45b3248a72bf193663d79daaf7e0ea,81,56,2,283.5,53,28,10200,2
0b2d7282cbeb273261b895d95fe80224,137,84,2,479.5,137,0,10280,3
2e47fdbd22a86c0f6f2a3d2b7ebc2b50,109,79,3,254.33333333333334,109,0,01026,3
a967e9d5c6cc1dbcb29826e5b74c13da,127,85,3,296.33333333333337,127,0,05040,3
48b4f0bb4eefd7473fef366de7a12163,27,27,1,189,27,0,09010,1
7d6f35133fd8f33de2e04667e25d746b,28,28,1,196,28,0,04060,1
60cda8274bd0496b8e1e69a16ffb9713,352,90,6,410.6666666666667,334,18,01085,4
0aed33fb3a0e69b860b7f6ccf1ed5930,137,84,5,191.79999999999998,107,30,12570,3
f609eb5f9b8c10ec213f206ab1695f64,223,136,2,780.5,223,0,04020,4
66b438c2ec5b27fca4945dc80dd193f5,270,127,5,378,196,74,10200,4
07400e2ca5bc90eccb911f6dbc3fa87e,15,15,1,105,15,0,12650,1
c91353ad1d140019a88bbf99f8016036,286,105,5,400.4,286,0,04060,4
5c9f020cf96195e43066e8b6e8b09dca,46,27,2,161,46,0,02751,1
ac1abbf6f498d4b0e1163b65ebfe9623,53,53,1,371,53,0,05040,1
a65b0e9f4eb7168ad1c7cb8dac96f6fd,26,26,1,182,26,0,05040,1
37a086abcd71d05eb34cf5eab819d45b,133,113,1,931,133,0,05040,3
3a075062ec2a45dbd3edeb92115e62fe,124,85,2,434,3,121,05040,3
49e7a9b67fbefcba0644397a15cca9f1,32,32,1,224,32,0,12570,1
4b5b8f80a8c847148ecada2d0f928128,63,63,1,441,63,0,05041,2
460bdb33bd3a8ce9b95aee3cc9c35f88,23,23,1,161,23,0,02756,1
5d8b524880293b3bda90eae8c1414fda,114,79,3,266,92,22,01027,3
c536cf99df99034e8d5f4b50a8661d0f,235,93,5,329,214,21,05040,4
db0ad35a67945aa0839a70a042f678e9,21,21,1,147,21,0,11100,1
10ca1d1595cd5ef3f5f5d033a6175779,21,21,1,147,21,0,02690,1
8595e2d2b859054f3fea380a09dc9ad3,16,16,1,112,0,16,11080,1
0d64988fad64417b34180914c7a5bcb4,326,120,5,456.4,288,38,01012,4
ec31aa21fb11cfa55ec2bbc4b1f9f5a1,27,27,1,189,0,27,04060,1
bba48b208c060d2de93fdcf37db6a494,43,43,1,301,43,0,10200,1
1665677573f15ee26c5d9fb5b26198f4,91,61,2,318.5,91,0,08150,3
03c3ad10ab47e6c7a27fc40c3bef0d93,90,71,3,210,61,29,10080,3
5b6497151cc2eb6fd3c463ea5c240a6e,98,89,2,343,98,0,10200,3
b0d2ba0c04f5ad3996cd18e1d98d4932,155,81,1,1085,0,155,01026,3
439519a5d614b08aec81a362234dfa7b,336,147,3,784,194,142,05040,4
7252e6a2a5660260c04b3b76e7e3a136,263,130,2,920.5,52,211,06100,4
3eab38b21a8ea22e4605cc5d51ab51f6,258,109,4,451.5,258,0,01201,4
d4cfbf9c1d7a1df0165cdecf8e761451,16,16,1,112,16,0,11040,1
77ab8b66ddc2447a481a145361915bc7,1,1,1,7,1,0,05040,1
8f8eb5ad99f517ebd71f96fcac6f5b1a,215,88,4,376.25,141,74,08032,4
e5733850b304f73e5e0226ba38e503e5,16,16,1,112,16,0,01012,1
43d04ee6b5f829c1ed64f7c613d7252f,8,8,1,56,8,0,08150,1
7ebd54d1a47618e7adee84d25320c49e,445,110,2,1557.5,445,0,01012,4
5eb68c3e508eaa5bdbf1c8a9e4d7e5e1,66,49,2,231,66,0,05040,2
419741aa60c0e789d88aa25ea9995e74,338,155,5,473.2,143,195,01085,4
367677ffe505de4a87b02e97bd14812f,33,27,2,115.5,33,0,11080,1
940a2f55bd36f1c9cf6804b5370b17fd,4,4,1,28,0,4,11182,1
fce0f12a7b26f49ef09388f6dcd975ab,38,38,1,266,38,0,08052,1
79231967f6252780c8ea479dab578522,152,119,2,532,152,0,04020,3
da64d7eef53e152d25b1ad67f82783bb,19,14,1,133,19,0,12501,1
7faef8671ec53284bc3d090065fc3aae,267,119,4,467.25,237,30,01013,4
3d66526c08fb1b07fc8b0d30451b4be1,180,104,3,420,150,30,05040,3
d01d2947f8f582ebc2b48d1e67bc15f4,117,89,2,409.5,117,0,02691,3
a785e658b48929094d530267cd9aba27,23,23,1,161,23,0,09090,1
d401bf9de9c95e3654fc0ae8b0dd67a5,166,113,2,581,166,0,10200,3
8ad1a705441e93b5cd0ef5183228f996,68,40,3,158.66666666666669,68,0,11040,2
0aca07714461615ed6413dc14c93dc0f,52,46,2,182,52,0,04020,1
f4f4f6ae847500f01246277ba2ff30c5,7,4,1,49,7,0,05030,1
ab0171cd0e94a85802ab1f121a34699b,12,12,1,84,12,0,12501,1
c42f8cc493ec2b2ca909ef23188f624f,17,17,1,119,17,0,11140,1
33868ec457a124ca9934d6f0895ebea0,27,27,1,189,27,0,05100,1
367a29b5ca1173c71449b68f7632ebc9,105,82,4,183.75,86,19,05040,3
19aa23d5ea9a514432d9f710896eaea7,95,52,3,221.66666666666669,95,0,01027,3
8be10c7b1f6c85d921cb8112b8e56846,22,20,1,154,22,0,10028,1
b2ae3cb97a9b9b32cb7a76b9e83146a0,13,13,1,91,13,0,02690,1
df4a2759cb36174ad4b10a2b873ae9dd,473,133,6,551.8333333333334,335,138,05100,4
9ad9f6a0fd2aa31b03c8273da8e36668,84,64,2,294,84,0,05030,2
65a5531193a6931e64531c0e672a8e16,42,42,1,294,42,0,05030,1
1b109568da1519574458d42ff9526118,19,19,1,133,19,0,01013,1
1732f8eb065a41668dbc7218d4bde41a,65,45,2,227.5,65,0,11100,2
39cbbd392085adcefac098042cb496e8,139,80,2,486.5,109,30,11140,3
4c0dd383b2cec5bf7f5054650527486b,16,16,1,112,16,0,08230,1
2c988881fafa33fbdce980cfd242b067,3,3,1,21,3,0,13955,1
a7542f9ed9555abc83b5d1360ac09906,22,22,1,154,22,0,05040,1
237062747ccb63b1f9d4fb21798f4c63,280,81,3,653.3333333333334,280,0,01026,4
030968216f92b92e60a2babe2c3f3700,66,66,1,462,0,66,04032,2
7e4b86c29a2b1ed79c28743d2f354301,141,94,1,987,141,0,05040,3
24deb8311eb55f87faea014a94b847dd,126,90,3,294,126,0,05040,3
bb9218c6047cd7b0dc15f0dbf4d961de,14,14,1,98,14,0,12570,1
1c4e14b32efdb8f9091b55bba449901c,272,116,4,476,272,0,08100,4
e1d456a7a0d46a06f99ba91d4ed3c9d9,23,23,1,161,23,0,09010,1
a36e29221cfa49d0e98d3eea1e09477f,39,39,1,273,39,0,05040,1
c2b1f02ce8b116e47f59562d41c63f0d,9,9,1,63,9,0,08231,1
e6cc6138b37c0fd2e9c04ab9ec552a03,36,36,1,252,36,0,08052,1
ffb84af8df6ab620376830ef0d57846f,131,94,3,305.6666666666667,131,0,08052,3
8c63555d5a4311f4b86f605d062713ed,92,52,3,214.66666666666669,60,32,10240,3
78fa20e4e62b43cc86748a8ba57de5ee,57,57,1,399,57,0,01014,2
bcbe8897594d26546dcc9e6fb2d78f3b,162,104,3,378,162,0,01027,3
654ff3594239bba2a72e8f16659cce67,82,60,3,191.33333333333334,65,17,05040,3
a61b642fa403c5a096eebc6aa42015bf,17,17,1,119,17,0,09130,1
33b0353ae5c3595a85275f7e1f5afac6,54,44,1,378,54,0,09090,1
e27ec0b6f417efcf067746f1647eb02b,31,25,2,108.5,31,0,10028,1
ca90af9ecd16c672542785c96272233b,54,54,1,378,54,0,08230,1
d5caa7fc94f5df40cc13653547039ed6,134,43,3,312.6666666666667,134,0,05030,3
e800f2f3d1e77e76f9c4b20e613f735c,98,84,2,343,58,40,08052,3
4adf2e5191760c3f5fb10b19f3ecba49,20,20,1,140,20,0,10220,1
466fa25f967464d428e84fe3f5fca382,34,27,2,119,17,17,09130,1
4b566b2a383970aa35f54b76553bd74e,256,93,5,358.4,256,0,05030,4
dd12da0b963bd96d02297d715768a994,147,86,3,343,106,41,05040,3
21fd3590bf6b30246361229edd79dd6a,48,43,2,168,48,0,11103,1
853fbd35d262f7ea5dd53aa699819d06,29,29,1,203,29,0,11100,1
20ac5f7540ca40fb1fdafb59eb5f02c9,21,21,1,147,21,0,01026,1
4f3370e96a5c592047fdb1e6b3a71d87,12,12,1,84,12,0,08052,1
53feb65523c9b286b18623abb96c1aa3,43,43,1,301,43,0,05030,1
ae59b2c855c64bfe94eedbc59e626bfe,67,47,4,117.25,51,16,01013,2
0d23e22cff80d465175ae89d20491ed3,216,122,3,504,216,0,09130,4
ea01745f2ba35ab45c3f98e1ebb40298,74,47,3,172.66666666666669,74,0,05030,2
80f0c2ca8541ade35cc526e4143a3f6c,19,16,2,66.5,19,0,01012,1
bf46435dc48de2bac2f10aaf2775a415,17,17,1,119,17,0,01027,1
11141b38a2191a6d2d1c7cf78c1eb73e,43,28,2,150.5,43,0,08230,1
f47fd7b59ac30d464536bb6d041db1e7,52,52,1,364,0,52,05100,1
393f95cefcac101144b656a086c95869,32,32,1,224,32,0,01013,1
c062a3b444e295b623f6fee8c3e56845,8,2,2,28,8,0,11040,1
865d1707a69d81c6cd94bdc127b9421d,121,83,3,282.33333333333337,121,0,05040,3
d24c3bd7cbfef3ba93a9ffdbfa5cb23b,85,67,3,198.33333333333334,55,30,05030,3
63f7eba205efea2c7b9c7f60c0c3df3c,59,50,2,206.5,59,0,01026,1
ae99f6c8dda6fc150f7aa2af988aab49,90,72,2,315,90,0,10200,3
0b8a42add2c21906775acea115d4da29,77,58,1,539,77,0,10200,2
fde70bb608f9baa0d3dd104253528763,27,27,1,189,0,27,04200,1
8b9ad8ddc98f141cf24cd9ad3280ed25,275,90,3,641.6666666666667,275,0,02751,4
7ca15f3723331db6bdaa57809ce2bb2f,186,104,5,260.4,122,64,05030,4
018f8506e2f8d2673164c07b0f66d515,161,109,4,281.75,108,53,01012,3
92e84957044fd18e93f26bb451dbfa22,25,25,1,175,25,0,10153,1
1cc4a6019c3c1dce803eebc6d11bd3b0,5,5,2,17.5,5,0,11040,1
d5e72978c8967e4ffbeab12bf6b08fd2,70,53,2,245,70,0,04080,2
7cdf0e9c471578c0aa8aa500517eada9,105,75,2,367.5,105,0,05040,3
ab7168167616c3b973fc7c17cdc20014,77,61,3,179.66666666666669,52,25,05040,2
3ffa10dfbac80e454cf497d43e4bd64b,14,14,1,98,14,0,01026,1
c6309ef73375164cb501263f384184bf,19,19,1,133,19,0,05040,1
e35d492d367824d8cbcf8c21ef00f1f9,324,161,4,567,191,133,01012,4
11481791a24f42b733495375511b00ae,21,21,1,147,21,0,08230,1
5406826b7ee87db82f95584377e5fab8,89,64,3,207.66666666666669,64,25,10200,3
1eff7861bfc56b50a04d151ca9aca939,97,80,1,679,97,0,04060,3
2eeb34a4f57dae68bb6523fd54ebbd4e,195,120,4,341.25,195,0,10200,4
d7ef2a021b0917ce4b13ba0e78d090d3,146,82,3,340.6666666666667,146,0,04060,3
49d890a730a723968ef199329c58d193,63,55,3,147,14,49,09130,2
f8a16946a5ffc6739b219a620cdd4d62,79,66,2,276.5,35,44,01012,2
2526e888907a3a2b2f0065fc7ed459a1,195,99,3,455,195,0,05040,3
3f9a681ee74d5ca4287777eed27c0b51,144,62,4,252,144,0,11080,3
35d347e89d12b117e6f027631cc41b3d,128,61,4,224,128,0,01027,3
0b9e42d99048e342c7d9024d6c47cc78,53,46,1,371,53,0,05040,1
41f38328f04893a08b714c1de4f7b9d9,51,40,2,178.5,51,0,08150,1
540734cb35dee14b73683e2f62434fde,116,71,5,162.4,77,39,06120,3
a5d94096b0a0f6a38fc4c7e556058c25,70,66,2,245,70,0,10153,2
26794da95c05463fb544c4fb0b6f6aa9,9,9,1,63,9,0,01027,1
ba0e7a9aeafaff9a96b4a2a6f33be4e5,7,7,1,49,7,0,05030,1
896bf8d0388a72ad340f25434e68ccd4,64,64,1,448,64,0,01026,2
ff21363ed220d0c4eafdc85dcd2da11b,200,126,1,1400,0,200,13830,4
b78d49cff36d8180c5d1a57a0b170d3a,7,7,1,49,7,0,09150,1
34f0543e52e33be88898ceb8f20a3de7,55,45,3,128.33333333333334,37,18,11080,2
f6861cde5d24dd5e4b471d3872953857,45,37,3,105,45,0,09010,1
4c3393c0cb129268d48e96b8d46a650f,12,12,1,84,12,0,12410,1
dc62b68b3812cf6820310f667f1d62f0,96,70,2,336,96,0,05030,3
6a243351cf15e136515d339465f9db24,35,35,1,245,35,0,05100,1
f2684a6855e1df6ee861dd6f20f75be3,54,54,1,378,54,0,04020,1
7bd17fc5af7b426e3427bb8026a04cd6,7,7,1,49,7,0,13830,1
a599954fd306a9e3013f7329d6278b91,68,53,1,476,68,0,08230,2
750df0c42d0112f1138472355944e008,74,59,2,259,74,0,10200,2
4771fdb38edd7dc73175fccca8d87a30,59,50,2,206.5,59,0,11100,1
bd20b5b0e876c7fac5553a51f625a9ff,313,91,3,730.3333333333334,290,23,11040,4
d22c5b02c456b3c251672ef8d47c2b1d,76,60,2,266,76,0,04060,2
955068c7b83e6786619c3bcc6a563938,37,37,1,259,0,37,01026,1
33dd693c58814a84d6c3e4e42bb13fdc,2,1,2,7,2,0,13791,1
f025972de4f40650539304a48f05b1bb,241,61,2,843.5,241,0,10153,4
a1ca689b94cfce9ad5e3fb1ec5e27d79,95,73,2,332.5,95,0,12570,3
4c0c506f93810ad504359bf51533f7cb,15,15,1,105,15,0,03050,1
ed8baf2cafc6129661ab2dea30f42ba4,194,100,3,452.6666666666667,165,29,05100,4
74c9e1c90765675d3aa8bc60ac13ac0a,189,89,1,1323,189,0,01012,4
722f5500af0bf5f3b36b095ef68a15be,36,36,1,252,0,36,01013,1
ae34332265bc3d11c73321aedf273a41,29,29,1,203,29,0,01012,1
d5f708f8dd9b8946cb386dcdd43177b4,321,143,5,449.4,210,111,01027,4
4e50a5cbb94083112478fb463da5d45e,23,23,1,161,23,0,10200,1
ef09a0e560eb96cafc620ca727815d91,323,92,5,452.2,323,0,10200,4
586b9b2886dd3e54abe0b5194c5055b5,143,89,3,333.6666666666667,143,0,09150,3
ffee77bf8e9f36c3aa965d5f88c91c99,141,103,2,493.5,141,0,05040,3
8a8dd8315eb783bd4b4bb4b115886c25,20,20,1,140,20,0,09351,1
43d0a36902053e02ad05474904acc077,69,55,2,241.5,69,0,01085,2
a4fb4f878d5fe59a3a51d49ad19e0773,203,81,5,284.2,170,33,11040,4
aa601426060891a1f7cc6dbcee99cea3,290,149,5,406,245,45,04020,4
fa5dd43f0a55bfa534639e313f1d8450,124,73,3,289.33333333333337,74,50,04060,3
21fd425322751806b0194c2ced4e8cb8,1,1,1,7,1,0,11040,1
039b7c8d250d665fac6687a02b0a9a9d,56,56,1,392,56,0,01026,2
92020725db4ce2cc84e8c173e428c71b,179,138,1,1253,179,0,02620,4
227acf0aff0845f2fb7cd10acfbafc5e,211,118,1,1477,211,0,05030,4
4d5cbb11e265bbfbe7d4a0f68d70d59e,118,75,3,275.33333333333337,81,37,05040,3
6f0253f8caf6604c69d2028b096729da,68,52,2,238,68,0,04201,2
76900acb2111d2540d6dec83fae9c269,3,3,1,21,3,0,11040,1
32600db4de03a701e339bd832b3e70f4,36,24,3,84,36,0,08150,1
1657e826b2c68fd89c6693b8f760ee6a,4,4,1,28,4,0,05030,1
58a936566826810608e2da3ddc8bcdd3,43,39,2,150.5,24,19,01026,1
ab4adc2230efc095d837262fdde7e8e6,15,15,1,105,15,0,08150,1
461d724fced80d1bca9053005fe5972d,4,3,2,14,4,0,10200,1
e5c29d255aa6d7588c90a7032d8040d9,3,3,1,21,3,0,05030,1
cabcf488ce9f47bffe5f6945727944f0,121,81,3,282.33333333333337,83,38,05030,3
ffe9b6f6c83dc36576db01e4dda7f7f9,253,116,3,590.3333333333334,253,0,10200,4
2885b9f54a8d4013e69f78c73f7aca9e,106,71,2,371,106,0,01012,3
012e9024523cb63c0baf3c26d1bacfae,60,47,2,210,35,25,01012,1
e2f990776f892f74e14c6e2d21b7c6de,255,138,3,595,255,0,01026,4
48fe379fc39a04fb9ccf466dc758ef22,50,42,2,175,20,30,05030,1
956510ec084e2ae8397440567aeeed9c,130,72,2,455,130,0,01026,3
65154dfd391e994703822f81619815f4,128,91,2,448,128,0,10200,3
719e527955f2486fa9e80a9ab6df1bcb,35,35,1,245,35,0,01027,1
909520287ea236ec4a805527e2fbf494,7,7,1,49,7,0,05030,1
c77155086aa5bb0ce16cf5c7241a6b59,31,25,2,108.5,31,0,05040,1
787710d3dda44ffe98547b6e408972d4,28,28,1,196,0,28,03050,1
e1a633c4b2d08ea6fb052a648d00606b,82,68,3,191.33333333333334,82,0,09130,3
8e214bbf096f832c623f0a987cb06bdb,61,61,1,427,0,61,04032,2
77eb4995a4102d991fe45bd9bfe52d70,283,104,6,330.1666666666667,244,39,10200,4
ba26efc9adcd6f437fa596d574256db5,5,3,2,17.5,3,2,11100,1
741b82f78e7275f9699a6bca26ebcb33,18,17,3,42,5,13,02620,1
c987cb29516bad523d82bd34a92d6f10,13,10,2,45.5,13,0,10152,1
f575bddb0c316d788056f7047ea20e95,88,68,5,123.2,58,30,11080,3
4a816fb52135dd6f3d03c22ecaa00d51,51,51,1,357,0,51,10200,1
1ffee8d534bdbf666a128cf0437f84f2,343,182,4,600.25,343,0,11100,4
0ae025356bd9768e2893b36750dc0c10,5,5,1,35,5,0,05030,1
20e15cbb6b30b4ba0e50407e96852053,42,42,1,294,42,0,10261,1
cbc2d3562d29e5f26331a3c7654feddc,238,83,3,555.3333333333334,140,98,01012,4
d2c3cf6a1e0020914a4132d59bfc465b,37,31,2,129.5,37,0,08131,1
2b8ff60b12cd2ea906111c9573cad73e,137,106,3,319.6666666666667,137,0,09010,3
9844601fd3387867fbc85b4549c1d9e5,78,49,3,182,78,0,04020,2
d767bc5034e25ffa84a821a4dcac2708,257,114,3,599.6666666666667,196,61,01085,4
dbc9eaa0b4308883c707dae55c0fc17a,336,164,5,470.4,249,87,01027,4
ce71b42abb8fbc04c231b7588a16e1b4,87,47,4,152.25,60,27,10200,3
7aa961dd53ae2984121a248cf95adb22,189,86,4,330.75,135,54,10200,3
c1632ac586e7017efc238221f433a9ff,77,66,2,269.5,77,0,05100,2
53b71b7fb3fd7d267257247f2a16ce47,29,29,1,203,29,0,04130,1
1accc4b2175bb82049a6bc60196cbbc4,5,5,1,35,5,0,05030,1
e850209e72da78adbaf186e4e7bd19ba,233,85,5,326.2,202,31,05040,4
b7c81b6a5cd2c9300d0c608a9974a555,31,31,1,217,31,0,02691,1
5a5707efd6377ef1c074909f7da8ee9c,133,93,2,465.5,59,74,10200,3
7178bd584cec22491ea605cf0aaa491d,115,66,5,161,63,52,01085,3
f3826ca60bf88eba6546dc26c5cc692a,8,8,1,56,8,0,12501,1
a492797b4f9e891677a04d98122a432a,128,69,2,448,128,0,05030,3
b2385a432c8901642a5eebfdaf33b388,149,89,3,347.6666666666667,149,0,09110,3
fdc20a1a5935d8ec1ec688f676d05f38,52,52,1,364,52,0,01012,1
92c7c52b05a6867c0dff360ae2068e22,29,29,1,203,29,0,05040,1
18bd33f40ec19bfbc3f69e56cf70b533,115,87,2,402.5,115,0,01026,3
9a3a881dd3bae229ccc66adc83492d96,30,30,1,210,30,0,09130,1
49606d99477ecc371054eb522cfada2e,3,3,1,21,3,0,11040,1
78984e145c560ba4ae890701da8081df,216,56,5,302.4,198,18,05040,4
52e1f0982578f0c99ba29e5a5749b711,94,47,3,219.33333333333334,64,30,05041,3
fde7e7f0036dd9a0ce0f79ed0a1897dc,30,30,1,210,30,0,08010,1
58db17a26a2327bcf54daf6bb7b51e47,23,23,1,161,23,0,01012,1
09974482e5ab270c5d0b7e7d5ae099f9,29,29,1,203,0,29,13877,1
eb54ea20a8a5e4b91e4ba6d2d4e512f6,162,81,4,283.5,162,0,01026,3
63511f16b84afd23f6f0badcee14824b,223,153,3,520.3333333333334,147,76,01026,4
5e5076d56d5b3ea8c5b1879cc4bbe160,109,61,2,381.5,109,0,09090,3
60dd1c9ca2fa58c2d72b5935c1acdbed,27,26,2,94.5,27,0,05030,1
7b173f5f6e9b932e730cb673a9a081ab,424,188,5,593.6,380,44,05040,4
acdb33e6624123c19c884da57edcf504,95,85,2,332.5,95,0,05040,3
38ec0024653ec86d8738b9f290f7798d,231,80,2,808.5,231,0,05040,4
ed79da858b98b9464d3b2aa107d41bc0,129,99,2,451.5,25,104,11140,3
7fc5531f4501436feebcfa744ace7291,49,49,1,343,49,0,04020,1
ca606970452550fef0ad9c13be7ce5b1,522,138,2,1827,37,485,01012,4
b6e1141ae49b8baaf424e43d6adc9184,302,74,1,2114,302,0,05100,4
f2ff4f3fc046d34114e65786f84c119b,52,45,1,364,52,0,01085,1
1609b2ecf60e3f0ffb623bdb09159302,93,52,3,217,93,0,05040,3
ee6f9420a74f16343825245b3c623b8b,70,60,1,490,70,0,05040,2
cde381b1124f0e775cb018c1004e65d8,4,4,1,28,4,0,09010,1
c57e302ea810708880ac8c698274fa33,53,52,2,185.5,53,0,05040,1
f7361537a6abec275377f540607bd530,30,26,2,105,21,9,05030,1
77c37de3a6d14c8fcbffd08f65b146c8,10,10,1,70,10,0,09130,1
b3002ee2656c78f6d9a583c239833f2b,66,66,1,462,66,0,04201,2
d878617ebf9c452c2234c83033cf56b5,23,23,1,161,0,23,01013,1
93f6a5e0256e9b4d012bb77f66dc614f,41,25,4,71.75,35,6,11080,1
887b50513103780f23ff84caa8a026b0,35,35,1,245,35,0,05040,1
7f0a37ee0a6c218e4f34d679a34d9906,109,58,3,254.33333333333334,108,1,08390,3
6836056446ea77936838d1fe602b2d8a,42,31,1,294,42,0,03050,1
0e8fb0c60b69a26806d1f1c2e978e242,45,28,2,157.5,11,34,05041,1
eefe1f9563b64b09121c9225c2f98525,46,46,1,322,46,0,09030,1
d79abb2707811c964c4ae362f5b420c2,225,105,2,787.5,19,206,03030,4
3bdcd2cfa92708f0e77a1f7dddecae4c,45,42,2,157.5,45,0,05030,1
d7bae080e35fec30720125236aaa40db,58,43,2,203,58,0,05040,1
4735b2dfd07cd2560395c97f568c9668,60,53,2,210,60,0,14301,2
ece18cbbffc4df91488e0809377ea864,43,34,2,150.5,43,0,05040,1
b9740ec44b12c78bed20691d2957bcdb,64,50,2,224,64,0,05040,2
5a8d0a984ba3ef46a27d302a80ec9953,325,160,5,455,325,0,01012,4
564bc7a1ef8ec28de4d156a1b9c418c3,96,66,3,224,96,0,10140,3
e0d5584c05a1614f506cd5b055a45b9b,15,15,1,105,15,0,11040,1
9bb4203871a602a3c6951051648046bc,73,66,2,255.5,21,52,05040,2
3b922ac431134ada0db21ee32905fc03,48,36,2,168,48,0,10200,1
dbc2ed4fef878c1ecdabbb96f9692626,35,35,1,245,0,35,01085,1
c5b3d11e9dbbb7a044705ac1a2661f9b,39,39,1,273,0,39,09130,1
ac7b1792239813efb70ca76e32488bf9,211,112,4,369.25,127,84,10200,4
64cca71d98af862c58e93dd777be9737,110,84,2,385,14,96,10040,3
97c3e064420470f4268d8d11b97be756,280,114,4,490,227,53,05040,4
99baa9c9ac7872697211fc91a4aca5a8,1,1,1,7,1,0,09010,1
bafe84f2f3084ad9dc6f9c7dc09ccec3,89,59,3,207.66666666666669,89,0,01027,3
cc5e5839f61dad7192a438a3f3c1083a,30,30,1,210,30,0,01085,1
a224db1e61073cd53ec9aca7c04b9f1a,67,34,3,156.33333333333334,67,0,10080,2
5e105c8874507d48d9d0d920f63af915,21,21,1,147,21,0,01012,1
361b350fe2dbbde71ff3002ba94c935d,80,48,3,186.66666666666669,80,0,01013,2
14ffa92416241d95187e1264cf17ac7a,107,44,3,249.66666666666669,107,0,08031,3
7b9baf5fdfd235dc78bdea2690f44ea1,322,154,3,751.3333333333334,322,0,05100,4
a3c6e730661a52f30d76a638342af39f,19,19,1,133,19,0,08032,1
2badd2d2ce92531219181ec85972ed13,363,149,4,635.25,363,0,05040,4
b010756caf72b9abff1217e9c0aab0bf,56,41,2,196,56,0,05040,1
34f7c9c483982c005c0f129ebfb9c133,22,22,1,154,22,0,01027,1
8f6100bf8f5e037f6d06f0592c1eb35f,266,125,4,465.5,225,41,02690,4
21bc98352cdee6726f2f05b1ad7f2bf4,63,50,2,220.5,63,0,09030,2
19df9fc4b8cf79eeb45dbf7cd59877b9,99,48,3,231,99,0,01012,3
97d0ee7201226dd2affc4a5cca3ec2fc,55,39,3,128.33333333333334,40,15,04080,1
8b66712fc897be4b502e1479a3baab86,25,25,1,175,0,25,01016,1
491d21e1bac3c02664dbb7f10e863476,2,2,1,14,0,2,12410,1
44e212a54335dc5ec08324ad068286ad,22,22,1,154,22,0,01027,1
24abf1e6decb3a1981ac250876892375,75,59,2,262.5,75,0,01027,2
2abc1d3f415dbc9c21568b02a1a584f3,202,72,3,471.33333333333337,202,0,10220,3
0a306aecb00afa1a3a861232d9d2730d,31,31,1,217,31,0,01026,1
96dec4d73438fc1e0411096b766a0d0d,34,34,1,238,34,0,08314,1
b980b6ef33f63dc886c5981a355020ec,37,31,2,129.5,17,20,11080,1
f6f63a8df7b8d10167153dba5723c816,283,156,3,660.3333333333334,283,0,05040,4
22702a83aa14d31322c82ead955ca2cd,145,72,3,338.33333333333337,90,55,11080,3
d3f1f733224838a1539ad11a579c14bf,101,76,4,176.75,101,0,01027,3
2a511271077261142dabf2787c6a6f78,14,14,1,98,14,0,10200,1
0a6d753bbbd86dae39649063135abb38,49,33,2,171.5,49,0,01012,1
21f2c335e554fd1299f7409a905a863b,63,50,2,220.5,63,0,01026,2
cf4515cc09873a317fb2909b20326e18,13,13,1,91,0,13,03050,1
71721bd02703c8601f0767bb4fc09e2d,96,83,1,672,96,0,05100,3
7884a4f1d8c458e5562450a5b9163737,72,72,1,504,72,0,05040,2
9cbbf5cd056f03e4cf5b78a8db5902c2,34,34,1,238,0,34,01012,1
89c37cdc81a8565ddf3be89c9adc302e,51,51,1,357,0,51,08010,1
d2625d35e4246cdcb83302d9e7ece87e,103,80,3,240.33333333333334,103,0,10040,3
affbb26088ea4561971683453594e5fb,32,32,1,224,0,32,05040,1
30c1f6b09573c7a0049551878a51c63f,18,18,1,126,18,0,11060,1
03783b03544f676c2499b86e2a4d4819,36,36,1,252,36,0,10240,1
e3e115d2893cf00887e2712bf5a1905b,73,59,2,255.5,73,0,04032,2
905977dedde5da50d0e5c6ac21ac27db,55,55,1,385,55,0,01201,1
80bb15114661905a5381f8518269dc86,40,38,2,140,40,0,04060,1
fbefc597e4c9b16963c1dd5b8da884ce,46,46,1,322,46,0,10240,1
6c3909c4a42ecff4a5c8a0ae7af793d1,18,18,1,126,18,0,10200,1
2d0842b5419f096583d985eb50959bb2,11,11,1,77,11,0,11080,1
de6981c43b417cd7aa4ef7a4635bcee0,13,12,1,91,13,0,01012,1
06d7d0594414a535b5fddf9e2a57598c,142,104,2,497,142,0,05040,3
2771c6a00c691e7cd701062b5eac157f,126,97,2,441,126,0,01201,3
8f6f93f5cef18273f414f0acd0b38dff,217,69,3,506.33333333333337,217,0,05040,3
5017c6886e05ff2dae05a650c1d03018,569,163,5,796.6,531,38,05100,4
f557bb2ed210060ad27d1d349cd59fcb,15,14,2,52.5,14,1,05160,1
2d6424390eddd7bfa0e8fdb684a4427c,221,57,3,515.6666666666667,109,112,02690,3
3a2ffd89eb85808c9a5b8a4d0b7e04de,548,233,6,639.3333333333334,390,158,05100,4
7ad48ddc4cb48a91a265c52a65809c90,16,16,1,112,16,0,01013,1
1ea550ec409b6f201503cd22a9c23e85,29,29,1,203,29,0,05030,1
aa3e35d3cb0169488bb559661d6fb640,103,35,4,180.25,103,0,08132,3
2d92f25a757e56d1f5c594feef1383b9,32,32,1,224,32,0,09351,1
caf9ba51420eb5691ca25074a3c32d3a,279,124,5,390.59999999999997,279,0,05040,4
9e8fe1a6890be417e3ae6dd74fc6f90c,42,42,1,294,42,0,05100,1
ce996811a909f7460775005d542eadd4,25,25,1,175,25,0,12590,1
a15a151148fd0d6cf403e0fe5c6cd6cb,32,20,2,112,32,0,08312,1
c212e27a7ffa5cd0b534828641e5e68a,118,91,1,826,118,0,05040,3
9005ebecfe83caea4c9728c80c33203b,164,115,2,574,164,0,01085,3
5fc2389ad7c20895659ecb8d8494da32,6,6,1,42,6,0,11100,1
d319b75a10774cbf58c28711345a9c3c,18,18,1,126,18,0,05030,1
2a8a6653d8647d2509d087d72e49ca05,12,12,1,84,12,0,01013,1
7989aa5c7fbae3648cb86b99bb03f860,46,30,2,161,46,0,07143,1
3c16ad5c77520f33b42b1a8cf2a643ae,64,64,1,448,64,0,05100,2
a7be17d7c35ee8cc827898f7e7ff8efd,198,140,2,693,198,0,11060,4
13331ffd3ede2f76ec3acf1ff3861dca,41,41,1,287,41,0,01027,1
8256f66cf7f360b1cefbd6ccacd964ee,282,79,2,987,1,281,05030,4
3d311b72562046a8d09714ed4cd79c67,78,44,2,273,78,0,05040,2
88112c1c95e42cdae8e2ea36e4eb157a,9,9,1,63,9,0,09010,1
f90316566d5a936f97b27ee41d2dd7b4,3,3,1,21,3,0,08051,1
08035d9e2a32eb0ca9e81fb8fa307722,17,12,1,119,17,0,05030,1
055b9ba56a3d70f933a2e2a8e0f486b5,40,27,2,140,40,0,12570,1
5e7b552bfd56a60ac32fd45e03f60334,108,81,2,378,108,0,01085,3
5d73a1f42c580067deaa2194ead9c57a,27,27,1,189,27,0,05040,1
43ef0b3a299806b35d6f9acfec777842,45,45,1,315,0,45,02751,1
56b7f7f0c6ab1035a9605cbb4ce230d8,33,33,1,231,0,33,02650,1
2e153e263e83b638c21888e70530b01a,69,56,2,241.5,69,0,05030,2
533e1b170262c315789e8a6f8a8b9217,27,23,2,94.5,27,0,05040,1
961ae5049a2ea05310fba0ed6c6e6390,56,50,2,196,56,0,09150,1
0cc9eb289abea76f5b5347c5a398a700,206,97,4,360.5,149,57,04020,4
e895e09124c176427438114794a87727,32,32,1,224,0,32,05040,1
85d3502fc69ad0ec74a75753e3d2afa8,42,28,2,147,42,0,08032,1
9943e15149c7d26312ebae0d1b2854ee,102,48,3,238,66,36,05040,3
b13da0bcce98c3357e77e92333a6e64c,10,10,1,70,10,0,11040,1
c47b136348f54e78b048ff151619a414,403,167,5,564.1999999999999,403,0,10240,4
1755116e8f581308e86d298b173457e9,26,26,1,182,26,0,04032,1
c7eaa3eb1fe3707fc94db98284ac4080,33,33,1,231,33,0,01026,1
41b9da47266461f2846e45d0187d4ae1,42,42,1,294,0,42,01201,1
6d2e110f3c75f5d3e3dd55b2cea94b37,53,44,1,371,53,0,05030,1
589c5dbe7f56dc5c16e536d3feebf493,98,67,2,343,98,0,10200,3
a83e7fa419d24910d1dc999e98d8990d,15,15,1,105,15,0,01012,1
7130aa85bb4c7626387111172549cbfe,2,2,1,14,2,0,08100,1
2cde92b34186990b37f96047840270ab,98,54,2,343,69,29,01026,3
813bdc06c990793a292b05fe9c2cfbe6,112,83,2,392,112,0,01026,3
4d8cd2c1371aef6c4f2f6c50bacfce9a,40,34,1,280,40,0,01085,1
2347d89d14d3c55a78c027b30a67cc96,124,65,3,289.33333333333337,48,76,02691,3
233b83e621bb855a23dec382a372da85,22,22,1,154,22,0,01026,1
36eef8b8d2173039ba0c6d64be480f5d,72,65,2,252,72,0,04020,2
226ee16bf4263f7a77615db8f63e5bf1,91,66,2,318.5,91,0,01012,3
43742c7751658d9d195883f11bd45e0c,27,27,1,189,27,0,03070,1
e0557060dc5f0984f72240eb24db964a,228,100,5,319.2,120,108,05040,4
d631aa21f444d8133edddfa73a9ffc39,71,64,1,497,71,0,09130,2
f123450a9421c041d5ae97bd3942521e,69,59,2,241.5,69,0,02690,2
fbd3e70db8c35a5714828e12130fa600,324,116,2,1134,324,0,04201,4
d4b9e3a5bd22e70f1793e17a1aee587e,15,15,1,105,0,15,12470,1
547f919f2b5741b506c5a8782f523f77,49,49,1,343,0,49,08010,1
ee7adabe20ffd4c1ef78d617a8c9a5c3,10,5,2,35,10,0,13530,1
155adf49afae41457569103b5dbbff2f,387,152,6,451.5,311,76,05040,4
b24599f4e65ea1fff55c7531bb28952f,224,123,4,392,224,0,01026,4
337646c54331ea5186c5bc2d2561ec38,37,37,1,259,37,0,01012,1
49cf402617351fdf5903a3f5183fda63,20,20,1,140,20,0,05040,1
aa6d85081a2a7227996c46f734a84cea,36,34,2,126,22,14,09091,1
fce3c7a8d41824e4f3e63509a267519d,23,20,2,80.5,7,16,08090,1
8a344d156f0a39d6d808a85b9e2af5af,401,142,5,561.4,360,41,01013,4
2cf9a916930e32963218540861b402bd,48,48,1,336,48,0,09130,1
e8bcb1fa453deaa30ee4ce65bec5d0fc,334,139,3,779.3333333333334,203,131,01013,4
421b75814ac29a6696d36715e668c4bd,89,63,3,207.66666666666669,59,30,08052,3
e886c4a23414e627847e10f1b0050821,460,146,6,536.6666666666667,360,100,11100,4
16e818484fdfdf236e29ce770a5b7801,275,69,3,641.6666666666667,275,0,01027,4
c75fdecc6807660e3bac2762e44ab5a3,52,52,1,364,52,0,11100,1
7bfe2d5704f4dd41272ac5a82f6d001a,152,107,3,354.6666666666667,79,73,01012,3
bd33ea44962c70456b235ef2823c2367,1,1,1,7,1,0,11040,1
51fb63a5a2c2f8f10f005199c5c2930c,91,78,3,212.33333333333334,69,22,05030,3
adef8899c5b7d9412e6e2cd7d34f1704,12,12,1,84,12,0,05040,1
dd9608d3b423171201b5886bc00c75b9,31,31,1,217,31,0,01012,1
8d6e83a0edb796558b8a95abb45ae6d1,66,65,2,231,1,65,05040,2
ebdc75ecab3610ed189492d853a31edf,243,149,3,567,222,21,10200,4
514b682cfe5486402d651c225771b086,23,22,2,80.5,22,1,01028,1
db8b8c209a809adbb7e80f6c350b26c6,257,136,2,899.5,172,85,01026,4
5a047edd2d550ff7cba1dde6f0d155ed,167,56,3,389.6666666666667,97,70,05040,3
c7f82e5c51bf8673259bb9eed66972e1,74,59,4,129.5,43,31,01026,3
1d0009a603ab56ae5dca6d943160f9b0,20,20,1,140,20,0,12570,1
4c22cadb6135b170bee9516352277f6b,41,41,1,287,41,0,03090,1
cd37fbcd5bbd1d6a1658b49dee778bdd,155,77,3,361.6666666666667,66,89,11080,3
e63aabbf8d7299b755aefc20ad1d83ae,67,62,2,234.5,35,32,01027,2
cdf98c05d6f1cedc621d2c669bafa1a9,148,66,4,259,120,28,01026,3
754acf036616c6eece5d19ed7ce5f958,60,44,2,210,30,30,01026,1
f7cebbe69c2f484bef2b4630c9c40c45,7,7,1,49,7,0,05040,1
ca57a4bca03b2780441b61a602df0e3d,62,48,2,217,62,0,01012,1
9aed6233f5be3c2c24eef09612927cd1,35,35,1,245,35,0,01026,1
a0fb3166dde671f2331d2358cb2e7639,281,106,4,491.75,281,0,01026,4
59ecdd17b2355154b9746ab66ee668c6,189,102,5,264.59999999999997,93,96,01026,4
a54dc4bc29d1c1a2b1e3a76f6b8ba639,49,49,1,343,49,0,05040,1
449c4d8bf9d6ef757aafbafeff57dd44,226,173,3,527.3333333333334,226,0,05040,4
79a78f99b3bc84b74970718a3902d951,59,59,1,413,0,59,01012,2
85003501bdd219d64ee30a6a26dcb731,62,62,1,434,0,62,01012,2
798b345965e7f392a76e1f96000c5282,189,109,3,441,189,0,01027,4
3fbfcf8408cae65df86acc9c6a3adf21,1,1,1,7,1,0,10261,1
0f0a5453c44ccddafdac64b6e9fdb9d5,27,25,2,94.5,10,17,01012,1
27509b883154e26f7e75c3cc4f26c2f4,27,27,1,189,27,0,04060,1
42497f8745632736cfe2ee6c19b1171d,256,152,5,358.4,223,33,01026,4
c2d938365bea3e10462cce407786849d,148,66,2,518,44,104,01026,3
d8bf9be0861f4b25f898baa4d71e1109,4,4,1,28,4,0,11100,1
1884d233c01e99766f7a0c252d9341fd,29,29,1,203,0,29,10200,1
a89fb6c31fa22ae2c9e2ff1a5d722014,32,32,1,224,32,0,01026,1
1ba0690a23c42b122ebcb1f429ee4c43,33,33,1,231,33,0,11100,1
4f95196ccaa1650f8b286a014c336b4a,11,11,1,77,11,0,01012,1
15c53b17ede8a57004f1af32e60ee14e,59,38,3,137.66666666666669,43,16,10080,2
515c4bf5a4af265ccf6dc83a42b2c1bd,67,67,1,469,67,0,04130,2
c89646fdad1091727c75b62e10ccc38d,76,56,2,266,18,58,05030,2
4e8c89669019f9808a39039dc3375165,44,38,2,154,44,0,10200,1
0379f7453377f7ad5f01a0caee4ff65e,47,47,1,329,47,0,01012,1
a017394a6cb64f17cefe77c27c6c1501,140,79,5,196,124,16,01012,3
d30dc78cd2e803da3b805b6398d1e673,89,67,1,623,89,0,01027,3
45df1c16ec584bd6538745eceae203cc,54,35,2,189,28,26,01012,1
296158fc0012f63afe5e7a7b55b3d96f,1,1,1,7,1,0,05200,1
633df7980b1cb00653c31bbfa0987351,6,6,1,42,6,0,10080,1
37fff4fc7439808d13ae3ae946704c6a,242,147,4,423.5,242,0,05040,4
62c1c76e305759372c8565844cf86c7c,36,31,2,126,16,20,08031,1
75c939bbe6db08ebc4f25aeb1a5a2392,108,48,2,378,108,0,10200,3
ba471c926dc405991eed851cf4237bc3,22,22,1,154,22,0,01026,1
1d2803ba80f911e3285b247d812047ee,174,85,3,406,136,38,05100,3
dc8a16db26762473c357bc3e33c0f473,77,57,3,179.66666666666669,77,0,05040,2
ae5a9690948c25f280243684debb1801,83,74,1,581,83,0,08100,3
29d525fd2a193c252f218871de0aabc9,34,26,2,119,34,0,11103,1
b8b08da8c68964de28aed2c636845ace,102,57,2,357,102,0,04020,3
4bb1ab00bac00a178fa16a37d1d34c4c,55,37,1,385,55,0,09030,1
878a432eecb45f050f337baf0d794049,48,48,1,336,48,0,03090,1
2f307fc1c3b24c694e445afd2a30ebb7,51,47,2,178.5,29,22,02651,1
4a3ca00c353540dee974fbd1221f510f,97,51,3,226.33333333333334,97,0,08313,3
1058104ad9b7a2796b3b6cc5527fd0bf,79,59,2,276.5,79,0,12650,2
ba8fc37a2756f0e5c634fbd1b2d3a37a,40,40,1,280,40,0,01027,1
b956cf9dbbcc5177f7b37e9e82f06b10,352,120,6,410.6666666666667,306,46,05030,4
1e94709a8c6a0fe3fe4111c62579939e,19,19,1,133,19,0,05030,1
a91c1bb1b42ee4c9a26927d1dea6c33e,21,21,1,147,21,0,01012,1
4abb008510817391a249870753e889c5,178,116,4,311.5,78,100,01012,4
5d538fb18ef3f26ad6fcc1c1a3b61bbf,15,15,1,105,15,0,05040,1
19ca00bb9d00291666ebbe106fe62816,70,57,2,245,1,69,08032,2
4b76c773219e1be0d61bfd27fea79b5e,310,108,4,542.5,203,107,01013,4
6d983f3e5a25bb2c47bad8d9d83f1588,19,11,2,66.5,19,0,11100,1
b34fdc1d3f8602f1f0abf2382f592b66,459,172,3,1071,459,0,08032,4
d444b715393804285b14c90c451c26bc,111,50,5,155.4,102,9,08314,3
464ac0a87cd86fba7c392934c4ef1d0b,69,69,1,483,69,0,01026,2
8b7c0edafa0d08f9ae4a8c7dc4ff6f36,153,100,2,535.5,153,0,01027,3
ac755641b2de13b734f857a868f8d737,104,81,1,728,104,0,10200,3
95c3813ef422da9884da6eeee99154c1,32,32,1,224,0,32,09090,1
e3b54a2d51c5df1d025796bb084e364c,36,24,2,126,36,0,04060,1
0de2f180939146422a1dfc4b44c11746,21,21,1,147,21,0,08090,1
8b10a6e6bd387ea76119fe01b3239187,45,45,1,315,45,0,05040,1
85c71aa5a0186381cd1cf95ae2808b56,26,26,1,182,26,0,01012,1
e64346d3b7dc5350a74cb9c87b68b03a,1,1,1,7,1,0,08312,1
40d1005709ca2afd6b79750b1b693848,36,36,1,252,0,36,05030,1
a22476c286e49d33c1505d765d4d942c,158,61,1,1106,158,0,04020,3
f31739cfd320f3b52f470b9a35a80a34,394,105,6,459.6666666666667,308,86,01026,4
8b604ce8c87c7649be892e2e7bc77219,40,40,1,280,40,0,05040,1
b02bb0a07bf7b99974e1b66dae14ecbd,11,11,1,77,11,0,11140,1
39220e05087ce058e5bafffeceff9905,28,28,1,196,0,28,11040,1
4b3a23bddc4498c110cb4b25a876c551,532,141,2,1862,532,0,05040,4
345384fb33bf9d59cf0488dee816e201,48,35,2,168,48,0,09130,1
6da1a3baedad88825682db31c819f44f,124,94,2,434,124,0,05030,3
8e81c77cc99874a3e9abab85624991ba,56,45,3,130.66666666666669,46,10,02690,2
5f422a65cc0c49b393042c5cc14c4216,153,107,4,267.75,109,44,10240,3
c3e673e368878ae624fef7e62abba4cc,308,114,4,539,308,0,01013,4
057c4a4d9581f1d12c5620499592d55b,114,90,2,399,114,0,05040,3
d6f0a7b036655a4631346a9fd352f19b,73,61,1,511,73,0,05040,2
8dfb431f3809c161ff161c271760cefe,292,115,5,408.8,248,44,05040,4
081221228ea334e046cb50fe2cce8540,139,88,2,486.5,139,0,01026,3
8bc479451f842de17650529e4c3d6057,129,72,3,301,129,0,11100,3
ac3a1f41d1eeda3b008c025ee0aa67df,280,98,4,490,280,0,05040,4
aee968d78a58d7a1eccc1f12c02046f1,100,77,3,233.33333333333334,58,42,02751,3
8858ce3a6f9b243469a4e9491131d96e,23,15,1,161,23,0,05030,1
a9e120023f7f392f9747c6f93b845b8a,36,31,2,126,16,20,05030,1
222fe48619ab0079e03d7cbe0c06b8a6,157,99,4,274.75,157,0,05040,3
f4232d51af90d70ac1ad6efb0c56d2bf,93,37,4,162.75,93,0,01012,3
5c0b2da87f0f95f6d6f73e5da92e1265,88,80,5,123.2,79,9,03090,3
9287c602c6826a6177d6f0820bfcab4b,103,92,2,360.5,103,0,11080,3
c7534554b6c8753770dfde13f7354b48,82,59,3,191.33333333333334,64,18,05030,3
11cdf0cc70e24663d91f7f76c5c02776,110,78,3,256.6666666666667,110,0,05040,3
4fc2faa892d0e5dd00414aa09cf8890e,8,7,2,28,8,0,10200,1
b7162eb53f8892eb3557622411e1e3e7,15,15,1,105,0,15,05040,1
cd66b59e9d08acfcdeb891de174ec6de,147,91,2,514.5,19,128,10240,3
0006ef2f1c591a406fe01da160466230,70,42,3,163.33333333333334,46,24,04032,2
8d09d2398f8761be04486d4e2d6a624b,327,145,5,457.8,189,138,01012,4
53846dc7c1996ec5a6cbcef399c36436,54,40,1,378,54,0,05040,1
addfb00e1520d9a7ea3813228f6d37a0,22,22,1,154,22,0,03070,1
9775090a89a494b412cc9da6286c1f12,294,151,3,686,234,60,10240,4
709f7ba7d2dce52b35a6aa6ee9085eb7,66,48,3,154,66,0,04060,2
8c03ee9ef5251da4a19205d4eea8f6d0,19,19,1,133,19,0,02610,1
cd67ad9969e8412012cc883f41f4d9cd,25,25,1,175,25,0,08110,1
7cedeeaeb5c002e2ae41ec038c5d235e,56,44,1,392,56,0,01027,1
165119b21be92074e15837e4ce131583,76,63,2,266,76,0,05030,2
12d845306c3eb775ec9bc77c56d1db0f,37,37,1,259,37,0,09030,1
f00c2eeb69b7e45312f6f301596aa947,115,79,2,402.5,67,48,01026,3
8ed86c4d27c1b54efff614114ecc39ca,296,133,3,690.6666666666667,296,0,04201,4
83e6c6d8e3b543fe3f3491077493465d,256,126,4,448,212,44,05040,4
0aef6e118e5a69a8b0ea9fd9d7e2b7de,41,41,1,287,41,0,05041,1
499b4de755e676aed2c6cfbe4aeb7819,17,17,1,119,17,0,05030,1
5da4ffa0228a8272c6d4cf38b5080cb9,304,149,2,1064,41,263,01027,4
ef2aa31459bf1f718828a641ca9a0e24,31,31,1,217,31,0,05040,1
d3263ac862b21098488ffb5cd81c880c,66,55,2,231,66,0,05030,2
0c6a4dd0d5ff0026eb956f54eb9bd0ce,46,46,1,322,46,0,10240,1
2ae73703bf71dd1d04f6fb9f9b67ca14,101,78,2,353.5,101,0,04060,3
928b8298358c39b642cf980a3ba8bcfa,24,24,1,168,24,0,05030,1
f05104aba98871a98bc88c1ea98b2af3,17,17,1,119,0,17,01027,1
09addc9db7f7faaceba8f9ecda271e9a,213,144,3,497,213,0,11040,4
c521b7ef82e22b76880b08f1171c7a69,191,103,3,445.6666666666667,84,107,05030,4
cd9693dec51cccb959773ec50a901365,26,26,1,182,26,0,09090,1
8c05876bd3d8b5af311db07457085eb5,227,129,3,529.6666666666667,100,127,04130,4
57dc2138661e8fcd17394035c3d7ad78,11,11,1,77,0,11,03033,1
691f05994e0c33af32c3031046cccd60,167,65,5,233.79999999999998,116,51,11160,3
97111a8b2d81c006598fc299334df6ba,65,58,2,227.5,65,0,11040,2
35bbf9f035ee1437ceb2ae180786bd07,18,18,1,126,18,0,01085,1
daa1a4c529e136864e91c9dbffa37446,16,16,1,112,16,0,01012,1
551206784454b8deb2f48567aa146c59,127,127,1,889,127,0,09030,3
61cde787f1915f0772cbbe6c9087bd7e,23,23,1,161,23,0,05030,1
64f2bcf0c3b959f28e5e6120783303c0,89,89,1,623,89,0,09350,3
a9b41a324718fc1fe182659c15f7da63,27,27,1,189,27,0,12590,1
da363dfcc76338f7d6768de20a2e83c5,66,63,2,231,66,0,13490,2
766844223cd1242fc45b26bf7bd4cdf1,82,69,2,287,82,0,10141,2
94fd82e46b4ddb8dbabcdd59ec468511,27,27,1,189,27,0,03070,1
7a225f583cb3b5d03955d7402df044c4,172,90,2,602,172,0,05030,3
64bfd16ebace99a24b1a5bd3e12a503d,57,40,2,199.5,57,0,02620,1
a60ad9e9cfd7ed9405cdee958912c5a6,15,15,1,105,0,15,11103,1
d8541626377a01b01b27efa6861ed816,45,45,1,315,45,0,05040,1
fa2907da4d271b6a8db8fd1168833c18,27,26,2,94.5,27,0,05030,1
3f7581f4034fedf50730c4ff75552834,113,83,2,395.5,113,0,01026,3
231ec87501027071cb744feee10cc428,1,1,1,7,1,0,11040,1
3250925553a18134d3f8b43ee2756a95,93,73,3,217,93,0,05040,3
fda4077d7bdf7c60ce90b0c1d97050fd,84,72,2,294,84,0,10200,3
b4bf4d242ed79de04dfc9e78aa0b614e,14,14,1,98,14,0,05040,1
9352cd19b5949127a89ca6733dfe8a86,57,57,1,399,57,0,01012,2
b36fb255f9eb9c40232771eee35dd3d9,59,49,2,206.5,59,0,05030,1
1b9f98950f8eaaa085c25039410d5d7d,77,66,2,269.5,54,23,05030,2
c9dfa6f82f88a03b0481af17661755fd,31,31,1,217,0,31,01013,1
83d9c98ec237dcc1d2d931b29a6d23e6,45,38,2,157.5,45,0,02650,1
8e4ce4dc7da110a7219dafe47b3c1ee8,132,74,3,308,132,0,11040,3
0cea617743eb34f10db723b98f8b51c5,57,48,1,399,57,0,12570,1
c3e0d4af70af7d8ea0c8240c5a9203e9,16,16,1,112,16,0,05030,1
8e3100b26ad2b47518687a8b37403634,40,30,2,140,40,0,05040,1
49f6de77958a7dadb7f7504cd808ceab,182,80,4,318.5,135,47,11140,3
cfc5d72c0fb39844ff56d8af3d80fd7c,36,36,1,252,36,0,10240,1
362780c4aaabce791fa7f6fb49e2bb37,86,86,1,602,86,0,08010,3
84cf326444378ebf912392538251e334,11,10,2,38.5,11,0,04011,1
2580966c45bdbba8146191405d6862d0,53,53,1,371,53,0,05041,1
e4570e10d54bc8396540dc8ae77d9bd5,11,11,1,77,11,0,12470,1
6d6a81b1c1990ac830c21a516e40ba9d,124,54,3,289.33333333333337,124,0,05040,3
7dbb770973fd958814d76a6323bf13c7,230,120,4,402.5,230,0,10200,4
462b88d72c8618d6cb039502cc8e9e20,53,41,2,185.5,53,0,01013,1
f6fe714eda90744206f4bd0136eeec08,558,132,2,1953,2,556,08452,4
809f0b0f6922c6507e8051c158a9eb90,34,34,1,238,34,0,05040,1
462395022519dfae3a4647a32fc409b8,661,187,2,2313.5,316,345,01026,4
ce3cc89e1de35082b9c4c790168d091a,122,96,3,284.6666666666667,122,0,05040,3
acf28f0d1ad1a76e775e480cac437023,37,37,1,259,37,0,10200,1
4cfe22cf21e4f3bff09e5f29b028776d,34,24,2,119,34,0,05041,1
ec66bd6c8b7aa0f557fc5174eb52d9a6,32,32,1,224,32,0,05100,1
411cca095168e51597b605908a1627e7,7,7,2,24.5,7,0,11140,1
a209a5d43e68c2167c5132ecc5a8d564,22,22,1,154,22,0,05100,1
15401c0e3f5551c9b0c7f7b5bf05a5fb,5,5,1,35,5,0,03050,1
5caad90751973f75435bc0c056432a18,78,70,1,546,78,0,05040,3
b3f5144b08267e37f831dd40b8fe3ee4,26,26,1,182,26,0,01026,1
09600975d77e3be8173d18671c3d2b91,202,139,4,353.5,159,43,08314,4
4dd6b3142432ec8b3040a519275eba08,8,8,1,56,0,8,11040,1
df450298f6b41a35a07afac1f157910b,74,51,2,259,74,0,09150,2
f37f0043b2d14bd7de878200f4850397,117,76,2,409.5,117,0,13490,3
63d5f5d4a14c9054496bd35920530eee,27,27,1,189,0,27,05040,1
3789c88d9c4354b0ef1ac04b5e2183fe,17,17,1,119,0,17,01013,1
b54236bcd72f89ecffcd753793bc0244,71,51,2,248.5,38,33,05041,2
0500c540a409484216cbe40390ef0d13,179,89,2,626.5,31,148,01012,3
357641a7dae5978384f44d2421c26633,21,21,1,147,21,0,02691,1
4c27e204421f9ca702b260ee69bce720,33,33,1,231,0,33,01012,1
4101d18c3864c0866839743ca073112a,96,61,3,224,96,0,05040,3
6b2310f175d1818e2422465b2f90c572,100,66,3,233.33333333333334,100,0,11040,3
e5d937be88758703882127292e98c1d8,86,73,2,301,86,0,05040,3
09b3e6a8efeafb6b18f6fcc631315aa1,125,90,3,291.6666666666667,57,68,11100,3
fe255b74f513a2f8c02ebe795544a0c8,1,1,1,7,1,0,13930,1
fe691783bb1dccb74fb05dc442b37b7c,95,53,2,332.5,95,0,10028,2
83d0990d16cc161cdac81c06afa4440f,18,18,1,126,18,0,01012,1
ddef8be6f18e88f805e6afcd4808350c,32,23,1,224,32,0,05040,1
6f632e2e80769589f07df1690e767dcd,153,93,2,535.5,52,101,05040,3
3642b5bd7688dbcac44c23ebae3b8ab6,59,59,1,413,59,0,14301,2
c951735035992212a0009b67cc0840a9,35,27,1,245,0,35,01012,1
c12cee39bb8690839c99f03dbb19b002,74,74,1,518,74,0,05040,3
dd30e7e4d8de177acc2c17ec44fa7772,107,107,1,749,107,0,05040,3
b6e089591dc961cb6696b368f1322041,52,33,2,182,33,19,05030,1
8226ca684c51524d8c2be89edf50c255,19,19,1,133,19,0,05030,1
83b6deec57f6eeb528466cafe38847b6,49,32,2,171.5,49,0,05040,1
06aa163ce1bb8fa3f7c75d8ffb3e8b8b,35,35,1,245,35,0,01012,1
113f650308befd0a9422a0ea1f77ff64,185,100,4,323.75,144,41,10200,4
d5daaf4866afb484993e191a75c6295a,45,45,1,315,45,0,09150,1
d98e1f984fe879503fec03316e6a0a53,13,13,1,91,13,0,01026,1
90bbcd768877682691f06b02ab7ce128,33,33,1,231,0,33,01026,1
516c1e7194722b69f7e87624110654c6,31,31,1,217,31,0,10240,1
d5473a4ac4727946ae16edc2a8eabcac,219,105,4,383.25,219,0,04060,4
57f326bab66ea0198cd149281ff58102,71,63,3,165.66666666666669,71,0,01027,2
8a515fa4946c6539b75133e044fd28a6,31,27,2,108.5,31,0,08230,1
ab9abd29385ec74c1443889c1d2d1e7e,34,30,3,79.33333333333334,34,0,09150,1
fa48340d4862e7f13b587f97c9b9d0cb,73,45,2,255.5,17,56,05200,2
dc2406f5773fb133aed82bba9f523cb1,15,15,1,105,0,15,09090,1
cdfac21bf81a73abe0e6ffd3fb62304e,19,19,1,133,19,0,11080,1
4aa1d2758dfc4189f65b94cb7ae07d25,106,53,3,247.33333333333334,68,38,01026,3
fd8a8576507b79db0cf022d85430dde1,46,42,2,161,46,0,10040,1
5f64bf120165bb7beedcc9ce425dc30e,108,67,2,378,108,0,05040,3
54dd6e628ed6a866d8a307f30de4fc50,57,40,1,399,0,57,05040,1
ff58f5aec82fa7ad0645e25abdb9ca43,11,11,1,77,11,0,11040,1
ddc064c6901b52d54b0f042ab26aae80,44,44,1,308,44,0,07144,1
e87a82fbb5f6593f347a823866220400,5,5,1,35,5,0,11040,1
790b3ebdcb6aa4bcd678a8e7e2806f15,25,22,2,87.5,25,0,11103,1
521d24b9101f75c379ee185a1a29e7bc,50,50,1,350,50,0,01026,1
87e3331f497d870c3ad228f2451d0d9f,93,76,3,217,32,61,05040,3
45f755282107ae3cfd491aaf9409acdd,113,67,4,197.75,113,0,01085,3
563fe624960162b23b78adc08dfcfcf8,427,155,3,996.3333333333334,427,0,01027,4
b963528a970af951cb05e2b7182f58cd,79,57,2,276.5,48,31,01026,2
e8eb3e2070456a6e411dfbe49a7d100b,57,48,2,199.5,22,35,08100,1
cad2534a0935d5c17506d17422482a7d,92,70,2,322,35,57,01026,3
806be8339746df8e2a358a47078ddb9a,35,35,1,245,35,0,05040,1
b7b8968147800fd7ac9d1358daf00128,25,25,1,175,25,0,03090,1
d47b1bba58e244a935f147fdde523dff,142,91,3,331.33333333333337,142,0,05040,3
0e50e1ceaf96e554cb215cbd7532abde,51,43,2,178.5,25,26,12501,1
8f55ef12d715fbd44e90ab8fac8ec9a8,93,70,2,325.5,64,29,01026,3
2fcdf53e9c05ca6730a1276f48728fa3,158,93,4,276.5,132,26,05030,3
9762a4d705257d420c392e5f4677b764,68,55,3,158.66666666666669,68,0,01085,2
ffef18e32a09c7f5aa3bde2316d1b921,17,17,1,119,17,0,01016,1
4dfdbd6da52bca73165cfa25fe7b7476,106,73,1,742,106,0,07122,3
b364ce5d650f1b09ff90e1a0820e95d9,88,41,2,308,36,52,08230,2
11aba1d36e8a6281a094dc54577cacf9,14,14,1,98,0,14,05030,1
d6a18d1ac3f3797d1e9929fdf54996a9,12,12,1,84,0,12,05040,1
23c8378c83df370c01bcfb66618b8550,159,112,3,371,70,89,05030,3
787eac249b21af83df25ceb8246e218a,41,41,1,287,41,0,01085,1
ebe3e5e428bb03a985f1a06c083b2d2e,30,30,1,210,30,0,04031,1
ab5976881b47108cdc5cba3dd855b7b7,33,33,1,231,33,0,01026,1
aedb49872e5304fe8c4644dae980675a,4,4,1,28,4,0,11040,1
ae0613b9eb33ebc7a159611e62af8df7,461,151,2,1613.5,255,206,10200,4
9e6fdef1290e444a16656885c764eb18,167,83,3,389.6666666666667,167,0,01012,3
ef12468654bc1b709257c9b5a1e9107b,59,59,1,413,59,0,08100,2
69d4a3a4dd23e5530f8902367ea7f74a,44,31,2,154,22,22,09130,1
5f09009c88e79385c24a886af823d857,167,103,5,233.79999999999998,125,42,05030,4
e430914c238da787102c2fa01668a922,101,73,2,353.5,101,0,05030,3
7e7b45947f769bed8d2c263ffc039cae,62,62,1,434,62,0,10101,2
7bcee25ab331ceb645afecee926f000e,39,39,1,273,39,0,01085,1
2217e52f94d524a7528f7e83af74a901,41,41,1,287,0,41,01027,1
ebb28f1b1138d1aa73dc56aa17d8c14c,1,1,1,7,1,0,09010,1
75df70b28696d2346c966025b2d81557,154,73,3,359.33333333333337,154,0,01026,3
bc9868474d3366fd21e505c038e2d68d,43,29,1,301,43,0,11040,1
a35646af21e5c5b14bb643d82ee2c304,136,73,3,317.33333333333337,75,61,05040,3
8d01198c0fc2efe201d8c2ec99075c68,180,89,4,315,129,51,01085,3
218fa5fc55d3af160bb748f35d6789e7,141,69,3,329,141,0,11100,3
7f2ffbc11c8aa4fcdb32ce4e03da6adb,181,81,4,316.75,181,0,05040,3
e13adf7984695756a561e7499fabb534,101,75,3,235.66666666666669,101,0,05040,3
78b9c98a015fbd495be94986b609e70a,4,3,2,14,3,1,11040,1
e5cfebd69e96688082c02300a3e9df74,25,25,1,175,25,0,10240,1
69944a6503b931b1bbdc72a901fc5a24,99,54,4,173.25,77,22,11140,3
6a811f37527798c4eb7ff360206d1759,52,35,2,182,52,0,05040,1
81c4d241ea01efe73981821896afcd89,69,44,2,241.5,69,0,05100,2
7da8fd570163409f73690a937328fd32,49,49,1,343,49,0,01026,1
54b1e0e0a8d455ba26a2bcc133df2043,100,68,1,700,100,0,01026,3
b6e404457f8df9c534a3a33ae5cff91e,12,12,1,84,0,12,05041,1
c1756c5766a36edbcdc622b291eca635,23,23,1,161,0,23,10040,1
32ed4659ee5927c04d87a0dc4367c391,26,26,1,182,26,0,09170,1
140687541a8653dfdc073ae40ecd6638,30,30,1,210,30,0,01027,1
96518475a9278d0aaa74c93dacce418a,210,42,1,1470,0,210,06100,4
a03add37ef5447522754e0df777edf59,367,100,6,428.1666666666667,333,34,01012,4
3d7f2002e93e3892bf5d572545b0198d,56,56,1,392,56,0,01026,2
e461882ccb7a7144e584c8c370b44d05,106,77,2,371,106,0,01012,3
7a41b228697678f3c8fa8104703a3ab2,34,34,1,238,34,0,05030,1
ad095adb2ce10c8797bcdd1e285f8214,56,32,3,130.66666666666669,56,0,03050,1
3b5aa803fc5f480490e59abfd7e337b2,17,17,1,119,0,17,01014,1
c6300aa75cc216783598523d59962ac1,25,25,1,175,25,0,05041,1
c171ae2b6562180373d5ff5db7f51bb7,32,25,3,74.66666666666667,32,0,11040,1
1d943c237baeee7c8165e15af1afcf47,230,130,3,536.6666666666667,188,42,01026,4
10dc37711610a91212a16406fac68863,64,51,3,149.33333333333334,64,0,01026,2
733657d629a23ddbdca777e3787dfa1e,24,24,1,168,24,0,01012,1
2e8493e5434f295274484cbc74701cdd,310,94,1,2170,310,0,05030,4
10a6f3d05e1d612cd611e98027add8c1,60,60,1,420,60,0,04020,2
7907cc5f4e5abe3e31057aaf8ed0c5a3,88,88,1,616,88,0,04080,3
82b65dcd1bb4f0de3b325d0387714027,201,94,5,281.4,201,0,10080,4
7e28906133bf9422cc9d29788590665b,6,6,1,42,0,6,05030,1
8e107f502d59e44aece48a648cf76424,103,103,1,721,103,0,05040,3
7ea36b91f339c718696ae60a5be72020,28,28,1,196,28,0,05040,1
93b512d6937a35ab76ad2adee42ef816,129,78,3,301,68,61,05100,3
a14365db2cdafc9930cfe6e7b48db2bd,24,21,2,84,24,0,05030,1
ac9ef4b7a3f200bb0f7c14cf0eeb3ede,14,11,3,32.66666666666667,14,0,12500,1
697ce9dd04ed7fc74425228381f22c50,121,68,3,282.33333333333337,59,62,05040,3
1b0429b31683e0d999f1260ddaec123c,22,22,1,154,22,0,01027,1
3966d0dbc45c69b064650f9b26c7053e,30,30,1,210,30,0,03090,1
2d01900b277a7f1e5ff1d885cf7adae5,41,33,2,143.5,41,0,11080,1
c181056a419f122c449667ce6319b6f4,83,51,3,193.66666666666669,56,27,01012,2
8bfd91103a17a0ebb9447e98fd62d501,36,36,1,252,36,0,04080,1
4e6d417353f69a5d7ff352a51f99d623,85,46,2,297.5,85,0,12590,2
61b8961fee0570b132eb413075e11a48,96,82,2,336,96,0,05100,3
8d819834b16d9c77035cb44b622088d3,95,45,6,110.83333333333334,85,10,11080,3
4d8fe56145e8a262373075f3e6c3194b,184,70,2,644,184,0,10240,3
4b19db1c930c016960c24e0d96aab704,40,34,2,140,40,0,01012,1
816e505568d0d220716a66fdcc8ae012,256,106,5,358.4,188,68,01026,4
fa5bf2d53d4df2bbaa914efd1d20463a,24,24,1,168,24,0,02691,1
404cd9fe08659a444eae102c53dc3df9,217,97,3,506.33333333333337,217,0,10200,4
05c9385ff0800874dec7e10d76910f82,60,47,2,210,60,0,01085,1
dabbc4e911354cd252192cab212e3436,14,10,2,49,14,0,05030,1
e73e0ee3adce6f3085d5e17367fa785e,34,29,1,238,34,0,05040,1
67bc9ba17a7968e5de002f33daa50ad3,34,34,1,238,34,0,05040,1
ac2eee4e73a314a8d933d7beb4047066,37,37,1,259,37,0,03070,1
4943598cdcfcba2c6c714cabcf3574bd,9,9,1,63,9,0,02690,1
ff1ae810cc3511fa42da9e1096243513,236,130,4,413,121,115,05040,4
f35256f29c242f8ff6a73368b0e72549,43,40,2,150.5,43,0,08051,1
c06463030a5bb4fd270cfcedbd61dbac,44,44,1,308,44,0,01012,1
29d993572f181588e1a76fcd7d852489,126,80,3,294,126,0,10200,3
f66fa63e55b340feb514cdad376f4cd0,105,85,3,245,105,0,05100,3
835d0ac3ffb7e59e20e21a2440391580,25,17,1,175,25,0,02691,1
d13e68f3aeb048c33f24d1cd22546a94,121,92,2,423.5,121,0,05040,3
a64a4a3268ba23f9bbf0139495430390,10,10,1,70,10,0,05030,1
fb0eb83e5d5ae013cc9353b8f561b4a3,15,15,2,52.5,15,0,01012,1
d7a4135c4bcfb3404dd7aa0950d0c8a5,30,30,1,210,0,30,05030,1
4b12ec274d90e2264163ee6792953602,15,15,1,105,15,0,01201,1
a9f00e9405888238fb4c9d829729a908,181,100,6,211.16666666666669,169,12,05040,4
ffbe5be5384038ad79c0aff7021b7f8b,99,70,3,231,59,40,01027,3
be728cc78f478bcb84933e71e5a76bdb,171,101,2,598.5,171,0,01026,3
4685d0d041e01fcbe1226cf471799292,325,116,3,758.3333333333334,325,0,04060,4
050a9a800971f7468356ad6fdc7f094e,20,20,1,140,0,20,01027,1
b7922fd3b62a956cf063f3444fdd0968,108,55,3,252,108,0,05040,3
5fa0fdeb4e4de9367819dc7964d34d26,28,28,1,196,0,28,05040,1
e62800656edc936f9e69e14b16f84f63,130,77,4,227.5,102,28,02690,3
6119f53933e97ab826aab979c7b42123,32,32,1,224,0,32,01026,1
40b905ee99c08f89c67361b364e2714f,41,33,2,143.5,19,22,05041,1
3fc4fba4be37652ef447c802fd7ccd7e,133,92,4,232.75,133,0,01026,3
1e9b5e9e4c4d04723e16c5309f3dd754,13,13,1,91,13,0,03050,1
f8e9c68d3e71d75dce76909b309bf54a,297,112,6,346.5,260,37,05030,4
5feaf03b88c46d2bc53092e1253a4755,19,18,2,66.5,19,0,09130,1
81a09ef0894bffec3bff5e4508724404,23,23,1,161,23,0,09130,1
876cc3ae4f14717c0f15faf679eaed00,84,84,1,588,84,0,09130,3
c16df6435f48cc964a7c74bf46d8c863,181,80,4,316.75,143,38,09030,3
b31f6a775048d142859eca6599c6e908,148,88,2,518,148,0,01026,3
51a211daa2add9d733879b921cb13283,33,33,1,231,33,0,11080,1
eb23a4ba420cf6534a464c7eb6f804c5,16,16,1,112,16,0,01012,1
0c168bad5acb521e3c4465756cc115b1,110,56,3,256.6666666666667,110,0,05040,3
5111a742d2edaca54aa3a599690acf1f,72,57,3,168,72,0,04080,2
bf691bbe7afcd370458c8b29b6786885,44,34,2,154,44,0,05040,1
d8543a214d5795664f526287e540bf2b,67,52,2,234.5,67,0,01012,2
726ae52d5cb1cc7ed8c606ecef2c0ba1,56,41,2,196,56,0,01026,1
0c5356b46ad3dfe352af82f0d543f089,30,26,2,105,19,11,10281,1
7ce0c9fc41d04516c43ec46271639ec3,41,36,2,143.5,41,0,09170,1
2706d37e73de97b869447afff92dd3d5,25,25,1,175,25,0,09091,1
36cd0fcd65c1d0968224cfe38c2525ed,54,49,2,189,54,0,08452,1
7c8996b4d1ae1eab5a8de653b8e7ac13,19,19,1,133,0,19,12500,1
49eae07bf4c37ef3adafbc524bbd2904,58,53,2,203,58,0,01026,1
de2683994a8d59d79e676e3c90da5127,84,62,2,294,84,0,01012,2
3d4e9ea55efaf45454a3f661cfcfb648,60,42,1,420,60,0,01026,1
12d1e3bf988568bb15bfdab912759830,130,103,2,455,130,0,02620,3
a21a35556f30ae8a27c2b3a95d3b7613,28,28,1,196,28,0,01012,1
8acd6d79a80ff5cc7bbc99156abda8f9,58,51,2,203,27,31,11100,2
1581b684d5600e1f1dabec4dd98a12b1,246,111,4,430.5,214,32,05040,4
d9da7edeee01cf227ffc4b7047bb47c4,35,26,3,81.66666666666667,21,14,11100,1
dddb0ee82345a9905b501cdbbe2f7f8c,57,57,1,399,57,0,05040,2
b228174a901f17d580feb37a86d5b74f,33,32,2,115.5,33,0,08052,1
899b645c0bd02924259e8447c5f3544d,34,34,1,238,34,0,07122,1
fc609e5dc44a239e951247365168de9a,193,97,4,337.75,193,0,05041,4
bb686aece648069cf5202965e11b8b56,121,61,4,211.75,87,34,10028,3
3917faa59fb68994e69fb6c39c6b6700,28,28,1,196,28,0,13953,1
234dcf0a9a114aa1b6bb8c7145142494,15,15,1,105,15,0,01026,1
2aaf90b737979327f5dd1796bf286f3e,218,131,5,305.2,158,60,05040,4
1ab83ba930aa5896d2dd321187151fdd,16,16,1,112,16,0,01200,1
1eec8bbf04deebbf17c824764e3970b4,45,45,1,315,45,0,01027,1
a38ebcab3404358422c057ea78d61105,57,49,2,199.5,15,42,01085,1
520cf72bb5a7b3ba46852661d7fe0612,39,39,1,273,39,0,09130,1
fbd183760e2abf3d1ea136bfed574c9c,30,26,2,105,30,0,05030,1
f27280b2e98d971b84cb3d80de1c5abb,81,62,3,189,60,21,05040,3
dd8ad067040a68b9be34d3b83ac15608,460,152,3,1073.3333333333335,460,0,10240,4
a35c9e5bf465bd9ce0f5d76b25107cd0,138,55,2,483,138,0,08452,3
a92df7aea05a12574eb0dabd391cd610,149,113,2,521.5,149,0,01026,3
c0b242eb6fea1dcbe637099f9d5dc243,35,35,1,245,35,0,13490,1
f6f0b40148dd861590a80476df5aeae8,80,73,2,280,47,33,01012,3
5ccf2d96cd19435b0e79a672576e050d,19,19,1,133,19,0,13820,1
bc9b5dbfe9155ade0560366f6ebc0b2d,356,88,3,830.6666666666667,356,0,05030,4
57cbb8259cffc618e0f642dfd66b5647,45,35,2,157.5,45,0,05040,1
261b66d7a5caad114dd8a8f86f0a49d0,19,19,1,133,19,0,09190,1
85b4ab2512d85b0d923ca93639326e0c,6,6,1,42,6,0,10040,1
514c8cb3a1bed5be880525f772887712,66,46,3,154,40,26,13490,2
80c0c42ce1a33b94d129d07b6fe10b1a,231,148,2,808.5,231,0,05040,4
3a147a9ff8a6e9fbc621cfdd808dc6e3,18,18,1,126,0,18,13820,1
a57fde13a7c1631f73949e5af07d8fe2,30,30,1,210,0,30,09130,1
39ea2a6c73f3fd552bc0caeee623fdf9,1,1,1,7,1,0,11080,1
165c366e88f712e07a21a75dd5ac7ba5,34,34,1,238,34,0,04060,1
7467f96631ca1ec5da8a95eacda29887,10,10,2,35,9,1,05030,1
78a93e7e686edbb6c0681f8a9da7198a,32,32,1,224,32,0,01026,1
1985d517b064c88b02e29cff93a453da,161,67,2,563.5,161,0,05040,3
021641fe57b40f45a99f901dbf5fdc47,295,160,4,516.25,295,0,01012,4
4e61c51250d8404e720a84b8c79a92ce,176,100,3,410.6666666666667,88,88,08051,3
e83ec36716709b22a61ff6c86a5533d7,46,29,3,107.33333333333334,28,18,08010,1
df1679580ef193257ef038ed69d9bb91,42,42,1,294,42,0,01026,1
103d20d38b948308d7f6ff5cec924e42,33,33,1,231,33,0,08051,1
b0d424ad35a77d02361f1f83acc63569,103,63,3,240.33333333333334,67,36,09030,3
bce9cfc04da08c12a6d895530b447f56,1,1,1,7,1,0,09010,1
9c2f019c8f74b6070dbd44e987bb8862,551,185,4,964.25,281,270,04020,4
34cb83359f523b30aa3e6c063d8797c2,24,24,1,168,24,0,01027,1
8a0aa00ca8e6f19ff255e29abbf36f44,71,58,2,248.5,71,0,02756,2
5ff7b7fdcd476e56a28e494b7eb3a26c,51,29,2,178.5,15,36,05030,1
d8c607bfd5740ecd3b84bfb266624187,425,171,4,743.75,226,199,05040,4
109f7abee0192ed5ca10e32ea89646ae,284,128,4,497,153,131,05040,4
b7a75755de80b18806b395083c49c2e3,393,144,4,687.75,246,147,01026,4
d2c6f24c2114a61f9c2078d31f53d6a4,39,36,2,136.5,39,0,01027,1
cb6a9f07d37602d75ae09cd3ad4fecf9,42,37,2,147,42,0,04020,1
92d7b2f2ef5d63cd739e4eddd5f6ad10,46,46,1,322,46,0,02620,1
cd6e38350a25cc8c67a66af2f58b2917,30,30,1,210,30,0,05040,1
88cc23c53803f96933ceb913abe08246,241,128,4,421.75,241,0,08010,4
e02870a066a0f1970f6aacfd07f1940f,103,50,3,240.33333333333334,103,0,09130,3
f53c931f1991b1957223497ae14f4d89,51,48,2,178.5,51,0,01026,1
4ff623865c16777dd07fa42e66b7dd37,71,38,2,248.5,71,0,03070,2
4e4cb6c0ddf0e1ab9d8288dd58aa796d,23,21,2,80.5,23,0,09351,1
6f30c171ce92d7b56e5507e86eb02b28,28,28,1,196,28,0,07122,1
eab260e57b37d4721de9219618274cfa,75,62,2,262.5,46,29,05040,2
f94e75ac58fae714eee935e903b379c1,34,23,2,119,34,0,12470,1
337b80bccfd0ab139874cd1698346c27,96,33,4,168,80,16,01012,3
87946cb0357d0b198ae3958e4e4d4ba8,100,69,4,175,52,48,01026,3
fe53816e0e90c45636e8e3b50e267556,157,111,3,366.33333333333337,157,0,10200,3
9f515404e99ebfe6e01fc69a22c300b6,47,47,1,329,47,0,01027,1
33312d604eeee46692728048b770bcab,76,60,2,266,76,0,01026,2
203be13e6bb406fb48a7af9a5b1864c6,36,36,1,252,36,0,12500,1
eca1a1c5f3e7b27adb1a575bb41e258f,45,29,2,157.5,24,21,11100,1
b255251e3650f9f01ac3c8a88d92da5c,39,39,1,273,39,0,01026,1
1e84266ec1ef20dc64b6a73767cfaf10,51,50,2,178.5,22,29,01026,1
6df946e021dc7a6ea837a368d9bf5f53,213,139,3,497,213,0,01027,4
25059de41a6f1d30250505d51ecefac5,91,52,3,212.33333333333334,61,30,01026,3
b17d99f30f58aaa5a9294132a67d0766,25,25,1,175,25,0,01012,1
5ca9f9581cbd1aa8f8d9afd847ab74d7,61,55,2,213.5,61,0,01012,2
a87d3e616899e689a58617b4d446ec1e,40,39,2,140,1,39,01027,1
18ee8f397b6804ec1ddb3c9ccffe95d4,73,56,1,511,73,0,05040,2
b15473f42eceb884cc880754a40df653,37,37,1,259,37,0,05040,1
2cbf21b4cca7df960e14c00f1404923d,96,68,2,336,96,0,09130,3
45588d219329a1c7aff47eac50013e34,20,18,1,140,20,0,05200,1
1fcc0ec5cc125cafdbec0a5c8d691f7c,14,12,2,49,14,0,09010,1
2ffa403ca78fb2fe2181188e7f9e18ea,38,38,1,266,0,38,13953,1
030192b34ceb515936c9b3558bcf56e8,160,76,5,224,131,29,01012,3
318ece86173c884ac2cd7440babee305,220,76,5,308,153,67,01201,4
06ac9ec7e8b46ea597eae3125b634b30,35,35,1,245,35,0,04201,1
74fa9cd14d267cc7c2db619c7cf1bb53,344,112,3,802.6666666666667,319,25,01026,4
5ebde9825a0ccaaeea129759cb1d24ed,13,13,1,91,13,0,09070,1
ea411a44c29dee97339a6921edadf7dc,5,5,1,35,5,0,05030,1
00dfad20efe5b87a65a040e2001bf7c3,186,92,4,325.5,186,0,05040,3
405614d83370d468ffb279465690e717,39,34,2,136.5,18,21,01026,1
fbfe24796db00e7bada7661c06f2c881,17,17,1,119,17,0,01027,1
6b801e83f367526d67809efdfe71875e,19,19,1,133,19,0,11140,1
477948f9ad79dc2e4f1af11dc82f9e91,43,43,1,301,0,43,01012,1
f835ddd1f3c5097e7a33e085fdf9a0f6,44,44,1,308,44,0,05100,1
bc8b8f4a159d7482e8a5159e27461022,124,68,2,434,27,97,04020,3
8addb69536cc01e5b5f7d0ed75d9d3b2,75,65,1,525,75,0,05030,2
eea29db03e5503d322008c72fafacdf8,30,25,2,105,30,0,12670,1
c24d7667919909ff9d2c6d023a5ea9f1,242,148,5,338.8,216,26,11140,4
c6896989d9d45eb2390f0ac47cb10926,10,10,1,70,0,10,09010,1
63ec292e25441e34dfe919309675efef,8,8,1,56,8,0,11040,1
72b4cbac0b99cf09b56a5ae8c3a7b935,9,9,1,63,9,0,02650,1
6852f252629b373b00f30805be0affc0,238,104,4,416.5,164,74,10028,4
cc23c9cbbbf9ceb4f16144c92a43e9ef,27,27,1,189,0,27,01027,1
c5f62c8f3bedd61be62cec440b5bd67e,97,76,2,339.5,97,0,04201,3
bd57de839f220658f53deaa2d2923105,177,99,5,247.79999999999998,177,0,01027,4
2a19d88199b2a8f3ce0b995b5b3ddb87,77,52,3,179.66666666666669,77,0,05040,2
5ad99240cc137ad52080c380d946a68d,112,92,3,261.33333333333337,112,0,10200,3
a074856a766cc003886a949fd55451da,99,74,2,346.5,99,0,10220,3
37287b1985e6774c74bc6e6f8118a63a,282,134,4,493.5,172,110,01026,4
77f69c4f504110a37cc84975b68eb40d,53,53,1,371,53,0,05100,1
e8c2a5b47db98e6cd5913434fc4c3542,85,77,2,297.5,85,0,01026,3
edb75ca08f72a03be0f57948bef6716e,9,9,1,63,9,0,05030,1
f1ac9a37ccdded5225d269b4c953e828,31,31,1,217,0,31,01026,1
01deaf75c91b7b262cc6da19bdbaf2d4,33,33,1,231,33,0,01026,1
00958a22ef3693d3d6934de502ed66a4,212,135,4,371,159,53,10200,4
fda6e3a7167f013de17c99e4f5380a29,18,18,1,126,18,0,05040,1
f39edd644bbdddbd19d96849e5b40b30,66,66,1,462,66,0,01026,2
64afa74effc9935dc4ffec2ddd46feba,114,88,1,798,114,0,01012,3
5b28de219d7e7616b03d296f38cf0536,102,59,2,357,102,0,08032,3
0225be8593176cc536d207b9472e556d,40,35,2,140,40,0,05030,1
477ec985da2303a229a5665dc8b65bbf,34,34,1,238,34,0,03070,1
62a58e133a92cfb04c263cf4d310771e,16,16,1,112,16,0,10200,1
b2ec78bdabc37e8d7a646d075d696fd1,23,23,1,161,23,0,10200,1
ca21b450abefbfb423f4dc3bc82fdb84,45,45,1,315,45,0,04060,1
2e0bbd93cc3b58aad50f26a255ff9f1a,375,131,4,656.25,337,38,09130,4
ddea59eb81abbb26e6b030b036158626,192,87,4,336,141,51,01026,3
65e25e63cf082ef2ec94e86903da0410,43,33,2,150.5,9,34,05041,1
eb68ad1f737584b4bfa980ca136e005a,32,32,1,224,32,0,04060,1
a6b4edd14922c7ffe733763b3d501a69,83,54,2,290.5,83,0,02751,2
1749da2a536c65e1ab91a3c9fc4beda8,119,69,3,277.6666666666667,119,0,10200,3
669d4289e73c07fd8b88b7a58efc29e9,76,66,2,266,43,33,05100,2
7d3e63877d2ebeccb9fac29b9d93d5f8,29,24,2,101.5,29,0,05040,1
13f685f1f6254348e93d239649b8567c,13,13,1,91,13,0,04020,1
ac307e22656240fa6d85286fed9e4e6f,141,53,4,246.75,141,0,01012,3
32811e14931bfc7a263f5d55d4495c49,196,57,4,343,141,55,10200,3
3f55fae2b6d14fa573a59345b2b6f2f6,32,32,1,224,32,0,01016,1
84721ec2e841f62b4ccef8be7804ddd1,30,24,2,105,15,15,11100,1
7448b6a794bc5bb7033034ad365be3f9,165,78,3,385,116,49,05040,3
f2a153c9d7143b7188d334135b39511e,53,33,2,185.5,53,0,12500,1
90e162252cbc2ddac9580e44c3ab984d,147,70,2,514.5,122,25,01028,3
2b8d058365b03c049530c527b2cfabe5,26,26,1,182,0,26,05040,1
818a4f3c9ec60001d531e5a0d580456a,129,79,2,451.5,129,0,05030,3
662571d1961f467c1644fd298b4a66c3,11,11,1,77,11,0,09070,1
c8ad535883492090be7e524e1026126d,31,31,1,217,31,0,04200,1
9dc8acd630ec255a1ffdd8b709d40fca,26,26,1,182,26,0,10200,1
40174506203984d6fe3658d1c5f41d76,39,39,1,273,39,0,01012,1
0fd785494fdc764a7a43f1ed4e4a4a29,93,68,2,325.5,93,0,11040,3
c72d78660362a5ea1e8f1abf17468898,331,90,3,772.3333333333334,331,0,05041,4
a8a5f3504abc9aaeaa19a5c15cf3e339,46,46,1,322,46,0,09150,1
4ea253158d381aa628e16dd7f1238722,118,61,2,413,20,98,05040,3
9114213381881bb9ebebde4d42550264,176,116,6,205.33333333333334,159,17,11080,4
1c8a1321f09f28ab731def886f47cc63,21,20,1,147,21,0,01013,1
59450812601936e7f5c6f92ec2221613,27,23,2,94.5,27,0,09070,1
e1b6aceef91b59918fe3e783e9349af7,14,14,1,98,14,0,05040,1
d515230848f0032fd71e4c7cead91b78,36,36,1,252,36,0,10240,1
b7c0dd95183ea545d0dce5065a324189,50,34,2,175,50,0,01026,1
93fa509a07879be143c81d08896958bb,105,64,3,245,105,0,04020,3
d5bed7900ac7ccae1459cb16d3db7174,25,25,1,175,25,0,01016,1
02636fce66b944d675d32b09ed8389e6,343,129,3,800.3333333333334,203,140,05100,4
cfbc83efa2508fec9093adae558ba1e1,18,18,1,126,0,18,01012,1
8037cf7194eb21b97adfd110bbcc6043,24,24,1,168,24,0,01201,1
b1602df0897298422909bb83e9f13625,19,19,1,133,19,0,05040,1
d9eb096abcedea75665e4f9cdbe2048d,38,38,1,266,38,0,01013,1
b30abe6b7e04855715c0744fedfc78c2,64,38,4,112,48,16,10153,2
58bb3c49728bee1e4087c02b34f8bf18,125,83,3,291.6666666666667,85,40,11100,3
04092735dbb4074feebe1197147e71b9,44,35,2,154,44,0,07122,1
d69b438c86adc09259e29d46052724db,85,65,2,297.5,85,0,05040,2
386ca6b00ffe90ae5516692fa5c79087,131,89,3,305.6666666666667,115,16,05040,3
ba00b551deaaf0fa2d7c9ffcfbcfa16f,20,20,1,140,20,0,11103,1
5e7f04ef5cb08787f40c25ae0f7bea87,2,2,1,14,2,0,10027,1
a3fe911c529750e1974f48d8a47517e6,252,85,5,352.8,252,0,01026,4
4b7cad8cc72e173a5ad62e0502eb4f24,146,108,3,340.6666666666667,73,73,01026,3
f26ce60eef8ad7c32a19a28d38fda7ca,485,118,3,1131.6666666666667,485,0,01026,4
cae49f9662b9c70339c79f90abe0ee76,37,34,2,129.5,28,9,07144,1
e60bf5dbb371b1b46fda1ee9918fe141,209,111,4,365.75,99,110,01027,4
58d795fe9a3b240f55ae5855b110699b,582,160,5,814.8,368,214,05040,4
0e989973655ffc697a10cc845a4bd798,64,55,2,224,64,0,01012,2
9609394ae36d234cafec551ddf04563c,55,51,2,192.5,55,0,04020,1
7d9405d244dda23fac3952aca8d05917,112,49,4,196,112,0,05040,3
b1fba05d78bb0e67cac5f2f524315c58,19,19,1,133,19,0,05040,1
6058772732ae1671daffabdac25bb32b,37,37,1,259,37,0,04020,1
d52243e93b62d7d78c702d0aa1907802,20,20,1,140,20,0,12710,1
75322934a3a93286a20cb7aec60d906e,82,56,3,191.33333333333334,82,0,01085,2
f35f2e4fb50575d35cb73e73d7534c23,18,18,2,63,18,0,05030,1
189abeb3812feb0dbec529cab5597d1a,28,28,1,196,28,0,01026,1
6bd6d4177ca02bb19daccbbd985c5eea,178,98,4,311.5,134,44,05040,3
0160c215b086cdcd435db935c37b8a73,68,58,2,238,39,29,05040,2
10c3aca5f30347b9df7161052ab11db7,1,1,1,7,1,0,10040,1
e9159d3131890c7676065556665a0613,24,24,1,168,24,0,12610,1
d6487e480b7a6f48459c14c8a10a55a1,225,111,5,315,225,0,09110,4
dd4cbb46c9f6327a6dfb2effdc7bf49d,67,67,1,469,0,67,01026,2
f348f5f0dc2ef0b8cc0a2cc2e6f27981,127,63,3,296.33333333333337,88,39,05041,3
dad5ee4ce5deed82f3636f8a755b3bed,95,75,2,332.5,40,55,05100,3
d09aa26179facf0e6bc439c08d4a521f,36,36,1,252,36,0,05160,1
def535f46c45322a48084b5129712784,119,85,2,416.5,119,0,05040,3
50e8fbd55d32eaeb995092d88f708647,5,5,1,35,5,0,11040,1
e6f201989c067cf66ed29d06f7f5d48d,300,114,4,525,300,0,05040,4
32682137404ee5b0f62a208a795254cd,67,40,2,234.5,67,0,02750,1
a201a18b110b60cccf273b467c6055e2,126,66,3,294,126,0,13820,3
61cffb76568bb7c4d74c106391da4670,54,28,3,126,41,13,01013,1
89e2bc6bbeb252cfbbe4808164eab29e,16,16,1,112,16,0,01012,1
9184327b9d00f76f60edcd745da2e23f,49,49,1,343,49,0,05040,1
ce863fea67fb250a18544b8f30a8ff3b,81,63,4,141.75,81,0,11040,3
6daab00a1ced030b6084952f655f5c20,13,13,1,91,13,0,05040,1
51d8058dfac6b95378a577d250104a0a,84,64,2,294,67,17,09170,2
886bf03927935f10548d171d296b04b5,155,118,2,542.5,155,0,05040,3
7265bff1abf90a3dd3d9ae6364db8888,38,20,1,266,38,0,08452,1
4e2356a1a380e76b7ae38dd4dddc61de,17,17,1,119,17,0,02720,1
b9d6241f78dced80158b43861bc34df3,14,14,1,98,14,0,09130,1
2fb6507c24136fcb7d8a0cea0c19d10b,470,197,5,658,439,31,05030,4
1c0973bcddf6caccdee74f5d37da4b24,10,5,2,35,5,5,05030,1
25fc7ddc42adad108d7cbca32166edd4,110,61,3,256.6666666666667,83,27,10200,3
505b66384840108c0613abc994eb9d88,39,39,1,273,39,0,05040,1
5f208b629fb65369e2286e8c48203118,35,23,2,122.5,35,0,12570,1
a6a03d5c7131d5ac9898e4c059447113,28,28,1,196,28,0,10040,1
24b166e96bf3f3a92cbd0c3faa29d2a8,19,19,1,133,19,0,01026,1
260b46706b0ad47163faa3293422bd1f,67,49,4,117.25,63,4,01026,2
00374cb7f0170153c519747b4062201b,100,89,2,350,100,0,01013,3
90d11cc357642484a409735645d6e4d8,48,42,2,168,48,0,05030,1
fccb5dae7681a75258cbe6095acb2056,125,94,3,291.6666666666667,125,0,02691,3
d2c2d2aec65bb762291cf4b4662d1f5a,6,6,1,42,6,0,11080,1
173791ed86b96d3e9f90ac80fe98211f,28,28,1,196,28,0,05040,1
ec9392d1508d30a84c3f14a90fa60851,65,55,2,227.5,24,41,05040,2
2a55bf6b66802ba7c2c25e7079e6d2e3,55,50,2,192.5,25,30,05040,1
7662dcd24e922a73e64b60d3931e74f1,13,13,1,91,13,0,05030,1
cad4de3204c9e63dccdc88cddc89cad8,24,24,1,168,24,0,01026,1
e3873da4bcf85c480fd27d4a144f2076,93,65,3,217,57,36,05100,3
6bc6eca9f45b60fcc5e633a76ab4f16a,5,5,1,35,5,0,02652,1
abf003cd10a2f2c91984af0744548385,55,46,2,192.5,55,0,05040,1
149f932cf99aebe0262cd3df6e4f34be,81,65,3,189,61,20,01013,3
67ada8cd9f4a4fb43fc3371384af594b,33,33,1,231,33,0,01026,1
8f71680018873421fe8e723ad9172977,97,75,2,339.5,97,0,11100,3
4a9b803593efbfaea28c7ee89ecb105b,447,207,3,1043,379,68,05040,4
81a3a37a2f04c349702e74e4bc710b55,18,17,2,63,18,0,08052,1
aa4e68e0a6f3cdd3a9013453c670497b,48,40,1,336,48,0,08230,1
e3b19c56248a87b7b9c392e85d455628,69,42,3,161,69,0,11040,2
64592aea074dfe73422757ba5f3ce5ae,34,34,1,238,34,0,01026,1
fea334d973ddc2dc12da0fdc7dbd9a68,21,19,1,147,21,0,05030,1
bd0553987d30ea9c15cbf0b178fb8128,118,90,3,275.33333333333337,67,51,05030,3
fa0895dd5a7f86cab997fdb4038a9579,77,51,2,269.5,36,41,10200,2
c06ffd99504fdd227885d3415119b716,28,25,2,98,13,15,09150,1
df24339acc49320367ca9214f6b571b0,58,44,2,203,58,0,05040,1
d61fc9842012ebc39dbec4025dec063b,244,152,5,341.59999999999997,129,115,01013,4
9078ebc062c2ecaa4242ccadd4f6d782,24,24,1,168,0,24,09130,1
4170253f471f8d7204a1ab30000ade13,15,15,1,105,15,0,12591,1
f28348332cf98c42108984642966e72f,72,57,3,168,36,36,05030,2
fdc517d3cc01d940c636cf17039ce0ac,2,2,1,14,2,0,09190,1
999e7a72bb0b277a77d7c8d776907e2b,108,76,2,378,108,0,01012,3
0f7122e7d938615aaddc19e2531753fd,483,100,3,1127,483,0,05040,4
27b909d1765b4010f8d5070e3db2efc1,28,20,2,98,28,0,11040,1
76f6b58ad2f1ee340e1e67254287a121,25,24,1,175,25,0,12570,1
15906f317aa83c35d51772a1868c75ac,25,25,1,175,25,0,01012,1
5c45cb98809d772e0aaa764196fbb62c,55,55,1,385,55,0,05040,1
f9a5fda5da8fb9b378d95a329e3410ef,8,6,1,56,8,0,05030,1
1fe88942597859ae163e71cd7e6de5a8,37,37,1,259,37,0,10200,1
a2f3e2d741f95e7a97c02b291d3e2556,102,63,2,357,102,0,14301,3
65831c5e8a66331edac37f9b0958cfa3,146,137,2,511,146,0,01026,3
8f7f6459bcc4290320336303b4fa8383,81,42,3,189,32,49,11100,2
fac18c0e2f5cc44dd8461d8c488ef125,23,23,1,161,23,0,03050,1
469a947eaf358f97c45061a80c6dbd8e,61,49,3,142.33333333333334,37,24,10240,2
c9edb8c71e9858eda08027a78d77da59,69,37,3,161,49,20,05040,2
2579e68aeea7af46fdc855cc81eb7c0d,17,17,1,119,17,0,01013,1
2b02753f1dc9c075ab75d7e317d0e1c5,18,18,1,126,18,0,01012,1
c7b585f26aaccd4c651ed3c1c5646797,38,38,1,266,0,38,10028,1
9119da17e5048816562eb2bc695dc2ee,28,28,1,196,28,0,08031,1
859277b373d0cba909710541fbe071d8,66,66,1,462,66,0,03050,2
d32b256acda9c881632eee805b8c021e,25,25,1,175,25,0,01201,1
0ee1ace30c4b0362560c6ed90fbfb082,102,86,3,238,66,36,02751,3
8595194d3f5e3aca986e5917449e422f,14,9,2,49,14,0,10200,1
cb4e11f8ed1dd1632bf67d763f7f97f6,22,19,1,154,22,0,11140,1
fe05fa80774452489eacb7f24407165c,37,37,1,259,0,37,05040,1
89d9603ba5281b96db0b543504afebd6,16,16,1,112,16,0,01201,1
9ff60f2daed3cdff55d6d1575cc73682,39,39,1,273,39,0,09090,1
5d0adb9b597c548067580d8a92cf053d,34,34,1,238,0,34,01012,1
0b26db9b891b3a0ae4ff664271a6116d,97,54,2,339.5,97,0,09010,3
cb02cf62a49430eb0a009bc96cb842a8,29,29,1,203,29,0,05040,1
fdfa89b0d0ad442c22aa8ba063e552c1,170,101,3,396.6666666666667,170,0,01201,3
c1ca6a945ac816f71c89756345abaab7,137,94,4,239.75,137,0,01027,3
d6b89102355e794ef9ed9c2f54996030,55,37,2,192.5,55,0,05040,1
484c1d64500d186ae39067e0dd426c58,38,38,1,266,38,0,05040,1
d4ce93cc493de666668325c3119d8b8d,34,34,1,238,0,34,01012,1
0a677995535b53558e656640ec5fcec6,58,34,2,203,13,45,13953,1
4c695d8b13e1352cf21987b616a5ab38,17,17,1,119,17,0,01013,1
c97729041f4db43996cfe158ca2c79c1,225,120,5,315,182,43,03090,4
d1de7a56104001cb3ce790f0317c9723,383,151,6,446.83333333333337,350,33,01027,4
30b29b1a62e8938a75987a3525596167,376,142,4,658,376,0,01026,4
5b2678239e6adda47adf4681dd783e66,50,38,2,175,50,0,05040,1
f014ea67ec1b475e6694dd2af0a5f817,38,29,3,88.66666666666667,38,0,05030,1
bf756bec040b0896ba8ec1a47c82239d,267,119,3,623,267,0,01026,4
893b735808510383a549732e9052d83f,27,27,1,189,27,0,01026,1
124ef397824724aca7345ed59337a8f8,60,36,2,210,60,0,01201,1
b4696dd75b55c0e61c71033d89eb6d4b,66,54,1,462,0,66,01012,2
b3991d2ab7705d807d7ef65861852b15,278,104,4,486.5,260,18,05030,4
e6ad141aeae80e63d71493fa6df2bdc9,177,99,2,619.5,177,0,04130,3
ff301dbe8bce32204753afa5a0f5ae76,41,41,1,287,41,0,04020,1
14da22aaf945dd3a8faf3b3052e40273,24,24,1,168,24,0,05040,1
2b08b30a4369bc967e4f86de3ec18343,167,110,3,389.6666666666667,104,63,01012,3
4fb616d151f40f6735425353867725ee,321,93,1,2247,321,0,05041,4
21451570105c6baad4658a1f6113a0cb,38,23,2,133,38,0,05040,1
2fe64313f6b09acd422aee77ff527264,49,49,1,343,49,0,01013,1
edebd1c1a6630578900b5dceb49eb937,70,59,1,490,70,0,05100,2
d0704c794f9e3e3874d05467c5d4f934,47,40,3,109.66666666666667,41,6,11040,1
500aba8a332f93b6dfb1bf3d72a51739,59,48,2,206.5,59,0,05030,1
b9b069659a609b1a3cc3a74723883dfb,21,21,1,147,21,0,01013,1
41f2bea0eba2c9f15b96fd765ea9f7b0,19,19,1,133,19,0,08452,1
2b9136d8636eb1a25df32b55ff354fa3,50,25,3,116.66666666666667,40,10,12670,1
abaae5211dba16b6f3f277db3ea18ece,17,17,1,119,17,0,09130,1
dfcb7a4f3809c9acd1f7be82accad5a7,111,92,2,388.5,59,52,08314,3
b8e7e42686816eac965425a331fac2ab,15,15,1,105,15,0,05040,1
e6e28f456ac827513fbe6618da7c5ff6,25,25,1,175,25,0,09130,1
ba2717370a39f190078074593f0efe61,61,58,2,213.5,61,0,04201,2
8ff808b4647525d8e39d0302b3bdb843,21,21,2,73.5,8,13,08230,1
95fe9686d5e2f304c094c4596b11c204,90,51,3,210,90,0,05030,3
037c96c588e5d9c0d2ba38f07ab3464e,35,35,1,245,35,0,09130,1
ee43917eed2aa45d22a859a65222fad4,107,64,3,249.66666666666669,107,0,05040,3
8d803563abb51bbc36dcac85ebbcd1a9,37,37,2,129.5,37,0,11100,1
c8120d3e9306170e8fc0f348614061ce,52,39,1,364,52,0,05040,1
1a4acef7ecf7096a768cdffed7913ce9,69,45,3,161,39,30,09010,2
f8744126d6f331e4d6f893928b339804,73,53,2,255.5,57,16,01085,2
45e734e852c316879c709289fd082ae7,63,49,1,441,63,0,01012,2
ea7700e750a5d038c380cd86d608ac9f,92,65,3,214.66666666666669,92,0,05040,3
369ce1dc24cb0b39ecd9fd18412a87c6,17,17,1,119,17,0,09070,1
5a83bf5e0b4ea7b8f5f737a3a35d2950,50,40,2,175,45,5,11040,1
5b5d877ce547f863900f21acd08e5803,142,76,3,331.33333333333337,142,0,01012,3
c5509f876ade6d5805e4c6d5f59dd504,221,126,4,386.75,221,0,10200,4
c6efbb3e1334f0e450d97a422f66aa59,54,54,1,378,54,0,06100,1
9453f64347e2cd7d2d8bd954bb38230c,13,13,2,45.5,13,0,11100,1
5bd5f176699d68e5f63a4f273b19fb7f,137,85,3,319.6666666666667,105,32,05100,3
279861bc077f075e0e8d85f7a66a00dc,25,25,1,175,0,25,01012,1
04dcb6ee64b37f5193dd03d9668357c6,46,46,1,322,46,0,01012,1
abb061ace50c032cae71edf8cce32133,214,83,4,374.5,140,74,01085,4
8fec54c8c8f8961da23b8ad580235961,122,68,3,284.6666666666667,72,50,11040,3
3818855f0fcf4dcdd65e25bba89fdb2f,59,59,1,413,59,0,05040,2
1046c3b52f681f34129f9351f66838b4,43,37,1,301,43,0,05040,1
574256a1295cec41e0d478e522fc01a7,30,28,2,105,30,0,09150,1
7868a3324eb899716e05ad1854fb9d58,105,61,3,245,68,37,11100,3
54c77fee26efe4302d33b7ff828972ca,3,2,2,10.5,3,0,11040,1
9aef901cbf7ce671c3c470420a1b1036,177,86,2,619.5,177,0,04080,3
95c5e475c9f45d2ae393728e4d7fda27,79,49,4,138.25,62,17,05040,3
83888add97ad1591ab83345bf6eb10b7,61,59,2,213.5,61,0,03050,2
be246c1088515145d9282db31807fc42,25,25,1,175,0,25,01013,1
ea64f467ae19de38a9bf0dfec776ac18,94,71,2,329,94,0,05040,3
4342b511f6c877d1c86f90fb686e2f3f,295,129,3,688.3333333333334,295,0,05040,4
e5c2f90c1314d9bf1766f4f2f35570da,40,31,2,140,40,0,10080,1
b3950abfd9f6dfb01b32c3d6b7d1621a,110,80,2,385,110,0,05040,3
5014555842f1b1f8536308dd3d416177,12,12,1,84,12,0,02751,1
ac986effc439b7c49c51863bc2cc62a9,107,73,1,749,107,0,01027,3
ff348bc5e7b6a9b89633c3f25091ca77,87,63,2,304.5,87,0,05100,2
6985cb3b67a9cd0689070bf4182aff8b,19,19,1,133,19,0,01026,1
1eb669fad980e90c8ecc3ba1ae42b253,30,29,3,70,26,4,13930,1
a84b7b1e5334c04286821ce187006bcd,22,22,1,154,0,22,08052,1
5aea398f720da05655480827d2a93127,20,9,3,46.66666666666667,20,0,05030,1
2c60af6be3a3fccb4d2c184bc3224f95,129,74,2,451.5,129,0,05040,3
ae5e4ce90082484fc38cd2ed13900532,111,76,3,259,111,0,04020,3
737879508eed24eb9541f19bfabbd317,21,21,1,147,21,0,11040,1
f88057c0c15f20b35449dedc840c731d,75,71,2,262.5,75,0,05040,2
956b7dde5c16a7d4423990192b06aba1,100,66,3,233.33333333333334,100,0,10200,3
3bb868496842159907f219fca00b9390,139,93,3,324.33333333333337,139,0,01026,3
3602a9360d156bc9f138f01da3f9a238,95,58,3,221.66666666666669,68,27,05040,3
b7aea19a31440bd09b261bd8a1a72e56,98,92,2,343,98,0,05040,3
2223d2927b9c931089c5b38528b3e6fd,41,41,1,287,0,41,05030,1
d62a6e3f61fd691499c3b1607548c790,135,103,2,472.5,135,0,01026,3
d3c489949c49e2999e99095134a95f84,85,62,1,595,85,0,05040,3
5e4e53354dbd45d0281165773c49f523,234,129,2,819,79,155,05040,4
4e54d9d94b563ebc861ea00599c8eada,7,7,2,24.5,7,0,11103,1
f236366157f2662bd31a148b5f58527b,397,204,4,694.75,397,0,10200,4
5c5c76319fa9a83d94bc1df657ae3741,120,83,2,420,120,0,05040,3
7caa0987dd6a119f7710c86895d84365,145,88,3,338.33333333333337,145,0,01026,3
77e474f8a29b13295f890ee0b99d761d,19,19,1,133,19,0,10200,1
bb012d350c73bee6aa6a4f4b110cbe9a,19,19,1,133,19,0,05040,1
47c99ac30d94d93c0017b1d806e68194,25,25,1,175,25,0,01012,1
df66de8739b47a4faa86af9fcb1095e5,130,84,2,455,130,0,05040,3
c001c9c612365bcc371525f667d336f9,14,14,1,98,14,0,01012,1
0efa403d519d55c26a90974fe96ac6d1,234,145,4,409.5,163,71,01026,4
b0258cff175fb8d2de074ff599dd4afd,70,60,2,245,70,0,05040,2
3bc4d7492d4ed14de59ceb472dde0506,130,89,3,303.33333333333337,81,49,03070,3
8a441ee7d446552341981786cf7ab802,140,96,2,490,64,76,10240,3
4383d8a4e26b708ac2029485a4ec5aec,278,153,2,973,278,0,01026,4
2fb1b26e909875e6f9ec51af160211a1,379,141,4,663.25,379,0,10220,4
d6f5d7d01005c44a405bdb82b27d2b82,32,32,1,224,32,0,04020,1
22ef746955edefb761d1ba366877520b,69,69,1,483,69,0,01026,2
41ed6710372534020001ca0714846a63,86,70,1,602,86,0,02690,3
7da6c783628551c4165b2b377c387175,37,37,1,259,37,0,04020,1
3922a7b475781c7298ad59051dacd77d,19,14,2,66.5,19,0,08090,1
16af027917d3bebc69c4cb025bb53224,36,36,1,252,36,0,01012,1
b5ad6add73070761d074842a701433e1,46,46,1,322,46,0,05030,1
ef22ca142651d071134d2d50cfe11bcf,74,26,2,259,74,0,12501,1
ff4a9aa4ca1ed313e3ddbc4a3a0c6c9d,69,49,1,483,69,0,10200,2
1ae2aac57cb974d648ba28cf461ce47a,13,13,1,91,13,0,10200,1
4430ded7747c5a1940fbb460bca7db69,25,25,1,175,0,25,02690,1
634c94381dbf6a12c566fde4cc119f3e,58,58,1,406,0,58,05041,2
14b01d533a9414942e0cc4855a7cb3b9,65,48,2,227.5,28,37,05040,2
8b9aa623b654a8be21b316a5fdf41007,50,34,2,175,50,0,05100,1
3367ebc763f825aca04803d5144c56e8,11,11,1,77,11,0,01012,1
9891002b573ada7d212c9edcd8f686c3,40,40,1,280,40,0,04201,1
416e1f5a5ba2f015229f989cbd0d6bb5,330,152,2,1155,97,233,05040,4
7668ca6d170a39992e0bc08ed83146b9,43,43,1,301,43,0,05040,1
026bd54695364537bd53760c6ad0cc95,133,101,3,310.33333333333337,75,58,08010,3
a2480eed3011edea3092719eb27a1b7d,121,83,3,282.33333333333337,121,0,11140,3
e576361827183977c4fa8e568ec802e2,52,44,2,182,52,0,10200,1
1036d1041b3f6546a88702f52734dde9,58,44,1,406,58,0,05040,1
d14b29ecf96a8a5b0b15f4941f6b8a65,418,173,4,731.5,326,92,05040,4
f8f932d6d9596fb1455c04b9dde6079b,107,70,2,374.5,107,0,05040,3
fbafb5d862fe3bfe89be1b2b623a1d49,1,1,1,7,1,0,11040,1
d32ab64aad234f1acf08ea0d69db3ed3,156,97,3,364,102,54,01026,3
d14ee9ce404a2b95bafcba45f5bfc35c,127,68,4,222.25,83,44,08150,3
92748a3d73c5897f723bb9b6bce21d9e,110,63,3,256.6666666666667,110,0,11100,3
4cc996e21d739a9879827f20f9b54a15,21,21,1,147,0,21,11100,1
3414cdbdf15cbc76617c0cbea4b16289,19,19,1,133,19,0,01026,1
191fe572bffa7041a5480b769bf3f5a6,41,35,2,143.5,41,0,11040,1
45dc9b8efac1764192696190d65a8cf3,30,24,2,105,13,17,10028,1
45a7ca17d73553b2a3877b4347b0e2a8,45,45,1,315,45,0,01027,1
f8933957d0f121750507cd0c3f4c3fbd,163,87,3,380.33333333333337,81,82,02620,3
2b51d5a2021fa7848a577c78ed42c794,31,30,2,108.5,31,0,09130,1
22990dc4a3ece41d4add8d3ad487267d,62,53,2,217,62,0,05100,2
4d3a26b35b2f982313e1b6b897d50619,146,99,2,511,103,43,11040,3
6d0295de88f0607501105ab9e2098d4c,42,42,1,294,42,0,01026,1
3cdf538b40f777374fafbfac03b13633,132,84,2,462,132,0,05040,3
aec6713e840e6e425bf7e9a41cac1927,58,58,1,406,58,0,08314,2
37e80802dc95a3f278b425e51101c5df,112,101,2,392,112,0,01026,3
a8943fce7b3fe25b98a1b2fea1a4abaf,30,30,1,210,30,0,04201,1
8314bce29183dd69e7b90ae7124e1217,61,61,1,427,61,0,03070,2
3b4ad49f7c3db36a4ea516b831df67ec,26,26,1,182,26,0,09130,1
751ed526caa8a1f03754dae894a6d888,54,47,3,126,47,7,10040,2
7f9169eb4b86c2f105017c252343ee82,158,104,3,368.6666666666667,105,53,01012,3
53389f51dc9f3977ca99f9c09f25ac3b,21,21,1,147,21,0,08051,1
ccc1320ccc53b574ee27bef7a600cbba,30,30,1,210,30,0,08452,1
974433598b9e789a8e44c10b1eba84cf,428,165,4,749,304,124,08452,4
02d0e16fce6fa57d2451f8a0f3d719cf,162,91,3,378,162,0,05040,3
8fbf2f8d3d48f9c59cf607072cd4b44e,119,92,1,833,119,0,01026,3
12b9cac4f6478724fa6afd5da781e638,90,84,2,315,90,0,05040,3
79cca132d4ed0027df395380e41ec0cf,77,39,4,134.75,69,8,12670,2
96c6b4a67deb8929440b6f20d740d051,29,25,2,101.5,13,16,01012,1
9fa27d799f7e1bcfda47ee699d8214bd,66,57,2,231,66,0,08452,2
4f371ba19b65e9fe8318ac1c7f631490,107,78,3,249.66666666666669,67,40,05041,3
e68cd0f5633ab84a4bd2dd3520180fc2,26,24,2,91,26,0,09030,1
855d876eb1334bddc12f4476482beecd,29,29,1,203,0,29,01026,1
a5f988794c1793a845e1cb4162b5a2dd,76,39,3,177.33333333333334,76,0,05040,2
e4d3f2bfdfe981cabba1dddf58c3c033,137,97,2,479.5,35,102,01027,3
46867d6386c11d0fa2809976f8c1abca,29,29,1,203,29,0,01201,1
ab0f20d9b5de9b4b187446dfeb1cdc5e,19,18,2,66.5,1,18,11101,1
02f7f390651babd24e0c8edc34715563,33,33,1,231,33,0,01026,1
6c17d0ddb33ba18e5eddc3027359431d,49,34,2,171.5,49,0,09010,1
8aaf2db93a7a769e990d9f31e5f96ded,32,32,1,224,32,0,01026,1
9e4e43741b104246877b60993e7c08a1,59,48,2,206.5,59,0,01012,1
34aa179de27259ad50ae759a0e323b51,81,51,3,189,81,0,03050,2
c1094dcff42baa3e0b8c62f5f7e51014,28,28,1,196,28,0,11140,1
81f77ba3d9ac0c3efe72d4c2454188fa,24,20,2,84,24,0,11040,1
9961a93dcfeb50676f5a8c9205cf34e1,47,47,1,329,47,0,10200,1
b12d15fed999c47adf00c354c2bc35b6,33,33,1,231,33,0,01026,1
ae87c086ffdb9bc71b9a204d92e8760c,85,61,3,198.33333333333334,85,0,05040,3
1094bd3efa1f342b2a169158a8924fb6,35,28,2,122.5,35,0,02691,1
67ed9da96a1620fa076e1e660948e288,104,63,3,242.66666666666669,74,30,01026,3
19653062e75765088820524ac413c02a,24,24,1,168,24,0,01013,1
f347a99f8110fbc7aec2649638de1f43,60,60,1,420,60,0,01026,2
e83ecfccebd4bf03fd6820ad137e5c7f,51,46,1,357,51,0,01012,1
aed377d8cd9e28af4c9ec6aaae98e256,25,25,1,175,25,0,01012,1
2c9b7004d92604a0fdbc9e702080ad4e,17,12,2,59.5,17,0,11100,1
2b8c0acc197954ead1e336b2bab7e724,36,30,1,252,36,0,10200,1
a3804ee407ff099c9e297a7ae6b0358e,28,28,1,196,28,0,01028,1
3ac76ea700df6b9fedf68db7198c1d25,101,77,2,353.5,101,0,05040,3
967cdab5015758fa38c0d9d3f905aed4,18,18,1,126,18,0,01012,1
04e9cfbe49cf573a2c4821474e71eda3,18,18,1,126,18,0,11140,1
63e0be0351d34760a3f04a6cdc55f8c9,32,32,1,224,0,32,01201,1
580e0a6730c9ed583340e7bccdb5fca3,127,101,3,296.33333333333337,127,0,05100,3
165722f0a7a863c2afef0f8b11485771,27,27,1,189,27,0,01026,1
02a85c1a74a0a962c88a5c03d2113030,22,22,1,154,22,0,05040,1
c55ebe9d01f2c4242a3c3e4c4a5783f3,41,41,1,287,41,0,01013,1
65f08889ace520499cbfa29c26a73fe0,116,67,4,203,95,21,10200,3
ea23f79b0a84d41252f71e2f38cc8fc9,96,60,3,224,65,31,10200,3
aec6c2acc6f59cae0d88d31d0e706d2a,63,50,1,441,0,63,05030,2
38f0d6ab636af03f58529f735a8a4222,303,144,3,707,226,77,05040,4
d9728ea065a5a5a4e9a1a22914e70c26,41,37,1,287,41,0,05040,1
733aaa3bae38c50b3bf83de7e15e5a5b,29,29,1,203,29,0,05041,1
bc1dab5cd5248edef5ba7d44679d59c9,6,5,3,14,6,0,07144,1
36aed42311943a13fabc951519cc734c,134,73,3,312.6666666666667,134,0,01012,3
638e6a81c29f83c00fcd2b73adca5edc,227,115,3,529.6666666666667,186,41,01085,4
a338fc92da0b744bf76a790ddfb8beb7,280,118,4,490,210,70,01013,4
c1b8a685064ceb078cc8371a28840ff7,242,124,2,847,242,0,01012,4
e7886dc1b54ab1fa4c13d5979a11a842,400,165,5,560,400,0,11140,4
1f79c2a4808bb58abc1bfdefae6e80ce,24,24,1,168,24,0,08052,1
2e3217c6eefad3026f6ffc744c003d18,9,9,1,63,9,0,04011,1
8756392e4599a1ee3c0280e628292b91,33,33,1,231,33,0,05040,1
a05f583c6dc662089e739c8a6c87d7d5,25,25,1,175,0,25,04032,1
d511cab3610a9127ffbeecd2662460b6,114,114,1,798,114,0,04060,3
c0e7d4fbd984f90dad98edce8101dbe2,119,89,2,416.5,26,93,01026,3
06c2b458f36109f547472b57f8617330,26,25,2,91,26,0,08230,1
394b8fe1b08e72429d6fed885eb02c86,167,105,3,389.6666666666667,126,41,05040,3
00f137eee8a122fe3a1e60234bb5a025,40,20,2,140,20,20,01012,1
99bf4fdaa3baa37b71f65510440a2213,12,12,1,84,12,0,08100,1
732c89c501b6a7362fac1a3d9e7e857f,159,107,6,185.5,130,29,10028,4
7fcb09222dac5f2e458144ce07749c32,105,65,3,245,105,0,04060,3
4dce86a9cdd5d7bf60a4c5ac58c9963e,25,25,1,175,0,25,08170,1
d5c3d0865fde93cb99181bb3ee7d8f84,11,8,3,25.666666666666668,11,0,11100,1
b3f4810221f5971e8f5c64cf8d7634f1,28,28,1,196,28,0,11100,1
3896040fe085ca57dd200ee647edc05c,14,14,1,98,14,0,11100,1
4325c4437acb20335ad5421e1ad2a775,7,7,1,49,7,0,03050,1
1d05d422b5654102e8ca1b665a9c72ca,48,40,2,168,48,0,05040,1
18ac567032b07fdaa35b9c727f6b0eb8,55,55,1,385,55,0,02650,1
adfccc3ae7c82088df20563f7da1ebc4,2,2,1,14,2,0,11080,1
35ab354f6de04c17f2a2af48078a82db,70,62,2,245,70,0,05100,2
04dcd87d10ec0278df760e972fa00c61,71,52,2,248.5,46,25,11100,2
14826fc31dd29c2ca8c30c51660619a4,57,50,2,199.5,31,26,03070,1
aaf7a90b85294f475441f293e88b0f33,71,57,3,165.66666666666669,54,17,05040,2
6b5faa5358a181bd2cabd2b3fe473b3e,10,7,2,35,5,5,08230,1
387cb677bb6125396e42f8bfb169e47d,125,92,2,437.5,125,0,08314,3
540de465aaff43045679f964b8d1ffb6,34,34,1,238,0,34,04020,1
2af6df3d10197e314b6d2766cdce6696,111,93,2,388.5,73,38,04020,3
d27ffd43db4d5f22111b85144c870b82,138,104,3,322,106,32,05040,3
f8e687f46a56131e25ecf361e1266188,39,39,1,273,39,0,09090,1
021106ad9457c59fb08950ed482db228,80,51,2,280,80,0,01012,2
430db2c83fd655565ea98779d20c50a1,277,141,3,646.3333333333334,277,0,05040,4
21b5f3ceced18ae8d3554ed968aba8a6,139,72,3,324.33333333333337,114,25,04201,3
3cd3b65a772ac28abbc2193f6547b123,49,49,1,343,49,0,04060,1
2081c6b6afa3523a8b44c29011c94dfc,35,35,1,245,35,0,09090,1
34d1d4bbfce87f150ff9fdab090eb3d1,86,62,3,200.66666666666669,40,46,10240,3
9564c68baba85da2153073296968e469,22,22,1,154,22,0,07141,1
388523457c6fb557aa389c4d5ae13b27,16,16,1,112,16,0,12470,1
37b641f314331dc6e6a93c481d09ec85,10,10,1,70,10,0,05030,1
3a57f53c21b2895f12535f9b64729250,68,47,1,476,68,0,10200,2
501b2f658243c2adadd68085cfd8972a,186,108,3,434,186,0,05100,3
b3a967c9e833e7cd6e2ce3a4414e0dc8,12,12,1,84,0,12,04011,1
a5d9997016d6b296a660dcd96b42913e,89,50,3,207.66666666666669,64,25,05040,3
514c0f094e78cfebb11989b319f33b30,409,115,4,715.75,409,0,01085,4
9ed043f0efde4151bd8d15b08c8aa4ee,16,16,1,112,16,0,01027,1
9670efa8a8232235d11a572449eb7291,24,23,2,84,24,0,05100,1
e015727b764d895ddf89fd137aed7294,305,133,4,533.75,216,89,02690,4
24eeb064e3af4a7f91ff656a759a9e3a,230,104,6,268.33333333333337,174,56,05030,4
65584bcff3c899a4941b05a55dfe404d,73,61,2,255.5,73,0,11080,2
f484d49b652bcbdeaa8fdebb195bd55b,134,78,2,469,134,0,01027,3
679631827335718e870efe6140422f45,64,54,2,224,64,0,10080,2
743d9628074e7e7d5542050b52c118bf,1,1,1,7,1,0,13952,1
7bae7b94f05ac96f45eff2f9e721176e,33,33,1,231,33,0,05030,1
3feea50c54a02ea478c7b67111c4c675,14,9,2,49,14,0,01012,1
0fb349206a05947b9bfd5f06830fcc46,269,128,4,470.75,269,0,05100,4
03f37242e8bde089ea235ceb74343128,48,38,1,336,48,0,05100,1
ba97b8b1f36495f93cef30556c62b904,241,95,5,337.4,190,51,05040,4
59c654a3f0786b06366255332a3d48ac,145,97,2,507.5,145,0,02650,3
aba46792d419b835c3c36c5ea63110b8,134,74,2,469,134,0,05030,3
d3dc6cf1c937dd35bb150b3d02a29992,18,13,2,63,18,0,09010,1
410dec3c5eacb4975f7630ab4f6675d1,153,68,3,357,57,96,04020,3
d92b7d37aa807037526afe58a0f020fd,37,37,1,259,37,0,08010,1
ac0d5ee5deb750ed99bb1602bd335491,82,82,1,574,82,0,05100,3
ceade91140314d2ae6be816780825805,29,29,1,203,29,0,04032,1
581e1dcc2ea102f597804c4f4bd81216,89,73,3,207.66666666666669,60,29,11100,3
4edcdf385603d48fbe586b4bac067a76,37,37,1,259,37,0,01027,1
864676e7441b5ac20b54abd3ff8eb4a4,57,46,2,199.5,57,0,11140,1
b173d542a233c29fa272e1fe96ea4d2d,16,16,1,112,16,0,10200,1
26dfe611bdd6c75fa96d96125632e5f1,47,47,1,329,47,0,09130,1
481663a859d79088524300be9d95205e,43,43,1,301,43,0,03090,1
89b8332237e0d0aefb0b88f90d2ad521,68,42,2,238,68,0,12410,2
e67e5a009859090f482456085b8c906c,99,72,1,693,99,0,01027,3
4241fc0385b775dd1bd9cd3ee4eb4670,96,67,4,168,96,0,11040,3
2b8e737fa814efe1bc9ab6a8b4b38512,16,16,1,112,16,0,01026,1
c950adf8206b3384d8be0215d1622c53,10,5,2,35,10,0,11100,1
a24a08e9069d17bee7dd58d0c0f795f7,284,101,5,397.59999999999997,284,0,05040,4
e6c088ee16abd35292b305ecbff7d6a4,299,122,3,697.6666666666667,249,50,01013,4
812dfd6aac88eeb083d3bf37b218195b,7,7,1,49,0,7,10220,1
1d48f0e4cbda9f77f85f1d3b04893134,150,77,3,350,150,0,04020,3
0912fe0f2c654d034acf6702c6993b8a,81,50,2,283.5,81,0,08451,2
87115c2b5be116e3529945f96a32ec02,1,1,1,7,1,0,08135,1
05592e60b7d5c40168e171c6dfc1a742,18,18,1,126,18,0,05041,1
40c91fa04b26b82a45ed883cdd242ddf,443,95,1,3101,443,0,08010,4
431106a06ddfc89fc5b8011f412f3b5e,285,185,2,997.5,285,0,10200,4
c31bbcc1b6ee61a1e4825756cc72d563,90,76,2,315,90,0,05040,3
73fc4eca4efb60037848df1122b77f4a,62,47,2,217,29,33,10160,2
5fd72297cf4fc499c68a993273e0ab95,40,35,2,140,40,0,05030,1
910e9ff3e8c7e92d02ff01ebd2a9a9fa,141,75,3,329,141,0,05040,3
e9b37346e2153157fd6f6a40d027bd85,291,118,6,339.5,266,25,10240,4
7902bf1c42e35536d3006970857bea3b,31,24,2,108.5,31,0,10200,1
d85f9ed57ea42144b5e02b1aa1ecd67d,67,43,3,156.33333333333334,57,10,05040,2
39a999ed983bdfc0e1b89021e6b8d176,152,78,4,266,133,19,05030,3
68f3f380e5775cdea7b5fb1a5b438a46,79,57,2,276.5,79,0,04201,2
6e3eab37078860bc1016bce77d302a93,26,25,2,91,19,7,05030,1
def405862d3a09c911fb207bcb31d4e1,52,38,3,121.33333333333334,36,16,05030,1
2013febe9c7e33a1bf59e6339ac13c38,5,5,1,35,5,0,05030,1
5cf70b28aff478ca0bab07e8507566f4,6,6,1,42,6,0,12670,1
3c9d38e0345416b4bbbffcd587c31067,34,34,1,238,34,0,04020,1
d56d66cdbb8316c09ac2cd0bb9c43c0c,70,60,2,245,70,0,01012,2
6f0b1ba0128241a51fc6432228e2bc8a,27,27,1,189,27,0,01026,1
0aed8f20cc5bdde79adb21e186fe4f64,29,29,1,203,29,0,08110,1
a58521f820bf4fd3770597fa8d56c550,497,176,4,869.75,497,0,01027,4
051351e49aaecaba612fa348d56a6032,55,49,1,385,0,55,11140,1
78b927a0bbdcefc9873d1487b31969ab,7,7,1,49,7,0,01026,1
3a8ac2ef356bd203ecb4f65cbd22ac90,11,8,2,38.5,11,0,11040,1
b64c59e42aeda0f3b1149db1f59f8031,132,54,3,308,92,40,10028,3
ad77e3afe2d59cfc48a9d8123c150d59,289,158,2,1011.5,59,230,01026,4
f518285077048c8f9209afeffee2fdf8,47,47,1,329,47,0,04060,1
e331986ba51024fd3ca03fb604c4345a,627,174,4,1097.25,574,53,01085,4
745128ae7298fdf2c79d0662f148a03c,22,22,1,154,0,22,08100,1
d71537265e72848619090ecb8bf451af,12,12,1,84,12,0,10220,1
009f5fe6b557854af99fc59e900245f1,54,46,1,378,54,0,05040,1
88fbf70ec26d2d9198927251ebb916d7,48,48,1,336,48,0,01013,1
1d6b63f54c2f41563a598057642a5c1f,13,7,2,45.5,13,0,08230,1
9f10a6eaeffa6105220a12c82337b430,45,45,1,315,45,0,05040,1
1977f46060a866183f39b1e17b044eb6,39,34,3,91,39,0,09010,1
c1b9ab4d631b329fb0a83591e35bd361,26,26,1,182,26,0,03050,1
147c67b8ba87f69f18b925cf856d733c,420,143,4,735,256,164,01027,4
7ec96393d9861f51499df41d1d855048,15,15,1,105,15,0,10261,1
ba1909296a4c13270bedbb673f21247b,59,35,3,137.66666666666669,59,0,09130,1
80e31f3110ad8d6ce43acb0d34249b19,258,108,3,602,140,118,01012,4
baca916de8e4b5647acb6eb44017999b,12,12,1,84,12,0,12570,1
3d9afbfcda42d407b6729e1262c126cd,13,13,1,91,13,0,10028,1
ab665d899358eaadf487421ea5921ca6,56,56,1,392,0,56,01012,2
776710ec0e4807fb56dfe52d6cac3aae,462,136,4,808.5,462,0,05040,4
ef5b25ceb19bcbe40cca99e822e7625b,2,1,2,7,2,0,12590,1
fd737f0c5d42e2aa28050a76584f9431,328,116,6,382.6666666666667,197,131,01026,4
9115939873b609ce0900afc09d303839,117,82,2,409.5,54,63,05040,3
c350fe0f258dd52ba9d3db31a998a845,8,4,1,56,0,8,01013,1
c4ade4c301bc1c5f6a85d7d61c7e25f6,71,58,2,248.5,71,0,05040,2
1ef738d620bdf51f363ce8fc6f0b4458,23,23,1,161,23,0,08170,1
92a594fc4ff6f9ce77573a84b78a4b80,26,26,1,182,26,0,01026,1
01054da50fd5e4de74287bd765859eac,74,59,2,259,74,0,05100,2
d75cf30a7163240d1288e0026418f4b6,14,14,1,98,14,0,12570,1
186aa09d2ae4c19760c27683f7695a0b,15,15,1,105,15,0,11040,1
e4c6819a8f33bbe6f3d79a53893e7d42,17,17,1,119,17,0,07144,1
a5a36259fc24dae44c4734e4cd461189,26,26,1,182,26,0,09010,1
978d42f1bfcad22a87fb1ab74f6d2769,90,61,3,210,90,0,05040,3
d1d58d8f8a069f39cec98b98faeef49f,45,45,1,315,45,0,01012,1
f97fc3aa9144f9a62e2f400b17702b07,88,69,3,205.33333333333334,88,0,10200,3
b1567e0e61ef545b214863bd73ed8265,21,21,1,147,21,0,10200,1
801ff07bc1745a0d5e149ee2c681830e,274,112,4,479.5,221,53,01012,4
df2a19235ac258588767d9b37ff82b01,412,130,4,721,325,87,05040,4
b1733dd7a7cb638666bac25f1bfc4323,36,36,1,252,0,36,05040,1
3e7fe79e5be34fa8aa771c2f03e8abcf,33,33,1,231,33,0,01026,1
4c303568a76b8cdbcf45518b426a85c9,297,158,4,519.75,231,66,05040,4
1564c2a556d50c3934e92455c5bd5a4f,37,37,1,259,37,0,01027,1
c3354d74fcb78ad82c0a1faf17c6070e,78,53,3,182,78,0,10200,2
da726040a725a66230303c4ccd449a8f,405,110,5,567,312,93,01085,4
b9db6c2c6ad246261c41eba4032bbe43,163,107,5,228.2,117,46,01085,4
4a3c27f1d1a7595afedd8cee3b619ee7,54,33,3,126,54,0,05040,1
02f8c4841cae59412bf9ed9d6191b04a,16,15,1,112,16,0,05030,1
2593902299df72fe42eb701fd1781da5,117,92,4,204.75,117,0,05040,3
de48ebf37a104c646d0457e72bfa0f0b,98,74,2,343,98,0,04080,3
5a819b1fcd9f76620ddf80bc54ea2f8e,27,27,1,189,27,0,09130,1
1d9978bf4733d8f0e5f4d0d6427191f7,164,76,5,229.6,133,31,10240,3
34d683c1c0a90d62df47f0fbfa1b9a44,23,23,1,161,23,0,01026,1
b94ef51d890e483455bf64faaf029345,26,18,2,91,26,0,04020,1
6e460a306de84d2c561441bb2659f754,88,56,2,308,88,0,01012,2
baa9447b185f0fb100bdf9eab7d8abd8,21,21,1,147,0,21,05030,1
c135a5f2b4b53f1c3d90df283e5ec83d,64,54,2,224,64,0,05100,2
89483a174e142686cd50d7d88d976608,12,12,1,84,12,0,09130,1
120b31986fde3f6e98535b5a9d1caa37,26,26,1,182,26,0,10281,1
9a6c045984a360e790c45afff884293d,32,32,1,224,32,0,01026,1
cf67fc49ab49889295f73f20a18b61eb,18,18,1,126,18,0,09150,1
53aaa48c19a6485ff0af6df994b8af86,61,61,1,427,61,0,08010,2
3bef6b7b222d5096113d3004b6d705e7,38,29,3,88.66666666666667,38,0,01027,1
b5b361a14abc21c2e6b576ff91bf26d7,35,35,1,245,35,0,05100,1
0ad94352096658f06ea0556a2b207a11,46,36,2,161,46,0,03070,1
d879c5b72b24a203dd24facff7bcfc9a,51,51,1,357,51,0,05040,1
b3aa121a2af5d028a6b3b38fa16f9130,20,20,1,140,20,0,04080,1
b64fbab3213c2201b28d413241aeb1f1,451,227,4,789.25,327,124,01013,4
dee65cff545f997601126821ee96e8c9,12,12,1,84,12,0,09030,1
816736b1ba3688e38fd94a14c69d7c92,35,35,1,245,35,0,04020,1
31a8cb30f7d565903782d3590855e762,243,101,4,425.25,185,58,11100,4
9202a257cd075eba9afe97baa694c098,69,55,3,161,69,0,05100,2
e0e4252d0185039a51772138031ca6b5,27,27,1,189,27,0,05040,1
75618131f7b98edc43881f075248a221,76,44,2,266,76,0,01013,2
797d89ee0efec110668e77b0dedeb4d6,17,17,1,119,17,0,08452,1
1e37340da0b58eec13d8173dc5622e92,145,74,1,1015,145,0,05040,3
02d063daabc815b560d0fa1be872cb43,53,28,2,185.5,53,0,11040,1
ca38f05c82deceb3081b7660fa590bb2,12,12,1,84,12,0,09010,1
4f55402ec9d7dec4cfa4dc17d751b913,267,114,3,623,267,0,01026,4
3d8ed5ea1c95c7fadfc2196ad59094a1,14,14,1,98,14,0,01026,1
52dd73ddb95ea1d23f3e529ab6fb3199,20,20,1,140,20,0,05040,1
212231c2fb52c37e781a7f333919bcf4,38,38,1,266,38,0,01013,1
fd8f405feae0aad9f0439f1721f1c1c0,68,64,2,238,30,38,01026,2
ba4e0c49b7bf9c0cab9a0447df523c34,14,14,1,98,0,14,01013,1
1ededa9ec4b4e0e0a14678c4ef62daea,13,10,3,30.333333333333336,13,0,11040,1
985c988ae14301cd2184cd7ad98b003f,441,97,6,514.5,316,125,05040,4
eaa9b127514946892e25119088ed9600,47,35,3,109.66666666666667,47,0,05030,1
c8af6530386e27fc781e0912873619c7,94,86,2,329,59,35,10200,3
9d3ac161077fc7e5b93b2e0406d18ab6,6,6,1,42,6,0,02650,1
fa00fd36516f0c9a46c06984a60d4217,96,71,2,336,96,0,01012,3
49fde53cfd923f98a148082af0361613,349,136,6,407.1666666666667,279,70,01013,4
b5d44cfa567965e820265f7492a861e3,45,45,1,315,45,0,08452,1
e90fb32102a11a05350a0f0aa09bfc59,44,42,2,154,44,0,05100,1
7925456ac90e8ac4110b41a0edff9b28,158,105,4,276.5,75,83,01085,3
66da33c0c776330acc0369febdc43535,75,63,3,175,61,14,10101,2
3a3949c7ff83d60a441ce782303a49c3,18,16,2,63,18,0,05030,1
305fa460575980a8b01b65c985932fca,89,58,2,311.5,64,25,11100,2
452faeb925881b1dd895345be0a4490a,161,121,3,375.6666666666667,161,0,05040,3
27935fe17ee230c867606fd0ea95136d,30,29,2,105,1,29,11040,1
546b564539565657c449ad35fdf2ee33,60,43,2,210,60,0,08232,1
882cc07b321f45499d0f14d5ae6bed06,96,78,1,672,0,96,09130,3
0e262a2d4f928cb1c76280084b758d12,22,22,1,154,22,0,09090,1
c8ed6e980078b7675f6f63b9b182090d,28,28,1,196,28,0,01026,1
76ca3657c1fe887b4a00717597d52c0e,200,101,2,700,200,0,01012,4
9048d6fe5ca7079b2a6866d08cdb667e,172,135,4,301,168,4,01027,4
bf1f9f3f262d885a003ba4fa13d50d65,501,156,3,1169,206,295,01026,4
ce46faf88ec8cff8b16a0f5f6d1ef1fa,3,2,2,10.5,3,0,11060,1
e220e3994bea7a9daf6887d06da5db6c,284,125,3,662.6666666666667,203,81,05040,4
fe44dfb99c79a82e305416053764e132,96,56,2,336,96,0,05030,3
f9c466831ee7734c1abe1614bb963373,15,15,1,105,15,0,08314,1
0b1d2db8bdd8e16b771f2276c77ae266,73,37,3,170.33333333333334,73,0,11100,2
da4635449d42430e6419bbce53b122a3,64,58,2,224,64,0,03070,2
5e8802a05d061c376b2ede18e7edc8a2,32,32,1,224,32,0,02650,1
251a0adbfcacb73d49e74705ee3dfe96,45,45,1,315,45,0,01027,1
2d30fb1d257aecbe1dfaa50fd99215e6,12,9,2,42,12,0,11180,1
f5754d27e1561c86ecbd2cf0ca399197,9,9,1,63,9,0,10200,1
6c4eca2c257e77e36eae9db70e603732,152,52,6,177.33333333333334,142,10,01013,3
0f311809c12890f67ded04dd3396b838,121,99,2,423.5,121,0,03050,3
cb4706dbfbc172143867daa184aabf18,24,24,1,168,0,24,03090,1
83c4bd98c3966001ea9ee13f5e0ca076,41,35,1,287,41,0,05030,1
d296c6170601653acf7b7ad92c46013e,53,51,2,185.5,53,0,03090,1
bead4b30e809ba8846263df1f1b55e78,51,51,1,357,51,0,07141,1
51069f18ca17d05963f385c117a58909,27,27,1,189,27,0,10040,1
8647a34ce130005bc1bdf1a0fb371116,33,33,1,231,33,0,08010,1
8435c43ac33c5fb189312bbb98a825a0,55,55,1,385,55,0,01026,1
bf4105909e0b8733bdbd1f01b292fced,180,103,1,1260,180,0,05040,4
74c23cbfa353bced5c37929d89800da6,36,15,3,84,36,0,08150,1
d9d48b84aaac1827396dca05cc31fd8d,31,31,1,217,31,0,04201,1
b8f7c6edfb6e4c86170e724a99a00349,21,21,1,147,0,21,05140,1
a68e30e8fa777b6a8a259e166bd60d9c,73,52,3,170.33333333333334,58,15,02650,2
bd90dd3e84ea6b741ae8650dea3e4cea,84,41,2,294,84,0,01026,2
07fa97638b5ea341910e7e9fa60b4418,10,10,1,70,10,0,05030,1
aae8cffea988b026460fc30f40c74b2b,135,85,3,315,69,66,01027,3
13f3fbc79e057523ca48376fccf30b6a,92,69,3,214.66666666666669,62,30,11080,3
c4257c49605def665041eb25dc1af3a3,28,28,1,196,0,28,01085,1
9c6d31b380d58c73b5cd3ce35e1f0072,20,20,1,140,20,0,05030,1
c07bca2d781454af720089caaea0faf7,44,44,1,308,44,0,05040,1
8b6d6c22b916765c3e1249144c7c2410,105,43,2,367.5,105,0,11080,3
3cdd76dd962dc329b3998fdc0cb32229,84,48,3,196,70,14,01027,2
12c9b6a206eea15d050451fa33904c81,41,41,1,287,41,0,09010,1
71184e675bc8d9547c7b3067f52e0c6d,200,42,3,466.6666666666667,200,0,01027,3
fd4cbfc2177eee3e532546b3aae659a7,30,30,1,210,30,0,04201,1
43c190ca3f12a0ae2dbc3dbb1f69a9ad,309,126,3,721,309,0,01085,4
fb40ee630134be32bf57efb4df6e66a0,84,60,1,588,84,0,03050,3
5f71881c65f1450a129b36ab45de896e,30,30,1,210,30,0,09010,1
df96f52e17d808b37fc847a2d7d1a19f,123,84,3,287,123,0,04020,3
b5a5d7807b340dae34e1f79e301472ea,28,28,1,196,28,0,03090,1
cdbf43158fb443d338b0ca25ee031cb7,37,37,1,259,37,0,03090,1
ba57833056fc9812aab43e541548db67,233,86,4,407.75,205,28,01013,4
185fb39eaf3a8acb921dae3743e6d0c3,32,32,1,224,32,0,09130,1
069befb4a810c07cc5d16252c9a8356d,40,40,1,280,40,0,01013,1
ff393db108aa0a5fc7921278b6d9958f,67,65,3,156.33333333333334,38,29,05040,2
23a2c550c5cccbdff564c84dde7def21,150,79,3,350,150,0,05040,3
aa3d9d98922dbbf5cebd0d8190e4e973,26,26,1,182,0,26,08052,1
97c4facf586eb39687a34a2be0fffd55,121,67,1,847,121,0,01026,3
c7c49a7c9c34f8872eba7e54038ef79b,98,83,3,228.66666666666669,98,0,01013,3
172aaf29b6cd73bc64f5e5ba6ed47da9,39,39,1,273,0,39,01016,1
25f5e1923f6eb5d72a63a55354e96552,10,10,1,70,10,0,08100,1
b837c1564899f33587b0c690daadca0f,27,27,1,189,27,0,09030,1
a38a0f1f6c748ec2e7ea91abadf891f6,118,73,2,413,118,0,01027,3
80e840d5cf320593f782843eef642cd0,102,70,3,238,74,28,09170,3
130175c5e24d5a98c49fd38c6c330789,155,75,4,271.25,155,0,01085,3
0bc7d778981eff6ea9c6e97d140b818a,221,69,3,515.6666666666667,221,0,04020,3
1f39a69f6c5e37124330f25b08b493c4,15,15,1,105,15,0,10200,1
7cc419475751bfe92597a26086e3d717,188,94,3,438.6666666666667,114,74,05040,3
c1a33dc5c15303b6d9087b008e7a073c,1,1,1,7,1,0,09190,1
f0d9f3724063d8398d77d2642cd8736f,311,186,3,725.6666666666667,197,114,05100,4
20fcb8ee45dd83e157fe9f0e2ba843d7,67,42,2,234.5,67,0,01027,1
800812bdcd3c7e0f13e33d2ce622f670,41,41,1,287,41,0,01012,1
588adeaa42d5a2eddf2028f3c86f32ed,3,3,1,21,3,0,09190,1
84cf41235756697cb023274d444f47ac,235,124,6,274.1666666666667,208,27,05040,4
c9e26f5f312f0aabeb1687be09f5ed50,46,38,2,161,46,0,08150,1
c91ccf21d0271438343100857f326964,65,44,4,113.75,57,8,04020,2
84cd26191592b9132af9135bd9d99e80,35,23,4,61.25,31,4,11040,1
e04180da5e700ead471a6eca014a8732,10,10,1,70,10,0,11100,1
5177f59a3a46f132265997bbdf8bcdfa,34,34,1,238,34,0,09130,1
d3b50ce2e5893b88691a83ff8fe46928,124,63,2,434,124,0,05030,3
38dca3466a859ddf118f5b3d8ad58844,45,34,3,105,45,0,01026,1
b3f8c1a84f03c3a079c012efc0bb51a5,132,63,4,231,97,35,06100,3
eaeb9c005d4e119d8aa43b58f1d33bb2,313,47,3,730.3333333333334,292,21,04032,4
1315d6641e9bf898540ef131c31f8c5f,10,10,1,70,10,0,04031,1
9646d5be501373e834c8c9706a1e963a,40,29,2,140,25,15,09110,1
a6765738259b70a24ab57f096bea4f30,176,89,3,410.6666666666667,151,25,10240,3
d70b94222230e692f05ba52bc4a507c0,2,2,1,14,2,0,10180,1
f9a2aedb93101762ccecf21e102e62a9,76,66,2,266,48,28,02690,2
84e648acb786dd66e5e8a2ac434d0084,87,49,4,152.25,61,26,01013,3
3166471fe1cef875c19f8020b8914ad1,14,14,1,98,14,0,10200,1
7d030637802e5f6e5b5ce77fd5bcfdc0,20,20,1,140,0,20,09010,1
7b460bc5db7f3bc60e93c9b01bf7d1a8,317,101,2,1109.5,317,0,01012,4
0a41b8534a99b9c70a871ad1bd827150,91,64,3,212.33333333333334,52,39,01026,3
60585d79e6cf77adcccb5d9efb8b81ce,21,21,1,147,21,0,01026,1
afaea5cf318f9a75a064a7eb1364a832,405,149,3,945,281,124,01027,4
cd59c8e5fca5106ba78a3ae9449378b7,82,51,5,114.8,82,0,01012,3
7167f3eefb97cf782a245accfdf91e7e,22,22,1,154,22,0,05040,1
79f9b69f71ee9a76f5102126a4535111,39,39,1,273,39,0,04020,1
859cfbbff0244e6e004bf81093d57e1a,24,24,1,168,24,0,10261,1
35bdfc3cdb026b90ad9f219becabb3be,113,84,4,197.75,94,19,04020,3
4cce08a2ae2956bd3ce48bbc60d30ea0,20,20,1,140,0,20,05030,1
ff82a7d9ffed4125ef5139039b66bad1,52,52,1,364,52,0,05041,1
f168b6c482df37207eceaaf9150a1db6,508,204,5,711.1999999999999,508,0,05040,4
a907e7aed20d2a4f3227fedcb4fbc3f1,108,75,6,126,95,13,05040,3
f1f5515054559b3dd811d4d8d8382841,99,63,3,231,99,0,12650,3
1ae3a9d3cd6babf12ca0c2672fa4bcf6,131,88,3,305.6666666666667,84,47,01026,3
1c944ae32e1c54a2a31e810f6296bbe0,72,51,4,126,72,0,05030,2
286c4bd359c3bb76d40db75d80df1c08,31,18,2,108.5,31,0,13930,1
2a2f55baf952264fef8ef8f2d110bd45,19,12,3,44.333333333333336,19,0,11040,1
220b78901bdd6a092e4be12c759e21e2,44,43,2,154,44,0,05040,1
79d34cab0a16d49a219e36e231219216,16,16,1,112,16,0,05030,1
07fac0a88877aa0133ab2cb540c062c7,165,112,5,231,128,37,05040,4
f83e5051abd6b9b9e381baa59e7ae7c7,25,25,1,175,25,0,01027,1
4f5212f9e223bf6ec64e156596752f92,33,33,1,231,33,0,01026,1
5d3c2fad241511cd253406d59c8b6faa,50,50,1,350,0,50,01012,1
0a554b203a95a3cb56f58c7b5db8e514,103,67,2,360.5,29,74,01026,3
c16eb4a3f7b191bd17cf403fa6f19867,62,47,2,217,62,0,01013,1
df19a913dac861fb9841ea451cc047d9,51,51,1,357,51,0,05040,1
351210e46e5e1c3176889c7ac9a0d75c,95,68,2,332.5,95,0,01027,3
afe6394e2c9b6fa88c0e4f26f402b700,32,32,1,224,32,0,02751,1
56a7d48b132db897fb96367c4db03d56,9,9,1,63,9,0,12591,1
9de7a0546c7644366235a2995d98bf49,25,21,2,87.5,25,0,09150,1
f36c97bccfc1ed7392c1d8cd28f44c66,23,23,1,161,23,0,05040,1
84210149f1619fd1adc91961208afd9d,50,43,2,175,50,0,05040,1
e2389b0ec863567431b84f1acd0c552d,150,75,4,262.5,150,0,08100,3
c63d949b997db21f806c491423100280,96,81,3,224,96,0,11080,3
bfdacbb360efdfca8c1c0901035c70e1,32,32,1,224,32,0,09150,1
66d3fa6ae0dab92f1e747af5626ea8fd,17,17,1,119,17,0,03050,1
b94a1857411d9084f7f8292d19278b12,93,72,1,651,93,0,10200,3
4cca0c6b7d52e577619d7fc1045a4a21,175,119,3,408.33333333333337,127,48,05040,4
d32a749a35c0992037f7630def8a0e5a,33,33,1,231,33,0,01027,1
abbb24a5253f55e4e87c97c324819b4e,1,1,1,7,1,0,08312,1
54dc7843515a05b63bd153de0f4db242,167,67,3,389.6666666666667,167,0,05040,3
1cc3c5210819a8abb3627e2a21d3a5b5,108,57,3,252,108,0,04060,3
b57d1ef8628251e6260f685a01497cae,153,112,5,214.2,140,13,06120,3
1a945cd11804b95e17afcce6b7894bc2,29,29,1,203,0,29,01027,1
2f975a64ea9b0da4147cf48068d8d755,85,68,3,198.33333333333334,67,18,05040,3
95a8a0d3ac86de3e449f26474deb3b32,234,132,2,819,234,0,08052,4
4a8ed1f89fe696af4db1d98c13efbd90,27,27,1,189,27,0,01026,1
3d58566857fc93c4ac170ae63524c663,111,81,2,388.5,58,53,01026,3
7eca6a86b03ed2a9078a6715a596c518,25,15,1,175,25,0,10220,1
4f18d0ce44a00bba87933a11866b5e50,344,108,5,481.59999999999997,280,64,05040,4
2a4dd92da6bd6975abcd501a690dc423,24,2,4,42,14,10,11100,1
27ee59759f208bb3bf769888c575327f,96,73,4,168,74,22,04200,3
416d01152b8b7951bd0cebd81ab24f6d,10,10,1,70,10,0,10420,1
5fc548d44304d4cf4f51a2f5ac429fe8,60,58,1,420,0,60,10200,2
2b484ac1cd245b1646ac610d1c431ed1,60,51,2,210,60,0,01026,2
37767d84a9fd1b996585d3eb7136beaa,46,41,2,161,46,0,10140,1
92ca6ca0e9da779fd20f79d14bd45047,143,67,3,333.6666666666667,143,0,01026,3
d0ff6528abfb5567f207dd39aa76fef6,72,51,3,168,72,0,04020,2
0c3049b73ef9c493339ffdc020a314fa,10,10,1,70,10,0,12591,1
0e810db2b80e868ea702d171ed96e0f5,20,17,1,140,20,0,05030,1
018e9ea4070e4df6b1e3e4137f8f42f0,13,11,2,45.5,13,0,10080,1
4ff9c4fe2db4bd2ffaf488f131d89d53,38,38,1,266,38,0,05040,1
7792a06cdbe33cdb471c5887da8bba55,32,23,2,112,32,0,02620,1
dc40080cdd0eac577af8a5ffe7be6b54,18,18,1,126,18,0,08230,1
df27989209061061b23760e53021e0f9,16,16,2,56,16,0,08230,1
8d0ebe59b5ccef1b238448ef9a9532d3,38,38,1,266,0,38,05100,1
0f4a66b0fb99cbf4a1bf8d3af3fe5cd5,210,144,2,735,3,207,01012,4
63c02f0557e785c613fb220594600045,2,2,1,14,2,0,12430,1
2d3ef927939b5377e021b8d5f4be373a,34,34,1,238,34,0,05030,1
0c5ee93afa29891552740b161c1b4363,19,19,1,133,19,0,05040,1
a6488f108aca00e94ca9cc3c96674d0c,117,73,5,163.79999999999998,117,0,05040,3
3989e1b64c6d4074252329502a1fecc7,28,28,1,196,28,0,03070,1
a6ed52dc158285634e795a902738c01a,111,83,3,259,111,0,05030,3
83250d7958aad6370bec34da4f22f87b,48,42,2,168,25,23,12500,1
9127194aabf5f5c254ec6d81328b1721,90,67,3,210,62,28,01013,3
8d624cbe1455e3ad43ffcb8d28907f3c,26,23,2,91,26,0,03050,1
5ad9f6c1399ecf6d18f219659c9fae67,188,81,3,438.6666666666667,188,0,11080,3
d1beb8df5e4e2cf85b651afe7e2fd959,2,2,1,14,2,0,09050,1
0bcdee3976ead6a2fae04dafe08dcb03,30,30,1,210,0,30,01013,1
e819835ff102212fc1debd993d72cb51,111,58,3,259,47,64,01012,3
2212952dae3297da36a733f3ec8e941f,34,25,2,119,14,20,01012,1
90bb15f2badda57b635b7a214b14be0e,18,18,1,126,18,0,09010,1
23f38e07a2e9ae7c9ce365282d923593,51,51,1,357,51,0,11140,1
ec624ae2a4d6bd90972d920043f51682,169,112,3,394.33333333333337,169,0,05040,3
a83198023dcb29fe6953daf94b339a45,49,38,2,171.5,49,0,05040,1
3c6e5675a788da5c36fb251e0c80e25a,7,7,1,49,7,0,01012,1
a27996583c93f9896112112a5615f54d,185,121,3,431.6666666666667,130,55,01026,4
f0566d3f38a6e4e35949d383c15a131c,105,89,1,735,105,0,10028,3
36e568bbc55d0f224aa071f3d8943ed5,108,75,2,378,108,0,05040,3
600d37893f18dca60562267f7ab4dcc9,29,29,1,203,0,29,09130,1
fa46f5239072abcf2060fccbc7d48f48,47,47,1,329,0,47,01026,1
278ed5b1e422c7c3d405f8eb6c864993,31,31,1,217,31,0,09351,1
80760660f79059be35fe8d2572534533,35,35,1,245,35,0,01027,1
169810a1195d181749c03b765600f425,70,61,2,245,70,0,01014,2
21685c548589da89cf5ff50921f2375e,111,78,3,259,111,0,05030,3
3e8f43ffe70a8546e1234ed9dd23f48e,23,19,2,80.5,23,0,08132,1
ae3360c6f26cbfcbff5fea7e62311ec2,80,45,3,186.66666666666669,56,24,05100,2
90a5ff3d871932a03e5225ad898bcfa2,18,18,1,126,18,0,01085,1
7f945b9fb8ff0181c4516dc7694311c2,318,136,2,1113,318,0,05040,4
efb4cf68dad1da32ef5ca9405aee6715,73,58,2,255.5,37,36,05040,2
33bcf14008f89319312cbfb557d29bcd,46,41,2,161,46,0,06120,1
2006f4a60734620fd2a31e625b693e93,39,39,1,273,39,0,10200,1
ea75ded3c8051c985bc7be4537cc0167,99,58,2,346.5,99,0,05040,3
99133ab9490be9590f9a363b67ff929b,37,37,1,259,37,0,12500,1
b958dee6fb9a99d2f3d91ed557a300d6,95,64,3,221.66666666666669,61,34,08100,3
84b468ed6adb70ca096a61f82a9ed7af,112,43,4,196,112,0,10240,3
696b9e2fa245c2c5ec60ed36ccedf484,204,101,4,357,157,47,01027,4
04ed643a1544100f98fe956051948cc7,211,103,4,369.25,139,72,05040,4
160bb0619b28d2af8f232e6f59f44dec,65,47,3,151.66666666666669,65,0,13953,2
47ac23d37fa56203c0a8e88d80d92c3e,31,31,1,217,31,0,05100,1
37062804a0b303f4b9805ac5e4fd2817,31,31,1,217,31,0,01012,1
889d44dcf40be29efd085865902dbc81,56,44,1,392,56,0,10200,1
506bccb34965595dcc192d3a94b8f831,16,16,1,112,16,0,08052,1
73ca73779ae7b65ce53ea59bcaf02196,3,3,1,21,3,0,05030,1
8353e36934a12e989ac884431295f8b7,123,65,3,287,103,20,01013,3
22141469f9e4f71697150c4e5e80e51c,62,62,1,434,62,0,13877,2
f3106b51e0df995e664b4e394f1707b4,92,76,2,322,59,33,01012,3
f94811772a45f34764ed3e7dc9e1d0d5,8,8,1,56,8,0,05040,1
7b5b1c1a80339f93bf576dff53e6cac3,87,51,3,203,87,0,05040,2
e5f444a2bed82ff0b9253372374e5c11,86,64,2,301,36,50,01012,3
f054948962fd50952930fe020ee0639a,22,22,1,154,22,0,09130,1
5248bd3d9a1c35f73c446dc8cfea0491,49,40,2,171.5,49,0,05040,1
a0280febb5090e280dec6b6d2e625b33,18,18,1,126,18,0,08230,1
439485cb74970140a6afb8338bf46bfc,28,28,1,196,28,0,01027,1
112ad545ba06aa73e4819188bd206cf8,183,98,5,256.2,156,27,03050,4
9057e3cda6a708d3dc93b8cfb17ed05d,77,60,2,269.5,33,44,01026,2
427a9ed43754d8cf25f5b0cedbb30694,22,22,1,154,22,0,05100,1
a959bdd43c52a00643b7e75bf36daef4,24,24,1,168,24,0,05030,1
4f75b73927342002493d32ea46f0b356,8,6,3,18.666666666666668,8,0,05030,1
5dda5095abf2c58245964fe0708135d5,346,101,2,1211,346,0,05030,4
ed7dbc1df889f606b0c9c35d2c9027f3,31,31,1,217,31,0,09050,1
db6f3e479fff64dab42636434271851c,28,28,1,196,28,0,08010,1
bd5fa9073fbc7e6e905ebf3c61b2a2c0,98,98,1,686,98,0,01026,3
1c63b6d36164a4b76b38d18249120a7d,383,196,3,893.6666666666667,208,175,01012,4
5fef29516b38efd5322f222bb1b59d15,27,27,1,189,27,0,04060,1
4eb81aca8c39418906a4141c25b4956f,54,44,2,189,54,0,05100,1
aac9006f07728d4305ea54bf77cd25c8,146,67,3,340.6666666666667,82,64,02691,3
88c17ae35e68c8cd4996356c35a1cfab,69,49,2,241.5,69,0,10200,2
2dc1197bec658dac795e8b5b6aca8bbc,62,48,2,217,27,35,05030,2
81c4d34a53e876e6cdb266c90cca289d,245,118,2,857.5,0,245,01026,4
3f1311a4425f718a196159e6833d7d46,52,52,1,364,52,0,05040,1
1a545fc7c865cd571377915794e6ca47,42,42,1,294,42,0,05040,1
c3d20e24980430d3f480c4fd4c69061b,84,68,3,196,84,0,09150,3
c39001b319c808fcd1596b2e76d46611,65,54,2,227.5,65,0,05040,2
93b2acbb433b28802ea3be8027fe5ecb,112,76,3,261.33333333333337,112,0,01012,3
072ee60496fccdd3065c0c71861d9d62,65,44,1,455,0,65,09130,2
b28d175a3c8f9d9161371a14965b2de2,126,72,3,294,126,0,05100,3
b21286c7d8708cd992157f733f07462c,19,19,1,133,19,0,05041,1
630c8097d6eef6dd96f78b7d7b536eda,81,70,1,567,81,0,05030,3
e9e4da9dbb596a85f9eacedef70d5771,79,62,1,553,79,0,10200,2
25ad58e0835ae8e9230c27f8d6b2deb3,1,1,1,7,1,0,10080,1
ae42a765c848b95fa8baf77d6a875488,32,32,1,224,32,0,01012,1
1d7de325150d6adf351ac3d303e223ac,8,8,1,56,8,0,12570,1
c3b9cfa359b1f0ff8e3229333b9826dc,40,40,1,280,40,0,05040,1
58084918b86341e6895ec28fb4fc7102,90,73,2,315,66,24,05040,3
7179f746a4e0c40a94a7241d3f9818ff,322,132,4,563.5,322,0,05100,4
34cd5d91de2165c11ec18e2e80c6f87f,38,38,1,266,38,0,03050,1
9933c5b42713a5ff2ef82dbaf7fca302,145,92,3,338.33333333333337,91,54,10200,3
3bda970ddeca028cbfda1db31b944639,77,63,1,539,0,77,05040,3
0cc363ac466e8eec1c5271e478a04658,105,38,5,147,88,17,08230,3
816e46a0ea9017e238c580099b45ca0e,106,85,3,247.33333333333334,60,46,01012,3
dceebcfa572382c6eec7aa83320a8c54,42,42,1,294,42,0,03050,1
3a6b3aa536840306060427cbc359fd07,92,74,2,322,92,0,10200,3
9f09aafc65d4044ebe8ab2021cee0eb7,9,9,1,63,9,0,04032,1
5505b5726dc522459bd94e502b6d461a,36,36,1,252,0,36,02751,1
e24550249c4dec95aeb23735c7079a9d,51,29,3,119,51,0,11140,1
7f55c0a26457532b1f94f9b812faa773,55,48,4,96.25,27,28,05030,2
cb8e9545fcc70b6e23bcd30af462f879,20,20,1,140,20,0,08051,1
4c9c572100f44b1bb0eb288d00979ce3,18,18,1,126,18,0,08010,1
1cc42dd198f490a1bbe667f1a4f9b212,262,120,5,366.8,232,30,05040,4
4c622aa8611e6714d201f2ed27dbc421,53,46,2,185.5,23,30,05041,1
6cf38f7586462400b5ef646aeeb82f4c,116,58,5,162.4,81,35,08010,3
2818b7df94230a4a2e7de340f94fe6ca,34,34,1,238,34,0,05040,1
5679d16c7e8a6ff8b6bca9db5d5f6247,172,121,3,401.33333333333337,140,32,05040,3
7259893b0035c228c0147238a2950368,10,10,1,70,10,0,11080,1
85b9f504b376fcb6851a2051672b75d0,26,26,1,182,26,0,09130,1
a4ea59759c86430ad51519b3535bedff,397,154,4,694.75,335,62,01026,4
a7019a44d27408a400740200678eb566,55,52,2,192.5,55,0,11100,1
c5d1650bb6b8ca820b3751226a80fe0b,116,63,3,270.6666666666667,116,0,11100,3
74d4be400679e5671de774e9384f9792,265,140,4,463.75,265,0,01085,4
7157a6fdeb5ea85a8a731f4402e09804,8,8,1,56,8,0,05040,1
fea8b40988a335c7ea1a73a3ab3f3395,133,100,3,310.33333333333337,133,0,01013,3
3cbcb4011e290888a3a297559fd9b03d,190,111,3,443.33333333333337,155,35,05040,4
93a4b1c45d75ac5ff6e332f97b5c6e71,30,30,1,210,30,0,04060,1
ae758f6e2aed87d7942c993d57f09450,37,37,1,259,0,37,09090,1
12ce0f73c500e19b7d9baf2ab06fa21d,52,45,3,121.33333333333334,52,0,05030,2
521eb87b75b31b0320e4eeb68a01e069,98,72,2,343,50,48,05040,3
f2114ff738a9d9bc12ab48b9bb3bd09d,24,24,1,168,24,0,05041,1
005694564a88fef5836dc13f46057dfb,126,96,2,441,126,0,08052,3
9efe0c002413e44ab9ea1f27c69a85c5,64,64,1,448,64,0,01027,2
0857f78594bd1b2412112d60b24b290f,65,58,1,455,65,0,01013,2
1c566edaa5d6955b801267082988c496,15,15,1,105,0,15,05030,1
7123b41de1b08d9c9ce8de3c1aee3782,119,89,3,277.6666666666667,119,0,05040,3
e531add7b30d032b275b1e4f954c612d,54,47,2,189,54,0,02651,1
fe971ec1d829e114690337b02e0851a0,73,53,2,255.5,73,0,05030,2
dfbfaedf18d4e6d40580de15d3011f6b,28,28,1,196,28,0,01026,1
80e3100a5184a6e068837b13dff27b71,93,88,2,325.5,93,0,03070,3
2ed773c706d509cd72d581fab3604024,67,48,3,156.33333333333334,67,0,01085,2
9bbf292a104f9d3c6f3054cab79e82e2,117,84,2,409.5,1,116,08100,3
e3ffbde240adb97f8ccac3c1f37b59c0,121,74,4,211.75,73,48,01013,3
838d2ecac1fa3e0c192d7488397efe9a,105,76,1,735,105,0,05100,3
6d3e4360abdc4a8acdcdb9b129ac7a38,154,76,2,539,99,55,01012,3
3643eccfd614f8fbb19a43321c82df75,17,17,1,119,17,0,01012,1
be0c45689b452b75015d919dfa229ef1,45,41,1,315,45,0,01027,1
bbcd8092a9f27a1454d580150afe9a56,10,10,1,70,10,0,04060,1
18e3f4001591ecf58db23ef1f9bf5e63,225,130,4,393.75,185,40,05040,4
79828f4aa0a8501e58c8deb9a53b9267,40,40,1,280,40,0,01085,1
587079ef4bdc94611a8499c9c56efc9e,6,6,1,42,6,0,11080,1
04c41879375a3d4aba8a6a57a06b1520,82,63,2,287,37,45,12500,2
5176a780b2742ee46ae1f36ae2b74b7b,56,48,2,196,56,0,05041,1
afa6301890bd8b5107213a322ad15db3,38,35,2,133,38,0,08052,1
b071517989c07823d998a640c44a7247,38,38,1,266,38,0,05030,1
727ea0cd4eb823aec417d9de09021346,97,50,2,339.5,30,67,05040,3
85c5f6b5d131557c3a07ff8eda68b546,16,16,1,112,16,0,01027,1
de78ef994a5be1767359ed93e53fb550,29,29,1,203,29,0,03050,1
97d3097094c87e45303027519eacadfc,267,92,2,934.5,267,0,06100,4
74ab9c395121ebc2e7631bcdfaed8f3b,48,48,2,168,2,46,07143,1
850ff1eadb1eb4299503eade358a2abe,221,121,2,773.5,221,0,03070,4
e9644edbb0bd90d69699f9563a056b7b,92,64,2,322,51,41,01027,3
4f15718700c208c6fb1c113c5b8116f7,19,9,2,66.5,19,0,11100,1
e4643587d0a1d74eeb0ccedb393fbc59,94,70,2,329,94,0,12500,3
b54213972c27addd17994509660501fc,94,94,1,658,0,94,04080,3
0b2f24f7fcd6ce41cc86c197556c41b6,169,82,3,394.33333333333337,132,37,04020,3
1ed92177f564f33c1348e49dfde0513b,24,18,2,84,24,0,05030,1
17293d81a7d9d2f2708777ce41594ba0,10,10,1,70,10,0,01027,1
173bc35c4b887633babce8d8419366c1,139,52,3,324.33333333333337,67,72,09150,3
0b7fcba9b6ee4e1e28c3d86ba8b32f43,97,76,3,226.33333333333334,97,0,01013,3
30d4a831759d042e4494f365cd4a0cd9,31,31,1,217,0,31,01027,1
b4d8d0b489e8c7beba0dfceeeb4d23f3,23,23,1,161,23,0,11140,1
7e2b13fbcd7b288f116eddd19c27529b,50,50,1,350,50,0,11100,1
90dedc1df91645dc2cfc954a746ba1f7,361,152,3,842.3333333333334,207,154,05041,4
384dceae268e4e0347794f03fa592ede,120,91,3,280,120,0,05040,3
534b18c4cf537999a04c9fecb9538a4d,78,71,3,182,66,12,05040,3
7d8e953e869b7a9e261e29e7311a4fa2,338,157,6,394.33333333333337,261,77,10028,4
37cbdf9a80f6c4e0f0d0e0babf0a851f,276,159,5,386.4,276,0,01027,4
66c89936b689f7c991f863a184a54e12,45,45,1,315,0,45,01026,1
3f3201d3eb6e13da7b633e9eded1a70e,19,19,1,133,0,19,12670,1
5a7f991bfef922e80066c3676c3bc82a,15,10,2,52.5,6,9,05030,1
a045f176189033d0b75371c6c9d4ffd0,30,26,2,105,4,26,08032,1
9b49b0b67a8bb8bf97fb9d52d6da5af4,103,59,5,144.2,78,25,02690,3
d1b4733544f35a8f73062141c02dbe66,24,20,3,56,24,0,11040,1
579adf7960d860117c7857fbaa9e4f4a,145,95,2,507.5,145,0,01026,3
326ab579551906e111f317def78373f2,55,46,2,192.5,55,0,01085,1
7bcd1aced749fd1b97223c6f21e279ea,148,107,4,259,127,21,01016,3
6d2dd0081685f30526bbc11a0df97c29,53,40,2,185.5,53,0,05040,1
303909d90916025a426c2958065e6e49,54,32,2,189,54,0,01012,1
36722bc9852aedac247e2e1b6cc8d13c,231,78,4,404.25,142,89,04020,4
34fb725a6a8461fb249d3bdc3a868050,287,83,5,401.8,287,0,05040,4
232d6bbb758e24d389b5fdb535589b6e,278,143,3,648.6666666666667,235,43,05040,4
1be634afbcf783eb947cb66700414056,315,85,3,735,315,0,10220,4
eaeac181616f83fa1f1d4414503ce2d7,43,43,1,301,0,43,01026,1
00143712a013f73eef3a8ec1e52b9ef5,26,24,3,60.66666666666667,8,18,05100,1
a64d65df2ab18b0804cfdd6063d126be,255,140,3,595,186,69,05040,4
759321ba7b593297a52abe78c408a46e,92,42,3,214.66666666666669,92,0,05040,2
43ab3b7157b81412c5c9872b70dd988d,1,1,1,7,1,0,10200,1
f9de915335ac23daef1dff6892579b87,26,26,1,182,26,0,11080,1
ceeefe19860ca3e7a1ec0dbb745931e3,9,9,1,63,9,0,09010,1
db371478bee93a6b84febf2813ec77b6,451,140,6,526.1666666666667,233,218,01026,4
08cada06275a4be90481ce4b9d4bd8d3,46,46,1,322,46,0,01012,1
380ec01e3ff77d4be0d657f02912dfff,138,95,2,483,138,0,11100,3
3ccd598725aa30c050e7ef17c406a6ed,89,69,3,207.66666666666669,89,0,05030,3
59e414c7282223b95a127789af139839,22,22,1,154,22,0,01012,1
22c9d146ff20af06acc0f69d50516057,18,18,1,126,18,0,08100,1
d6f20fa801715b4099efbd8f4556dbbc,201,110,3,469,130,71,05040,4
c6839392376247ec96217070c510eff0,17,17,1,119,17,0,11100,1
693d74877ae900b8d2b2ea07322d45e3,263,116,5,368.2,238,25,05040,4
db065eb1026b96a03f7c78ccc170eaf6,33,26,2,115.5,33,0,09010,1
df6b267455b25e2a2cd8b5f06e43dcdf,22,22,1,154,22,0,11040,1
acd22fb20056a76a68baa9b04aa46b1c,47,47,1,329,47,0,05040,1
cce2b5193a7f2d3acdeaf8dae4f288cd,13,13,2,45.5,9,4,07141,1
6697f6294dfd0ca947b9dbb361210daa,43,43,1,301,43,0,09130,1
32faaf025d2655db924d1da84e100833,28,28,2,98,28,0,02756,1
dd9774592fd1071b21bca91164b1cccb,190,115,3,443.33333333333337,190,0,01026,4
ddc4feb9eaf2fed54ebdff9c20283246,12,12,1,84,12,0,05100,1
fe3bdd7132fbd22034f915b98df5951a,63,60,2,220.5,23,40,11040,2
f0065d19f12ab47e5a09aa9870f87431,133,102,2,465.5,133,0,05040,3
11d00522b004e6b3d0a12824099855ab,69,69,1,483,69,0,03090,2
f30cd55340f45cca5e0662dfa5d99921,44,32,2,154,44,0,08100,1
05cca674305bb95fe64f4ae77a8239da,34,34,1,238,34,0,03033,1
b2b03d10ebbc29f45ebe087132b571e9,2,1,1,14,2,0,09010,1
82380cf0991c9d4d115c42d0647979cf,14,14,1,98,0,14,01026,1
e60449e5b6fd468e4538af034a92e6d1,81,60,2,283.5,81,0,05100,2
b0e1a7ebe7657fac73631c8f2c5ba0cd,19,19,1,133,0,19,08391,1
27d0f980e7be57398129eb861ee9612e,233,136,3,543.6666666666667,109,124,01026,4
c9fc3e4ac311266b1d1fb5ff78355ef4,12,12,1,84,12,0,01012,1
36eed4143bdb602a69fbde05efff1971,155,80,2,542.5,155,0,01026,3
bc4127174b9be42970d3edaca59a23e4,131,89,3,305.6666666666667,131,0,09130,3
d9533567b74151b50c32bf0f9d5ab6a7,187,75,2,654.5,187,0,10200,3
5a8251fd583b12505bf67ac7789bd99a,181,108,3,422.33333333333337,181,0,01026,3
0733a45d5ad9c52944059d5206400a92,116,99,2,406,116,0,02650,3
c5841a1ddff7bb32f9918b54cb0af1e4,35,26,1,245,0,35,05040,1
98052ef6cf60a0a7705fdc53c0995af5,118,80,2,413,118,0,11140,3
132b368ee30ea016f0f52c733a503343,32,32,1,224,32,0,09010,1
3a610a1aa33563dfb7d8da7911f2b9aa,43,36,3,100.33333333333334,43,0,11100,1
9ff002858d2df4c1e09a33098824ccaa,138,93,2,483,138,0,05040,3
4650d2325b678e8b48b4398708bd91ae,93,66,2,325.5,93,0,05160,3
285b08c937f0eec583a247433f3557a2,88,72,2,308,39,49,03070,3
1c94d5bfa64bee4fae383fc7507d7247,65,57,3,151.66666666666669,65,0,10200,2
9182350f8e6af4b81e980883bea27c76,56,40,2,196,56,0,05030,1
1eb22f250b05620007022c9f7c99a1b3,118,70,3,275.33333333333337,118,0,10200,3
d3fa6f06dbc848b033a0032fabbfd17f,25,25,1,175,25,0,01012,1
bc3491ccef6641e583ac23b887f47c7e,130,101,3,303.33333333333337,130,0,05040,3
6040c14ce456cbe25952bd95596821b7,11,11,1,77,11,0,05040,1
796e596662a7dcc92f251d43dffa6cc5,92,70,1,644,92,0,10220,3
9dfd1fdca90138d0b818996a94c92884,9,9,1,63,9,0,11040,1
84d8b0ba727cec887f3462064b732f2f,89,51,3,207.66666666666669,89,0,07141,2
4abe9ee8a90cd1740d40c1ed880f9072,411,115,4,719.25,3,408,01012,4
829f33fbef37a09456cb35b42b50cab8,35,35,1,245,35,0,13830,1
5741ec113d5ea8b2d83fb970c12d5a5f,19,19,1,133,19,0,04060,1
a59bf7b54b747729f2843ba52730916d,79,56,1,553,79,0,03033,2
a6798556e0b6ccae1040f3ca2beb9739,17,17,1,119,17,0,01026,1
8a32618d6105fc98d3d62d4dcefc44c1,32,30,1,224,32,0,11040,1
b13fe6c920dedf75274f4f845c390cd0,125,109,2,437.5,125,0,05040,3
9efbf44f81140c484de48c327d26ae35,57,56,2,199.5,15,42,01027,2
1ec16c4b42e658dc4c1f3cd9b6f5dea9,38,33,1,266,38,0,09170,1
ac3e46d3694b55e08a213e171540ea49,113,85,2,395.5,68,45,01026,3
a6876c7a1bfa556871bce6b628bec827,429,228,3,1001,429,0,05040,4
dd1a44e4ded54e8d98c0b2670199f9a5,17,17,1,119,0,17,10101,1
06bf27f407d50705bbfa6c7d173f8600,82,60,2,287,45,37,02620,2
975a6c9e8095fc7214f686d7f6325b67,175,81,3,408.33333333333337,175,0,04060,3
ba3a245e85c64acbbd5918b6f89442a9,279,152,3,651,188,91,01026,4
2328cbd805c91ef1baa2eb99fd65d024,72,58,2,252,72,0,05040,2
699cdce1b33eb037094d3de2856ecc6f,65,65,1,455,65,0,05040,2
652a75f4a3a7339595a7fe2d024ff493,10,10,1,70,10,0,11040,1
95d065188d182972445f30311cceb1d5,96,67,4,168,75,21,01027,3
e1daccd1c1ab5cd3ffdf0ef6abe9b47d,4,3,2,14,4,0,03090,1
347acee08fdd3ca5b73b30cd2c0d4048,132,93,4,231,132,0,05040,3
6d713a1a372fa93b09ede723dd9de711,131,71,2,458.5,131,0,01085,3
5ba40575868a68a8901eec17c53c7cfd,26,26,1,182,26,0,01012,1
9f4ed19da30f6b99d229955d22eb1531,18,18,1,126,0,18,09130,1
e55d7ad322266767e5f49849b2af782a,35,35,1,245,0,35,01012,1
74774560124781e1b1cb2ba739f9645d,140,78,3,326.6666666666667,140,0,09030,3
d2d8018ac42bec7edf54e5b72fb45e81,39,34,1,273,39,0,10080,1
0d0e34ecad789c94c500d78d13fa058b,33,33,1,231,33,0,05100,1
4e203b79ec8e12a79c436645eef2b79e,75,58,1,525,75,0,03050,2
ef9129a4f55c2979ff96148adc3f9a50,13,13,1,91,0,13,08150,1
9df0bdad314b7882242d3af85d61dc3a,36,36,1,252,36,0,09130,1
1fa11d19d5989ccbf41120f9b02ac20c,55,42,2,192.5,55,0,05041,1
6aeaaa87e860efae391d1721cc13282c,45,45,1,315,45,0,03070,1
9dcc2433139ecf43737668060d37767c,132,63,4,231,91,41,01026,3
2fea70a99a58d0d25817b1693ee84bde,36,36,1,252,36,0,05040,1
98d800f3c56991314db927cd7ffccc27,32,32,1,224,32,0,03070,1
144d83f5506414709941740bf170c2ac,70,41,3,163.33333333333334,33,37,05030,2
0a798062d7d7d57d6ea983782a3d61fa,92,56,4,161,92,0,09010,3
a92ab0cfcf0dd79f3e902c29b472937b,5,5,1,35,5,0,12570,1
3805ee40ca3c70b28be76d89dfd33f2e,71,71,1,497,71,0,01026,2
bbf7690fdc2381787ff98527dfbae805,7,4,2,24.5,7,0,05030,1
e11ee3a59c038ac6f33f7b262e24ad08,98,49,4,171.5,71,27,05040,3
69ddd17335bbb3531b9898185b17f68c,121,82,2,423.5,121,0,03070,3
df0b756a3b2e136bf3c73fa441b97826,14,14,1,98,14,0,05040,1
56f8d73fa0791bbbf3d7c9f5158f07ec,374,131,5,523.6,336,38,05040,4
4cbc788bbaf55825a8198692180d0f15,18,18,1,126,18,0,05030,1
23d9383431fb8ef2d89504967aa65c38,137,89,2,479.5,137,0,05040,3
c2b06f31e89b078be6c113cabf32e87e,18,18,1,126,0,18,03090,1
b57bc9d03c25865348dfaa7b6fad7bea,21,21,1,147,21,0,01012,1
52430c7284d9afab8670818a25ce6223,37,37,1,259,37,0,05040,1
f4dfaae94348ace612728d9714c0d1e7,22,22,1,154,22,0,05040,1
af2e923d4626156caea0cc73d7c20b3e,24,24,1,168,24,0,05030,1
cbef0dad72cafac5d0f0e54c51eba035,42,42,1,294,42,0,03070,1
79e7d85d858327e0e3f94b99c192b50b,314,132,5,439.59999999999997,229,85,04080,4
e1b9065f4bb3c48e8d07af684e4eb49d,7,7,1,49,7,0,12410,1
290ce756a096a48c6449411fd9c23161,32,32,1,224,32,0,05030,1
f3b5bbfbbb8dc940a671da326ae8925d,101,67,3,235.66666666666669,101,0,01026,3
45dced955e37af20236f46d253edf54a,154,77,3,359.33333333333337,154,0,10200,3
f687c4534327af3c035d194281fc423c,40,33,2,140,40,0,01012,1
2b2e6faf80b21d7f8703f674ef385902,236,98,3,550.6666666666667,236,0,09150,4
6318169b8882a31fc1b60318fecca9ba,32,32,1,224,32,0,01013,1
7034a06f0ad4cd345bc9455d822a61ad,281,126,6,327.83333333333337,263,18,01026,4
74513aff50c045d9fdbd9f5a85e7f518,7,7,1,49,7,0,08452,1
a24d62cde77899746237d904f4fa3678,32,32,1,224,32,0,11080,1
3b158067f62832fe78ae6aeac264b493,41,41,1,287,0,41,08391,1
9aeef0cddab765441200cca3d4a29134,69,69,1,483,69,0,05100,2
4cbe542282e962ebc7e82d4b8c4332d8,95,58,1,665,95,0,08452,3
5405e1d1c832b0294c3d11530f4798d0,139,84,2,486.5,139,0,10200,3
b1d329ca94e0da9b262260a36050f55d,77,57,2,269.5,77,0,05040,2
438602ab759ee26482080f66b5212e66,19,19,1,133,19,0,05030,1
777caaa505ea64f629519cad8bc88900,106,81,2,371,106,0,01026,3
ce5668fa9183a4e068da1696a2ffc6cc,66,50,4,115.5,48,18,05040,2
4c5ea71a3860db7abf44c2159bc8908c,19,19,1,133,19,0,02751,1
bec54c87165df0bc867a9303c119c99b,18,18,1,126,18,0,05040,1
8ff67ccb4636b37d066df11ea2c261bc,173,82,3,403.6666666666667,83,90,10200,3
a82d185ad14f37c2047ef5fd3fc323af,19,19,1,133,19,0,13830,1
5f8e469ac2c7a18645f8f6ed63f3c3b9,18,18,1,126,0,18,05030,1
41682ba2f47eb59b6162794fce8ea266,46,46,1,322,46,0,05030,1
62e4fbe37c4770918e4a917881c65c19,187,126,4,327.25,83,104,01026,4
5f7563a3595d2c6a14c56c0d7ba98d7f,176,119,3,410.6666666666667,176,0,10200,3
f2196bad32863dc680914db3c578151d,100,61,4,175,100,0,05100,3
3b7206372ed842622c469ef8db87b413,215,107,5,301,215,0,10200,4
5535e8995348d4330e9007d90b818c3c,208,103,4,364,208,0,12670,4
44250c0a1f6adec65a98885be39d1a7d,37,37,1,259,37,0,09150,1
5d1596bc255b68c92044f687dc08dd96,64,64,1,448,64,0,01026,2
b32e8d08e83219273e625294451e8754,411,204,3,959,411,0,05040,4
ff6611d37d557859f81f3d1f2b41be3a,14,14,1,98,0,14,13930,1
4c22118421d4f7076395aff1ecbdc068,38,36,2,133,38,0,11100,1
da9cb2e07d68f4b5798ea45ba8936cbf,28,28,1,196,28,0,05040,1
402663029a5bfe0878f1b55cbf5b8811,130,73,2,455,130,0,10240,3
c5d58e0ab1ca1813218a05d32df10b09,101,68,2,353.5,22,79,01201,3
cd815a12e3deeb9eb6f448742aee7740,56,41,1,392,56,0,12570,1
f3d01eb941094e9316bb65b4588002d1,66,50,3,154,66,0,02690,2
3a87723c9c844d94a824ea9d9db167aa,61,53,1,427,61,0,01026,2
bf498bd2a8bfbb5458da5b0e47d293d7,49,43,3,114.33333333333334,49,0,02751,1
33446715d6155ecda6392b76dbbb5c94,147,74,3,343,147,0,01026,3
956111c09745ede97b3a0c7ec3027309,141,81,5,197.4,125,16,01027,3
f11ca6d2ffc78989a81faf2d7ddc7a9d,125,92,3,291.6666666666667,74,51,09170,3
7900921a3886978555372106f586fabc,98,58,2,343,98,0,10200,3
7fb0dac94a508a3466b944fad5b054ff,579,157,2,2026.5,534,45,01027,4
696befb9bb22e41e7e0cad36a422f202,76,55,4,133,57,19,05040,3
402a9d7c01d18811b042a86ae6ab2c84,266,190,3,620.6666666666667,266,0,01026,4
11ec9fa92e1ed11bd8ed8ef9f38adb53,18,18,1,126,18,0,01013,1
d6cbc000f8ee1131f1ee3a6ad784e8a6,79,60,3,184.33333333333334,64,15,01016,2
a22a6b29fcdd15f1fa80dd532b88202c,164,111,3,382.6666666666667,164,0,04201,3
ea34d0b7208ad77b96993ef518912577,403,133,3,940.3333333333334,403,0,05040,4
ff125041f4ef2aec160103506c24da13,26,26,1,182,0,26,05040,1
7e51d31312ee52114f196ea57d4953f9,3,3,1,21,3,0,05030,1
58b075d85e7e4cad1d48272285a22fd0,209,114,4,365.75,168,41,05040,4
be0f9446dd2eeb0d9e5c6f5e2c98342c,175,116,2,612.5,175,0,08452,3
c266b1a19e846e31876e4b649dda3ad7,8,8,1,56,8,0,05030,1
828b1274d109ac2e710f9edbc3bd1912,43,43,1,301,43,0,04032,1
65384c0dd85c40262c5bde8f4c9b4b2c,21,21,1,147,0,21,02750,1
d5061d658656bb4ccaab6b43fc4ea617,99,90,2,346.5,99,0,05040,3
0f63d967485a8d363e0b39e4ae7252a0,26,26,1,182,26,0,08052,1
d2606299dfc00c887b3f069d6c54654d,167,69,3,389.6666666666667,167,0,09010,3
9b24a8e4cc288eb2c8091be35601249e,50,46,2,175,50,0,02690,1
a4c00053b821d24d0bddf4b8d449925b,83,61,1,581,0,83,08314,3
39cdd8f054abbb30d7ea30285e1411e6,23,17,2,80.5,15,8,11100,1
f4ae4221d5551c319bf8deaf4bc98ca3,74,58,1,518,0,74,01026,2
d49f65a7231fd829fe8ba4e632ea0271,347,156,4,607.25,184,163,01027,4
7324097d2c821fbd5207a32bd5322d71,49,49,1,343,49,0,05040,1
924ec3a313015b4f95b0326815a0adab,11,11,1,77,11,0,04060,1
76cbe7c2b94b3c1e5d9094f9d4cf8122,57,48,2,199.5,57,0,02691,1
3c18328a0dd7393c3a9fab2a597689ef,25,25,1,175,25,0,01012,1
fa2e341fe8c7621ec71eae84bd8a963b,14,12,2,49,14,0,11040,1
86cbd53fa6e9a57920a0d8a48300e3dc,359,183,3,837.6666666666667,292,67,05040,4
e2d7bdaabbffca09fb748021809d1ea7,480,140,4,840,480,0,05040,4
868b45071d6ec1451de54155baba39aa,33,33,1,231,33,0,01012,1
6c94dd9ab61c7ebf7cee48515f67c301,80,73,2,280,80,0,08314,2
8bef87c06e65b2192c3a26d3dcc7720b,199,104,4,348.25,199,0,02751,4
ae998a950e657be8ee5fe3388adc0f0a,50,19,1,350,50,0,01026,1
0054b10cdd4c0b6272caa58ac0906931,12,12,1,84,12,0,11040,1
08e929d92bc159f6cb09f3c18f26e731,175,102,3,408.33333333333337,175,0,05040,3
5e76e26ec8d2deaa314794c2b4e022ef,359,136,4,628.25,320,39,05040,4
1621fcc7c280f4ca49a340b871366cbb,56,46,1,392,56,0,05100,1
83e6b786bb5052824740d4b1f0998fae,372,103,5,520.8,233,139,05040,4
cb3aa82bd95d049ed6b35d18bf86f80d,43,29,1,301,43,0,09130,1
16ce34f0b2805498c8236eafdb370639,41,41,1,287,41,0,04060,1
d2e64e4e2845ddbacb7b9b8ab8453a98,369,100,5,516.6,270,99,05040,4
c35df5b7709006b8ae2016e4933db21a,34,27,1,238,0,34,01012,1
264d8219cd1b0f6d6e80100fee8d0cd2,138,81,6,161,117,21,01012,3
2e10e3e736f8c6f9aeab49865c4287ae,16,16,1,112,16,0,09130,1
089ecc3c2e5bfbbf460747c4ca1e912e,378,119,2,1323,354,24,01012,4
c51cb07df3e0b0e08aa66b0f9d9a9fe1,59,59,1,413,59,0,01026,2
89705f10f24660ddde45d5b3143d5972,16,16,1,112,16,0,12470,1
82e1c019663bb7472c5466d30fbfa13a,14,13,2,49,1,13,11040,1
53aaa4e4c906e13bd57ca48ceb6001e7,101,81,4,176.75,101,0,05100,3
437a7cb00cfa86f73d85dc2985d64c6e,54,35,3,126,54,0,10200,1
a40c0eb4b989bb1fb8833d82e4ef04f5,132,85,3,308,83,49,01012,3
3fad7eeb9a88d72d1d1817a879b88c2a,18,18,1,126,18,0,03033,1
a7ebfa8b6cfb511ed7c94187f3e52696,40,31,2,140,40,0,05100,1
bf49b4b0feea5063ec5933483eeeab6c,58,46,2,203,45,13,04020,1
525ffd6e742c83e337adc5277b83a8f9,10,10,1,70,10,0,04020,1
fea218f736050d94d12adec947de9884,37,32,2,129.5,37,0,05030,1
ceb7103be32823d7fe015a60cfc517b2,14,8,3,32.66666666666667,6,8,11101,1
26bdb41f49cf45e0b8c84cdb2536cc40,40,35,2,140,40,0,05040,1
7a5c789d27a609942b65d4113832a374,31,31,1,217,31,0,01026,1
ff54a7ce7c89b936e993220a3b9b6d86,215,98,1,1505,0,215,01085,4
d218ffe13558737f74d54434d9694697,16,14,2,56,16,0,10028,1
044d461921913fe11fca5d87c8c63875,46,38,2,161,46,0,11100,1
57a331877d9092927ce6184a874cffbd,45,45,1,315,0,45,01026,1
4592604669b712ba47da99b597e245e0,13,13,1,91,13,0,01201,1
60039d2a9aa651e9b572b6c71303ec67,101,89,2,353.5,101,0,11100,3
9fd949d5245988ad9170c9f797351273,702,175,6,819,676,26,05030,4
31ecc82988ed47b0f38501165992b700,25,25,1,175,25,0,05040,1
d5df82ab83a93731dc92ef6ca836f89d,98,80,2,343,98,0,10200,3
26a750849ecef237366d95f745ed6cc7,75,64,1,525,75,0,10200,2
21ed61b4515a1edf71ff7f3567c78e9c,7,7,1,49,7,0,04060,1
2d7ae4fbc310dbe5ea586fbf6a153e78,6,6,1,42,6,0,12710,1
0971ae6df101268c0c30fe5e2deb870c,35,23,2,122.5,8,27,04020,1
989213089adeec67b02b1be5f7c9882a,16,16,1,112,16,0,09010,1
af759fc744fbc505fa313d3490d2ec2f,25,25,1,175,25,0,06100,1
d9ddc5cd2ffcb2783469a71521210e2a,160,109,3,373.33333333333337,113,47,05040,3
9392cf9e14161a1004193613086fcde2,88,88,1,616,0,88,05040,3
ea65892ec3e09180fd59264ee5d94cfe,104,59,3,242.66666666666669,104,0,04060,3
f16c4a6298cc0d7ed1867fcaff40cfc2,67,56,2,234.5,67,0,10200,2
4e05d263aa0fc297ea8b4ca32a90d55e,140,73,4,245,140,0,01012,3
5fdcf76da524bf65ae67678fa9f4b4b0,50,50,1,350,50,0,01026,1
ee0739967eaa5a7bd9d0a34cf1da4357,163,102,3,380.33333333333337,75,88,01026,3
ec0313fa1dd7bcd0abf1196ca2952320,10,10,1,70,10,0,11100,1
cff32ed5f4f6232dd8ec131862d3098e,25,25,1,175,0,25,01026,1
68cc6f1ffec0a67f34491673257000de,88,88,1,616,88,0,01012,3
55d9ea0165f40b2ab51d6be3a6bf0dc9,250,112,4,437.5,250,0,05040,4
f4e88e46249477bea6c60701eb064c84,21,16,1,147,21,0,01012,1
1c36cbfab8cb30abd3f90818ed4649e6,273,114,5,382.2,253,20,05030,4
3e652577027e9937c818f6c9375900f7,41,27,2,143.5,10,31,08090,1
16c5ac307268651dc9976108e5157c06,375,159,6,437.5,343,32,05040,4
05b39c49966790760d026e23d52b4a2f,509,188,5,712.6,368,141,04060,4
8c690ad3865bb6c3e12a609a474b8399,107,58,4,187.25,107,0,04201,3
c5d8926b1b21c0b5cd72cd08f007481c,57,50,2,199.5,57,0,01085,1
dfe980e1518a9fea656a1537fca74494,231,100,2,808.5,231,0,05040,4
091545c117e11d178a4de0e75be07524,110,66,3,256.6666666666667,110,0,05040,3
07b300f9d5d767ffdc0f8a0a6903715f,7,7,1,49,7,0,13490,1
21122a17127e7f2689d4f29e4dd6b597,19,19,1,133,19,0,09090,1
6bed2d436e17a7093cfdf81c3c1872b4,53,47,2,185.5,30,23,09150,1
f4de55b9a3e5a1fab960426e59cfc0d4,194,61,4,339.5,159,35,05040,3
3af7e76ed73d8641fb0d2e9b424030ca,121,77,3,282.33333333333337,76,45,05100,3
768d0f930e83a8b7db499338711bf0f9,77,69,2,269.5,77,0,05030,2
cd5a252c8fff53015523048ab91d7272,52,49,2,182,52,0,05040,1
985518bb85c39f6183e22def47bd1268,101,73,3,235.66666666666669,101,0,05040,3
bc13215345416a9425e44d9d433fb54d,31,31,1,217,0,31,01027,1
240c586d85c7fb2433ce7a59c73a3398,161,96,2,563.5,161,0,05040,3
2903b7144ca8ef5c684edd993deb0bd2,127,95,3,296.33333333333337,77,50,05040,3
84bbb06cc3fa0afc71fcb1de3d1f2772,46,46,1,322,0,46,01026,1
8eccb82d088fc79578214a865cc33168,139,102,2,486.5,139,0,01027,3
35118fbb4928543f593a9c44abeddb45,334,207,2,1169,334,0,05040,4
1f1eacbdb8bb1bec04e5aa807d026dd1,350,153,5,490,182,168,05040,4
3d0f1d9a9eeb14c460f580fe7b276572,44,44,1,308,0,44,01012,1
921fda6fed8ae4999efbc1e26d76f12e,29,29,1,203,0,29,01085,1
f16e12466de9feed371bf42913cea454,37,37,1,259,37,0,01026,1
ca47acc61be9ef2ba9171caefb8a644c,13,13,1,91,13,0,01200,1
16f1b5db9e1521f345d37074bb722abc,38,38,1,266,38,0,10153,1
e2294bda04a4f24d7ae8c3d70ff5bdb4,16,11,1,112,16,0,12710,1
1444f01a087d813793e9a70186332f2b,1,1,1,7,1,0,10240,1
0c490e56741cc938fb6e01f5612a8882,40,40,1,280,40,0,02751,1
24654025fdcd32b89e3d2022e10902e4,25,25,1,175,25,0,05040,1
3b9a924e721ec33a920be530b1645cf6,53,53,1,371,53,0,05040,1
b132835173469242f6b64b49fa89039b,81,57,2,283.5,81,0,01012,2
78d1d7e6fecaf69f885e12e562f437b8,272,139,6,317.33333333333337,187,85,14351,4
e2870d0af10f494debed26bd48eb3b1c,101,65,3,235.66666666666669,101,0,01027,3
b5616fc768d5e1f55099ad61446694c3,307,127,2,1074.5,307,0,04201,4
821ad81bf9697393ba45318a66d69c30,73,49,3,170.33333333333334,73,0,05030,2
e15113950f98cd82b5d2157bc2b8c748,24,24,1,168,24,0,01026,1
d302854236282357cbdb0caa2f382f54,160,116,2,560,160,0,01085,3
135218190d6218ee1e7bd080c48ccbc4,35,35,1,245,35,0,10040,1
2cbb4cde766764ca3515ba507c9ec528,133,107,2,465.5,133,0,08100,3
e5efd031d1c01e50cf62b1d92b55a85f,114,53,5,159.6,114,0,09170,3
de93fadf6bb840ec75d9188bbe324f55,73,53,3,170.33333333333334,73,0,07131,2
c5ac0b88840cefa247e5309b0805babb,11,11,1,77,0,11,12670,1
b7ca356f10c2c66fad712caf737b9f9d,24,13,1,168,24,0,05030,1
4426ea71287cfee208d9517c04275cde,333,159,3,777,333,0,10200,4
87a799a3c9cc07afe41bcb581f482c12,111,88,2,388.5,111,0,05040,3
5e5628716948dc2c7fb8bcbd23040601,336,123,6,392,236,100,01026,4
18d4918e3925ffe6ce547a3f5f3ad883,227,100,4,397.25,155,72,01026,4
c4a8022f49968e9d5dfbf01efb09fec3,67,57,2,234.5,67,0,05040,2
c7029df574628a8cc0313e12e4851238,145,81,2,507.5,54,91,05040,3
d94d470a976caef0a8b5f436e47b9d43,28,28,1,196,28,0,10153,1
7ee12eacbdd2a9682041cc683bb52231,98,81,2,343,98,0,05040,3
05169bf55c2ef1f40ebb36392e2b6026,66,47,3,154,66,0,01026,2
132b9badd92dd41ca80f86167998dc82,10,10,1,70,10,0,01027,1
c309e939378bb6e20820ffc183a324af,53,42,2,185.5,29,24,04020,1
bc2664222a4ec454314f71d6120e9351,315,192,5,441,303,12,11100,4
0aa1a1173ee95f99d6353478638fcacd,357,100,5,499.8,357,0,01012,4
a0c9dd4e82bf53a5bea34001f68c156b,51,46,2,178.5,19,32,01012,1
102fecba2dca7884291443a40132d200,55,50,2,192.5,55,0,05040,1
4fd603c0b9e9d63d924362badc158a7b,25,24,2,87.5,25,0,08032,1
3b96d97411624916579fa265436ea7db,75,75,1,525,75,0,01026,3
43a3ef33d43891f89eeee7bc7f62c117,11,11,1,77,0,11,01085,1
79090a926550f59f9ab2cd07713c4e78,49,43,2,171.5,30,19,09150,1
e810055ac47298434a1c586b14e7273b,180,108,3,420,101,79,05040,4
4cfd848631735a2ab6a19376026fb5d7,47,43,2,164.5,47,0,10200,1
98b51c6687246796a9f62b9815ec91b2,93,69,3,217,93,0,02650,3
4ece50e7ba19c74d79c46d1fe53808ec,52,42,2,182,31,21,05030,1
ab3e17f9912a3061efaa494d2becdb91,36,36,1,252,36,0,05100,1
c6449a02def11dd5ce3510c2b39ee870,128,66,2,448,34,94,13953,3
2e51e5e82613d4d38e827f9bbc6fbe80,2,2,1,14,2,0,11040,1
f532f9b142eec07224af8446c644672b,3,2,2,10.5,3,0,10041,1
3030033c4407ad5b7e5b675e0664c69b,300,114,5,420,284,16,11080,4
4e78ff9d002a142a1db044cd76dabb8f,30,30,1,210,30,0,08150,1
37a7e91aa8cb54d3c53508a1fe8bed50,36,36,1,252,36,0,01012,1
bf6d9a10be39cc26b832584a053e7e29,20,19,2,70,20,0,08100,1
7992460baddf35289b5c40e5ab575224,29,29,1,203,29,0,12590,1
c0ad51b5c177ce078b924a85312563ac,14,14,1,98,14,0,05041,1
ee4a4e585bb531c94101fe0575d5f0d5,10,10,1,70,10,0,11100,1
30fcdf0e8fced1c439107fb861fd558d,119,63,2,416.5,119,0,11080,3
eda8c5867ab34f85dc19c810bd0578bf,65,65,1,455,65,0,01026,2
bdd1c8eef73e640f278a46e60c497897,10,10,1,70,10,0,01013,1
2ec0f04a1230030fc8336ae85880111f,170,146,1,1190,170,0,11100,4
3776de7e0b1f6ec25f2afe105208ad11,59,59,1,413,59,0,05040,2
bf32f78d7d09ae5d13fedeec9e10e6eb,90,74,2,315,90,0,11040,3
0b5cf3ec0ef527a32c77b15ebac3bc6e,50,50,1,350,50,0,05100,1
97d48a61ba4391c9fd5d97f7a7ed7175,51,48,1,357,51,0,03050,1
d6d7dfe869179e5bd93eba51bc8f335e,157,123,3,366.33333333333337,106,51,01026,3
2947c48ad88fc93fcffedaa40618f199,23,23,1,161,0,23,01026,1
8c1536a14df170d9c01102613c629b67,230,115,4,402.5,180,50,05040,4
cd99447d84815ab0b81fbcbf425eb4d8,36,36,1,252,36,0,05040,1
8b176489c3b51dc680ad5cb782b3b531,4,4,1,28,4,0,11040,1
22055785533ee4fc24797d1b5f11b28f,397,96,4,694.75,397,0,11100,4
896dc6c75e3e38028155e6415cfbe581,35,35,1,245,0,35,10240,1
ab91b50781bacef5b3e76e9ca6c78cd1,27,27,1,189,27,0,02651,1
aa783c102b3d69bfd4d89f5fc2ba8ae6,84,73,2,294,84,0,08100,3
f350b919a1367fb7e2785102e98b70da,12,12,1,84,12,0,05040,1
57b51e64ff3161bce8c3997ded37de89,81,81,1,567,81,0,05040,3
6a49c1629094171c0102747a2905cbd9,115,64,4,201.25,115,0,10080,3
8edee4e501d021f97b3be401a20e7772,117,93,2,409.5,117,0,04060,3
f2401a082788097f2f55b255665a7aef,3,3,1,21,3,0,05030,1
7ba9442507daec1aac51fec1d69182af,132,72,3,308,132,0,01027,3
c58982f7759d95c6c55c4d61edc7acd3,81,49,2,283.5,81,0,05040,2
dd2b8993fc405681ac5985afca901e5e,34,34,1,238,34,0,05040,1
2070b7691fce9cbfa7eabdd35f692d9d,1,1,1,7,1,0,11040,1
173ed37b2673f8afaf349ff958439906,27,27,1,189,27,0,01026,1
3c0797b49285168067f77e789922014c,27,26,2,94.5,27,0,11040,1
75b07e3ace6b493133f64a420b5ac7ce,108,93,2,378,108,0,10200,3
4bd60b93080a9530326dbd3aebe296f2,81,52,2,283.5,81,0,09111,2
0160f36758f314794e86184310316231,143,78,5,200.2,121,22,05030,3
8ec5bff1679ec151d5882f6a39fa7301,32,32,1,224,32,0,05040,1
908e985cd0ada574ee7e713b9acf74d8,24,8,4,42,24,0,05030,1
2ad0e533133b99bdb571816db8edef60,115,54,1,805,115,0,05030,3
3087d05ffc8a0a675bfcb5cb13b0b166,11,11,1,77,11,0,10200,1
c90eaa10ad7fb48739d6ff16bf26065e,38,33,1,266,0,38,11160,1
67ddd24bea322248bad5564c32f6b9ba,35,34,1,245,35,0,01027,1
b9a7f04738c6edeb771ec6d2ee64c917,104,59,3,242.66666666666669,104,0,11140,3
e97b234be35a1695ea5eb65fdd8db199,147,78,4,257.25,112,35,01012,3
7053d15d1ce238fbdc0f0089d6e6a3fc,39,36,1,273,39,0,08150,1
2763e5bc33d3255fd4113eb565fb9916,27,25,3,63,27,0,08452,1
ce2c2c1b2a11dcc27c424761ec2740ab,47,39,2,164.5,47,0,05100,1
6f4a2ab183a055a41aa831566a29d6f2,48,35,2,168,48,0,10200,1
a71364be54f5f0a27a8e45174e879138,113,78,2,395.5,113,0,05040,3
4a4350bb91d0b507ea77d76e571c0888,35,35,1,245,35,0,10200,1
c17448c55d368aaf77a94a1d422f0e2c,218,46,5,305.2,210,8,08032,3
8339816452fce777e36aebd4cfe00d5c,37,37,1,259,0,37,01026,1
cd5e472d011ac693c4c88fcd34fd37f8,24,24,1,168,0,24,02610,1
ef272a4388f38f93fc7c4373ceaaadb1,97,75,3,226.33333333333334,97,0,08314,3
77b4759df53ddafbc3784173c844da3f,230,96,5,322,230,0,01012,4
9be9b2e9be04b13054bcbd04d97f4768,61,42,2,213.5,61,0,07131,1
fc93685d510779963f069225aa23da37,75,41,4,131.25,58,17,05040,2
f708d1842ee3c1bf4dc5bcdb361a1d65,19,19,1,133,19,0,08150,1
071570d1839d02583cc274334b299d13,320,117,5,448,320,0,03033,4
db0b237a8e5a5446dc781043e0c75b9d,34,27,3,79.33333333333334,18,16,01026,1
23b84036714497d7fdb40ebe4406916a,145,108,4,253.75,80,65,10200,3
d21f43aca07f5f020d3db997cc40152f,68,53,3,158.66666666666669,30,38,05100,2
b1709a2733b0654cfa347ede789afaaf,141,78,3,329,141,0,01027,3
cb2ebee1431a8d1e38caef053f3036ff,25,25,1,175,25,0,01026,1
ab7a8039c5a2a408c8e9494aa0f2b482,31,31,1,217,0,31,01027,1
9cba40f9f6005c56b78eb0a8a5ebad36,125,93,3,291.6666666666667,125,0,10200,3
cb98ac486b493c8b2c8be13b89971806,91,65,2,318.5,91,0,03070,3
8996b9df09f45bf179ec12d1258b637a,85,72,1,595,0,85,05040,3
50225a5539c09bcbab2f9ff9f0518ea5,116,67,5,162.4,90,26,02690,3
ce500a907b478b8ee6cd1e80469407c0,22,22,1,154,22,0,12410,1
47e4a0f1051d73a22034ee6fbba0fd04,99,82,2,346.5,99,0,05040,3
177f09d766cf733eb1478023f37138a3,179,77,3,417.6666666666667,179,0,11040,3
044c1d5e42841267fe6aa0e6ecea3b84,400,152,4,700,264,136,05040,4
261e2a6fcc8059973fb7135cdb45f020,189,88,3,441,189,0,05100,3
07147fe2b3367553498a6184435a1113,38,38,1,266,38,0,11100,1
7d54bb9380067db95d681a7ce0f1aecc,30,30,1,210,30,0,05100,1
e529521f9b502a1666c4ffbc6c698743,80,62,2,280,80,0,01027,2
cc04592b1d4355a8bae82a30a2447f6c,154,99,3,359.33333333333337,40,114,01026,3
0df99241598568a0f42eb600d04841c2,324,168,5,453.59999999999997,244,80,05030,4
7b3ab08c607c9b91d736e31c826cc625,112,85,4,196,84,28,05030,3
b71b2562df7c993976a05349f6b1a650,109,83,2,381.5,58,51,01026,3
c42d2ece9b3d7a9fc7b0163f9a05fd1e,128,72,5,179.2,128,0,05040,3
179ba4aa3930cb747df30e143fc34885,49,49,1,343,49,0,12500,1
00a79e61250cbb98453a901540c82aa0,23,23,1,161,0,23,01016,1
fa2a42720ebb3f3dfd3c31730e20855a,30,30,1,210,0,30,01027,1
1e4fe03211ccae2986401adc1d77319b,15,15,1,105,15,0,11100,1
809be076500d81b38a1ec929ee3c789b,338,143,5,473.2,137,201,01012,4
ac5ef2f17b49e7b07bcd8235ae671d7d,15,15,1,105,15,0,11040,1
fa4fdca33a71d05f850130de948a1a13,203,116,3,473.6666666666667,203,0,01026,4
b7cd349dc6111177997228ca5495cc0e,25,19,2,87.5,12,13,04020,1
49479acb24e30049c5d1828bc1722e14,16,16,1,112,16,0,10200,1
5609fe3331c970dfdda0e301eae7752b,38,34,2,133,38,0,10040,1
05afd0e436ef48b53d2395a0dc10130c,51,46,3,119,33,18,04060,2
7460fb48f079ab9f9596fb0e57f801e1,37,37,1,259,37,0,04060,1
2e993b0c0e109b2b058ebbd7ebc10548,17,17,1,119,17,0,05120,1
05f222ee6266d9995279b8c82795903b,13,13,1,91,13,0,08052,1
7f5173bb7556e5ebcbd43d124cc8c124,374,124,1,2618,374,0,01012,4
39ee2cb4d2adafa7b2b1c78094b25525,119,75,3,277.6666666666667,76,43,03070,3
c0aa3cd6102cb2f32eb131075132df08,95,39,5,133,72,23,05040,3
c7bf36e1ba57eef87b31a2e4221fe1ac,316,204,5,442.4,316,0,05040,4
a8e56730ca24c7310d219a9d770ba1ca,35,35,1,245,35,0,09030,1
13efff1b3c795c3cac00ed779a0b6c9e,67,58,1,469,67,0,01026,2
34c04ae3ac9580bbed93281437ec6999,101,59,3,235.66666666666669,101,0,01026,3
b60d1479bf3476818401530bc70989e2,23,23,1,161,23,0,05030,1
12fb6a1d6a15e83ea168e661992ff674,19,19,1,133,19,0,10220,1
324579c57681838f914916a06603ec43,14,14,1,98,14,0,05030,1
4d3a68100c418373ccf76223ec35c52d,19,18,2,66.5,19,0,11140,1
7d5f766a1343e4a4274c3c9cc4cd1fe8,24,24,1,168,0,24,01014,1
029ab50e0a6c7e2bad99e666e979e618,456,218,5,638.4,283,173,01027,4
bca2eac5565ad3d0fcc6ca0ce7862c24,9,9,1,63,9,0,01012,1
0ed6da5b3eddfa5290ed85e8a2d558ce,41,39,3,95.66666666666667,31,10,01012,1
86a424eb6a7a435322d44eabbace2fad,4,4,1,28,4,0,01201,1
ff48fd23c4dd19a8ce4608432adc1a39,18,18,1,126,18,0,08390,1
cfde42cf6afe3f9efb32bce7bd49e28e,15,15,1,105,15,0,05040,1
f9c1a490bcef8ad3ebcee37996d87ebb,102,73,2,357,102,0,05040,3
c05ab06d972aea915778ceed26a5a5b1,54,54,1,378,54,0,01026,1
22c89553c1c9312df87f2be0f8b3b5b3,27,27,1,189,27,0,01026,1
421654b7ce995a1984e5561505f8ec80,216,104,5,302.4,168,48,05040,4
b80aab8f57516d930e30ea184d2503e1,83,52,3,193.66666666666669,83,0,05040,2
b18d5cd4403e733d3813032395c57bc8,18,13,3,42,18,0,11100,1
1e089a22d7c3687c0af886c57191874f,72,65,1,504,72,0,05040,2
bc32483aa12bd97d43954fb441261edd,31,31,1,217,31,0,08010,1
2df3f43366be7524c30d120884a2730e,62,43,3,144.66666666666669,46,16,05100,2
4527e6a2be243c7aaa65f84ef98b85f3,132,38,3,308,132,0,04020,3
64aa38233d6718754e9ad33127f1821f,31,31,1,217,31,0,02691,1
67aa4ca0961271a0e9ce5c5e5e95d5e0,280,111,6,326.6666666666667,235,45,11140,4
66ca48fb420a3ad74ed61fc12bce3ae2,197,99,3,459.6666666666667,197,0,10080,4
c8c8db4801b39ad56da5c580663522af,20,20,1,140,20,0,01012,1
ad9ebb783e7d6c4d137ecee246f23f36,21,21,1,147,21,0,01026,1
525682bd0a464810651907ffc37dd9c6,35,35,1,245,0,35,09110,1
c0734ed1f379edc973b1e6939f42b718,383,152,4,670.25,319,64,11100,4
eee860e01d0a9b5ccc9672f9d9da1f4c,30,27,2,105,1,29,04300,1
271e6066d80459ec93b4eb4bebf9c200,15,15,1,105,15,0,05030,1
63e418614945f65f642f689b75d3b0c5,132,76,4,231,132,0,05030,3
a54846a5ed9471d925588db3a468baa1,44,34,2,154,18,26,05030,1
e9d6b6e7c0b5612c045d3f47cbc098f7,61,61,1,427,61,0,05040,2
bc32968c6d62c1cbd3ee4499d8f59419,22,22,1,154,22,0,03050,1
fa6393ed068ba3a7859c949c53308af6,62,53,2,217,62,0,01085,2
cdcd928f03e9e22cc1c44e6191637b79,9,9,1,63,9,0,08150,1
0bdf60d4ecbcc7910abbb95054f6bc78,107,57,3,249.66666666666669,56,51,05100,3
31488267f01bed4b36e4f526a3e2b116,73,55,1,511,0,73,04020,2
bf59b307c9d7a969f923f155f0b4e695,63,56,3,147,30,33,05040,2
f1f64d3cbc703f74c497a7318f8c8c5a,69,53,2,241.5,69,0,05030,2
0ced898a821d90780826a15d14d08c35,50,50,1,350,0,50,12570,1
201901eb7812393c1ccd7e80668667cf,196,95,5,274.4,196,0,04200,4
bdfc8445e66158993fd456a97a72044d,500,189,1,3500,500,0,05040,4
fb63e3d28353a32217b1b63755f98391,132,72,5,184.79999999999998,110,22,01013,3
8e361cebcd8e2add100ad4ae1f6b1293,17,15,2,59.5,17,0,01026,1
37d019a16122927f475f0688a588bb54,40,40,1,280,40,0,01013,1
0fffef71fd0b20cefabecf9dc621c869,64,38,2,224,64,0,05030,1
ccce0c0896785f743129b8bdfc9da902,28,28,1,196,28,0,12501,1
3891b8dae32823230b39c15a14664a53,67,65,1,469,67,0,09010,2
2f0229e8ab0db0452a042646a238cc48,44,44,1,308,44,0,05040,1
05969d792e292657fc6649eeb6f9662f,790,286,6,921.6666666666667,538,252,01085,4
bba7838127b9634f24d859ae832af1fb,5,5,1,35,0,5,11040,1
76a6f423cb01d40a9fb029b6b454d71f,13,13,1,91,13,0,03070,1
5a66990be38ab4d679644e936da8ed91,163,103,2,570.5,163,0,01026,3
84a3310d2e6ab50c646dcd0366d8100b,49,49,1,343,49,0,05100,1
a314a418b3e0740396671c57fab65981,98,80,1,686,98,0,05030,3
87a9fa3a7df33ac59419156dafd69848,135,52,2,472.5,135,0,04032,3
68840aaec476c602122e8596f7832d38,34,34,1,238,34,0,03050,1
a2ae91b808d8a12d97f378ce851c9661,380,150,5,532,328,52,05040,4
d20df16a4df41eaf6e7ee9801ac7c8ca,9,9,1,63,9,0,02751,1
ac646afad24ca2292bedb9c7aeb47c4e,97,74,3,226.33333333333334,97,0,01012,3
07a0125d3e2b9b37dd406e18f259dc4e,11,11,1,77,11,0,02610,1
6fe7aff0b2a9615a24344e2399624f40,144,70,5,201.6,130,14,05200,3
c9a39c8de89770f717253a4b28c04f17,31,27,2,108.5,13,18,06100,1
0439e3dcc72753cd93bdba4e27a63684,64,53,3,149.33333333333334,64,0,02650,2
40765e34f88c87d8670e2aab12191ddf,17,17,1,119,17,0,05040,1
710e1994f576880ba5b1c39cd9f2f27a,34,34,1,238,34,0,05040,1
32242629134c704af3672bdeb0064773,200,138,1,1400,0,200,05040,4
40b8c7e587fda4ca62aea0f3047e22ff,36,36,1,252,36,0,01026,1
a25655cf59410cfebb1bac722946c63d,26,26,1,182,26,0,01013,1
5864fbba52ec26d4e7f6cd0fddf131ba,113,81,2,395.5,113,0,11080,3
0241473bfad8fa22272225708c1d814d,80,46,1,560,80,0,11040,2
b5b81cb0491c4d86f761c84a136c45f0,227,82,2,794.5,198,29,01012,4
14e234d28ba7f5cecc05506c5918c02f,1,1,1,7,1,0,10080,1
8aede738464615cc86f39eb1ab56b5f6,90,64,2,315,61,29,04060,3
27373532bf824148e39f1bc1a7b89fea,25,25,1,175,25,0,11100,1
2c545122d4f3f293d82895bd619f828e,36,18,3,84,36,0,08032,1
c3ed61ba1850a30f11c1fd85e8f0243b,145,88,3,338.33333333333337,145,0,05040,3
3bbc95246b3ce4ccf316cf53e5b724f3,94,60,2,329,94,0,01012,3
85f0492b83d0612cc269651d3beaf50d,14,14,1,98,14,0,09010,1
f8f44e2f7aa2917693ab83b6c1d15944,168,106,3,392,168,0,10200,3
0723d7cc65418825d5f17f8d31574457,69,52,2,241.5,69,0,09130,2
5837a18615ded6b5a16c1ac28582f6e5,93,81,2,325.5,53,40,01013,3
79c4904aad7f32fe690aa99542013d54,334,101,4,584.5,334,0,01026,4
b2fe815cf9efeda87a0b276df29edc75,108,51,2,378,108,0,01026,3
44bbf4e86432ea6125e2590d803ec688,66,57,2,231,66,0,04020,2
bba70bb07f5a7235bdc740ade7a6b49e,33,33,1,231,33,0,01026,1
7b35ed5b83b52174baf76800af27f1c6,6,6,1,42,6,0,11182,1
2ff9cba89bd864e106e14919158da61f,17,17,1,119,17,0,01026,1
a43d752a6f46e46461f83ec4f98a4f6c,230,89,4,402.5,230,0,05041,4
d1c3a88738b5e2ea48690ce691e852e7,20,20,1,140,20,0,09170,1
57357849317b9f9ac873f4885e9c3ab1,8,8,1,56,0,8,05030,1
e5aa08fe8d2e27a1aabdb05d72211b33,33,18,2,115.5,33,0,05030,1
b439eaf195031a8e54336c91791891fa,245,115,3,571.6666666666667,180,65,01026,4
57c11193675e76678a919ff5107e4687,4,4,1,28,4,0,10080,1
796b7e8f6f14675344c2e1fdd4257742,70,54,2,245,70,0,05040,2
efcb369e7f71b605213faaf8043b5e22,351,114,2,1228.5,351,0,01013,4
06a244e9e0064ca747d0000e23cea161,55,35,2,192.5,34,21,06100,1
2bc8a2a872ad8403ff129cff5e7d8a20,140,78,5,196,118,22,05030,3
03b8ec3502c618d10e1a591d726b6eb8,18,18,1,126,18,0,11100,1
3518a6a892bfb9e51c8a967b3415abdb,32,32,1,224,32,0,05040,1
a0ac757bfd2b8f4e81f8b6d19e8ca8f7,13,6,2,45.5,13,0,11040,1
d2eac5ce41cd2bbf6302396029b4c221,3,3,1,21,3,0,04031,1
fb82abd9158a9bc4c882189463e91d19,24,24,1,168,24,0,03050,1
327b67d50c8bd5676c2321e8f0e46f19,123,81,6,143.5,110,13,05040,3
320a4da22b11ac718f6cd49e25a55283,50,50,1,350,0,50,05100,1
969f6af55655f26468ce3d4560f2989b,26,25,2,91,26,0,05040,1
95ddafc87b04bfb4cd0eb074027cdcfe,35,28,2,122.5,35,0,05040,1
1e6502108e225a77ce065612841357c9,60,53,2,210,60,0,05040,2
c97096d81ff8f968f3e40ff995b0ea88,10,10,1,70,10,0,09090,1
400175af924a084abb1f2ba69ba71e16,116,75,3,270.6666666666667,75,41,10281,3
cf122255ee21620239736276a33cbcf8,206,112,4,360.5,206,0,01026,4
c42b2103745a7b3f14a41d04dffaca25,24,24,1,168,24,0,11100,1
687ad63a1d2a110209bd11d4e1b10bf2,128,78,2,448,128,0,05030,3
d19b7be6b076606dea2a44af2ed39b00,134,60,5,187.6,134,0,10200,3
cf61b02f6b6348bcb715a2771a17534f,141,95,5,197.4,96,45,01026,3
8a6a22c38cf75ea0d35bb9bf802a22a2,298,124,4,521.5,274,24,05030,4
e9f056066d6ef32268eba69a5574c070,103,78,2,360.5,103,0,05040,3
67581a6a42d0e5927a8e104c4bbc5b61,43,43,1,301,43,0,01012,1
26c61234e501128a276a59ecd6ef3e13,37,37,1,259,37,0,01026,1
c89d827094c14c56739f69470f930297,61,54,2,213.5,61,0,05100,2
8259b87fc8155e8b6f4288df2e3ed15f,36,29,1,252,36,0,08051,1
e1340b9747b88defb0694bbafc8f1a7d,42,33,2,147,17,25,10200,1
19cd287e4698877432db8ec6309359f3,24,24,1,168,0,24,05041,1
7c95d91abee795bde036be8a49f8eeb1,162,77,5,226.79999999999998,136,26,05030,3
2b14619ba68acb28cf079beed9403bf3,210,123,4,367.5,210,0,01026,4
8875f5147f2fc281866623d6fbf9fe99,45,30,3,105,32,13,05040,1
89119c08fcf817cf275b6b404fe2b432,100,53,3,233.33333333333334,62,38,11080,3
9101158fc44107bea152300387d7e091,59,51,2,206.5,59,0,01026,1
c17cf752d9a6360b40ec7db46685072c,141,68,4,246.75,103,38,03070,3
6543021bff7de4b14e47a41eae0df864,362,109,1,2534,362,0,01026,4
1a1b338fee2a82c2a42dd816c3c266d3,139,66,5,194.6,116,23,01027,3
980a12b57869713548b2f7085751c593,36,36,1,252,36,0,05040,1
f94f6b75ffcb8f8f335d540d5eb9bae5,478,133,5,669.1999999999999,354,124,01012,4
a254b1d364c3ec75d250c6528c2b59cd,172,105,5,240.79999999999998,154,18,05040,4
02d71f520346a1db67c69c744d8b989b,4,4,1,28,4,0,11140,1
c7f4ac8d6595815d2e61eb8c6c745ea7,120,65,3,280,76,44,04201,3
e93fe06b38d8db00dc61e560c6501aeb,21,21,1,147,21,0,01012,1
85c19968456b92fb7cb1c06365af3691,32,29,2,112,32,0,08314,1
874f529ca5d1118787e0096460fd403a,28,28,1,196,28,0,01012,1
6c2c6039a256cb1546eb040bf659916f,57,57,1,399,0,57,05040,2
d6701e59210d77b5be8c75743222887e,69,62,2,241.5,69,0,05040,2
8ebe41ed2a2ab56a7652148ee3b4e7ec,24,24,1,168,0,24,05030,1
4c36abb6c45411fb0f55b0bb95be767c,75,56,2,262.5,39,36,01013,2
8488ae38897017dc902508d2b065b650,115,60,5,161,102,13,11040,3
4c6fb71841c4397cb2de57a795e6059a,21,21,1,147,21,0,05041,1
8c64335f30ccf95ad47cbf1b4cae2780,219,140,2,766.5,111,108,04020,4
a1a1fdd7e46f49d4b55450b70e859d36,73,59,3,170.33333333333334,73,0,05040,2
59beb6355a5f0eb2e9f88b2850e07fc0,66,46,2,231,66,0,10200,2
f02501c1d2d78851c8b07c064fdce110,11,9,1,77,11,0,05030,1
dc4680a784f397b6ddb2c2094cad2aa7,180,85,2,630,180,0,01012,3
c087667b07bbd6dfe82d683a5adfb9b5,41,41,1,287,41,0,05040,1
d7d7683a0626bea95664b4b6d1feea11,12,12,1,84,12,0,08313,1
17913207f3a8dd2faf63027fdb3d3b8b,65,55,2,227.5,65,0,08452,2
e289658952d28004c1ae55865837810f,44,29,2,154,44,0,11100,1
162feaffabae88c631e6bb8719ab5052,44,28,2,154,44,0,05040,1
6c8b8bb5623397de95715853260814b3,16,16,1,112,16,0,08052,1
8df8c4b7739ca0417132c6bffcf3af32,4,4,1,28,4,0,05030,1
148d050a6752a530cac1809b66ff06b0,36,36,1,252,36,0,05040,1
f994494614d49d71300d84253a52ea4b,22,22,1,154,22,0,10261,1
25d32ab7e9b1305b7f9d232cac522a08,44,44,1,308,44,0,08032,1
b5c1f71ae50f9dc98fe3d6e9e50f65ec,115,42,3,268.33333333333337,115,0,05041,3
556ee268d1b0bc24b2dfdb18252b7e9c,46,39,2,161,24,22,03070,1
dfcf76048b712658b7853292f016526f,34,34,1,238,34,0,10240,1
f1e853364c711d962d91f8ec7116abfd,143,84,4,250.25,143,0,01012,3
5e6333bdec1d714c4dd71963cb3ec723,38,38,1,266,38,0,02690,1
673a04bec6ee3385c84fcb8c0f124b24,17,17,1,119,17,0,11103,1
f6e8837c47046ec19c233b39b36b206e,114,86,1,798,0,114,01016,3
87d0b7a9eff77c48f906691b85327617,24,17,2,84,24,0,08132,1
e59967846ef5e59b6175c68d888222a3,196,116,2,686,196,0,04060,4
109822016d83c30d9d3f66079c3e3fa4,136,62,3,317.33333333333337,124,12,04060,3
d72c261a6076cd94c545422bbde20f4d,255,124,5,357,255,0,08230,4
2a3853f0cda61a82d41be23cdf1907cc,21,18,2,73.5,11,10,03050,1
5d45fad84325b0bc78aade48ae9cb105,30,30,1,210,30,0,09110,1
5dc7c0610215d3c0011f0a19fe53b789,248,120,3,578.6666666666667,248,0,01026,4
87f2c53dc67facfc3192b8711508e23b,155,83,3,361.6666666666667,114,41,05100,3
c9e49b829dcadd968ba48c2bc113d318,29,29,1,203,0,29,12742,1
708e3848d7c2fa2c54eb22a7331d4811,41,41,1,287,0,41,05040,1
a06cd6ee257cea92e623cfaf9d2ae656,239,76,4,418.25,220,19,05040,4
9935949da6b28e507478996d1709066a,75,65,1,525,75,0,05040,2
e4514069729270295feb857a7eb14f2c,269,100,2,941.5,269,0,05030,4
8a80ce61b47f54ddae106e8a2dd0b085,106,77,3,247.33333333333334,64,42,01026,3
dd92217c17530dde03329f88f24b78ef,45,45,1,315,45,0,03050,1
3e203dbe167ade0558c12b163cea6ec9,72,57,2,252,32,40,05040,2
24a2fac9a3d12013ecc31d1833c39c6c,96,65,6,112,74,22,01012,3
6f6db4f176d9673906ea41b5ecb11f95,29,29,1,203,29,0,05040,1
0fa9b7da27cb1f3e7bba8bc1e76160fc,124,86,2,434,31,93,05030,3
f53a7e4b4b800dddb3b7421a5916dcc4,24,24,1,168,24,0,08010,1
48d8ee562a603374ffb410b2c09ff732,109,87,2,381.5,109,0,01085,3
76278617d0b8283aabfd942cf969381b,22,22,1,154,22,0,01013,1
5b86fcf276f8a7647cc5c721a014b13c,65,53,2,227.5,65,0,04060,2
b938c442ecee004dcfb8dffa7894b6b3,143,113,3,333.6666666666667,143,0,01026,3
d00ad7fac3bae43965e4c51b06909151,14,14,1,98,14,0,11100,1
67f26a512bbc00e35b171f54ac5ccbb8,38,30,2,133,38,0,09010,1
5edd9febce7656ec89c692b161798053,139,86,4,243.25,54,85,04060,3
eb6e934dab09bee6b39237cd2f9e2a95,5,5,1,35,5,0,09010,1
e10d5df659408738098acc9c2b909269,55,55,1,385,0,55,05040,2
eb930364a4d90c1ef4be177fb9f8aa52,42,42,1,294,42,0,05030,1
52051623c15ec885c5c29b7cee8c0d62,208,100,5,291.2,179,29,05100,4
fc846046770bd4d6d08e644e06ddba01,34,34,1,238,34,0,04080,1
a6af2d0b86eb069c394b375d08af2d63,105,83,2,367.5,105,0,01026,3
d948bd98b4140a67e4892820ced88268,27,27,1,189,27,0,09150,1
82b803f6b1ad2f3c850d8f66c3aa840e,164,88,4,287,164,0,10200,3
1329daa6398c625158c9b3f1658ce102,92,51,1,644,92,0,01027,3
23c15ac37f6d5137628533196526f429,21,21,1,147,21,0,01012,1
843379039b40b4d720bb56b7345619c3,95,88,2,332.5,95,0,05030,3
6422af170de208d3199e686630490a70,27,27,1,189,27,0,05040,1
ce3a84cb15f0e99e43089c969606b826,26,26,1,182,26,0,05040,1
e35cd8a728fe22f3b988451bc67444de,4,4,1,28,4,0,08052,1
e5ef5187692418045e884628bd98a609,124,85,2,434,89,35,05041,3
26963e805e455dbaf28d7aaae68cc060,309,102,2,1081.5,275,34,01026,4
0addb962f420874d4bcd18e01d90fc8b,9,9,1,63,9,0,11100,1
5e8edda3dac76065c2af4983fb8de42d,29,29,1,203,29,0,08110,1
91bedd97e0e9576edc7441380de600bc,17,17,1,119,17,0,01026,1
f2ddabcb84e07520f7d11bb5ae987c0e,80,49,4,140,66,14,11040,3
bedbb9dabceaf548958431d05a4e2559,71,56,2,248.5,71,0,01012,2
a32f63ccc5bc8f767cf8ac620b5ac40c,60,57,2,210,60,0,01012,2
49f0859042e44f9b242eeedd71df1a6e,280,147,3,653.3333333333334,85,195,05040,4
72f86233ee7cb001eb30ecacf7ab4b96,7,7,1,49,7,0,01027,1
3f5f1fec1e79da116968a0b0efb9ff8d,55,55,1,385,55,0,05040,1
a800e4bdecfa2f074b5bac0493124702,65,38,4,113.75,51,14,04012,2
b618e2477fb8fb42cd00e50f64f32edb,344,128,2,1204,34,310,04020,4
c1a4a76b5915e646777eaf068189ac10,20,20,1,140,20,0,05040,1
20422163724d75387bd156707d04e1cf,1,1,1,7,1,0,10080,1
2d77ef6aa7c65734be58561524372015,215,147,4,376.25,153,62,10240,4
085adf77a44f960f7ae55783311f941a,119,58,4,208.25,95,24,01012,3
0081c4cd8a89ed39c1951057e862dfc8,191,90,3,445.6666666666667,191,0,01026,3
dfc1853cb5cf0b3690c50ef8a8e29bc1,422,83,3,984.6666666666667,388,34,01012,4
57aacf673072a2eacaa6229e8e0c02b2,54,48,2,189,23,31,01012,1
6c8f72ec332703bd06d01ee4c413a4c4,73,49,3,170.33333333333334,40,33,01013,2
a214fc229da749b07293f70d2bee241b,118,87,2,413,118,0,10200,3
8b9e711a4610c1a9fcf658eec4c35b03,179,91,3,417.6666666666667,179,0,10080,3
2f5ce5d2c2c9a3b3c13a541dd0f3840f,120,86,1,840,0,120,10028,3
de0ad4b37609a2c051a67c1b5e35ac5b,81,73,2,283.5,81,0,05040,3
07a99757e6d14af9860fc0e6397dc7b7,198,100,5,277.2,168,30,05040,4
9cfbb18fddfcec298b60b0b69899916c,22,22,1,154,22,0,01028,1
b8fbd58606b58762a31cd6ca12ea336c,44,44,1,308,44,0,05040,1
2e374cf5b995407e265ba3005a53f9ad,266,168,6,310.33333333333337,254,12,01027,4
e8acbe53cb97afad71877ca23ab0d900,94,82,1,658,0,94,05040,3
a82549babe75025993c002ea3aad2408,27,27,1,189,27,0,01012,1
391f046a916b78fbb5cb7e4e4d96a371,66,57,2,231,40,26,01085,2
2902eaf57c47278b9652f9f9c8b29a27,46,46,1,322,46,0,04201,1
57d62eb7d6a7998f62efac11cea15e24,67,43,2,234.5,54,13,05100,2
70520dcc16329c9219aeb1a72efdf953,36,29,3,84,36,0,05040,1
0f9630280980881a77ab7749304d917b,103,66,3,240.33333333333334,63,40,05030,3
7f85f149c1a3ac6fe9647b6be99e5de2,33,32,2,115.5,23,10,01026,1
9726606efec809c8f216048a748fa9e8,21,17,2,73.5,21,0,01026,1
06b4c6a28a6022760878325a19e413f7,194,77,2,679,194,0,02751,3
88902afdd13a10a81f723439c52fbb31,29,29,1,203,29,0,05040,1
0caccfd7c6792c11ba8f3b951ae5fc1e,29,26,2,101.5,29,0,03050,1
8ccebc57b4ebe8897fe8ffb1d2810db0,49,43,2,171.5,49,0,01026,1
305ebf2bbea1c381727fc2476afd2dbd,24,24,1,168,24,0,01027,1
57202f300ec95a8a4c766bab53beb7c8,73,61,2,255.5,73,0,13930,2
92d1ef5f4152d018da66b56077d8bf76,63,57,2,220.5,35,28,02754,2
66f6791d890230abad7a32fccd2d38ef,24,23,2,84,24,0,13490,1
5b7e5f2ed982e9a5c5fa243cefeefc62,288,64,2,1008,223,65,05040,4
c7c49d23923328ec1601cb29663fe017,21,21,1,147,21,0,09130,1
69639d63acf7bb9379b3891e0002b238,192,92,2,672,192,0,01026,3
6716cbbac2ce67113aeeab04065413b2,125,73,3,291.6666666666667,125,0,10240,3
882b2ea23d05c347bd2d691fa230e80d,29,29,1,203,29,0,01012,1
14f22c9cc7d5110ff540cbe5ae29f68b,134,82,3,312.6666666666667,99,35,10200,3
9bf0b604cb4eea7773c4e2ebc3173394,23,23,1,161,23,0,01026,1
0a1b924f4f734a5b939358331f398052,294,101,5,411.59999999999997,262,32,14301,4
bedf5c640dae2c3423e6978367195a9f,107,57,4,187.25,107,0,04020,3
1b17665cac8c4234f74a95583f54a95e,120,72,3,280,8,112,05040,3
3afda910835850407c338b7efe7d758d,119,56,4,208.25,82,37,10200,3
3c38cb7f4804280780ddae7e943860ba,116,75,2,406,116,0,10240,3
689234226d26b157b247cc0aab23a3d2,319,170,4,558.25,232,87,02650,4
3d985ab9102e4fce6f14daaa3bb1e88c,375,126,3,875,375,0,01027,4
ddbec8fcb6eade53914b0b30bec2f9ee,72,52,2,252,72,0,01027,2
803e8ac2ef5d1d9c8cadf1688c3abe04,157,59,3,366.33333333333337,157,0,01012,3
3e72e39631da922bae2405ba175799c0,171,88,4,299.25,140,31,11060,3
9a423fecf1d9fac457d57170922bcea5,147,89,2,514.5,147,0,04060,3
853dfc90780447f09d0ee255635e1c84,78,66,3,182,78,0,04032,3
8ab24c6585cd8838353327b1e6378a43,71,43,3,165.66666666666669,37,34,08230,2
57ba445ae5445a05195fad1267e38cc0,87,43,2,304.5,58,29,10028,2
98841cef51bd4b6d704ce25d61303b79,16,16,1,112,16,0,05030,1
f8796e44f3b5dcd520daa1545a390cd3,189,126,2,661.5,85,104,05040,4
c8fa0d68d0582262bc5d7ec9c047ff17,54,44,2,189,54,0,01085,1
6a124411ab1a9de7775c4697a8ae0849,33,28,2,115.5,33,0,12710,1
e22d6505dd73739860dbbd3e18745cae,67,59,1,469,67,0,01027,2
64e384974c01b4365248d1f96b920cb4,97,78,2,339.5,97,0,01085,3
9c05f521051abb4ccdb188fcaec87562,4,4,1,28,4,0,12501,1
40158a4ac37a0799115f17c1a5dd6438,29,29,1,203,29,0,05040,1
e98894914fb3fa39b7fcc2ab60d34116,22,20,2,77,22,0,01085,1
7be437e3a32f556437e391ec9a39244d,257,127,3,599.6666666666667,257,0,05040,4
9a16cdfff6a11966045cd3b7a4897434,19,19,1,133,19,0,01026,1
6e12ae65509d837f85677f25b75294fa,55,55,1,385,55,0,03050,1
0f3c7fc08c6bde96cd719f16867a7fed,112,55,5,156.79999999999998,112,0,10200,3
c8341cc0266dfbe3bf8586e12f4dcac4,18,18,1,126,18,0,11040,1
7e60dfa07b972443e01ec83b5313d4ad,26,26,1,182,26,0,14251,1
0af3601ee17d924ffba3894823e1893b,29,29,1,203,29,0,05100,1
578a270b9f5ecbec4e862d8610bc1d69,72,21,6,84,63,9,05030,3
cf5a92d4d8293ac061b54554a357ea06,28,28,1,196,28,0,10140,1
879f4bda40a11cb2e1d07bc534741650,54,42,2,189,54,0,12500,1
f2e5aa9e370dbbe8e0f80b7add8a4449,6,6,1,42,6,0,12470,1
a0675b8e8d4fb46f03848295d031c7cb,120,65,3,280,120,0,13830,3
7c1ba897324a652e268d4b22570a771b,128,91,4,224,95,33,05040,3
49b22ffd36f91ca82c71d10bacbf69f9,96,77,1,672,96,0,01012,3
7658cea546bff531aa8a5bf820b8ce51,59,44,2,206.5,59,0,05030,1
712a20d124d2d865afdd83492523fbbf,44,30,2,154,31,13,09010,1
f24068ec39c0c855ac32d8fa44f7f18c,275,132,3,641.6666666666667,201,74,05040,4
9f0fcb04351699dd78845103670de6b4,10,10,1,70,10,0,05041,1
246a0bb420a9d36dca95f6494c89edd0,54,47,2,189,54,0,08100,1
2f37d98fbd1e54d0f3cf38dfdcb50bc7,113,84,2,395.5,68,45,10200,3
a50b3782f96380f35fd79e92d84ef0e3,20,20,1,140,20,0,14301,1
26c71854d9f9e346518cc76912a902b7,25,25,1,175,25,0,11040,1
dd62040c4a0ffca4f33dca4c85fc1d97,22,22,1,154,0,22,07144,1
bda9774a52f517c49c3e2bdb72f30aeb,118,71,4,206.5,118,0,08052,3
e0e8546502c14576f0a1d1c9925eba8e,76,62,3,177.33333333333334,29,47,01013,3
35b1d47ab31be0e749dd9039888a81d2,29,19,2,101.5,29,0,08100,1
936b1f7b425b5f9a0d797b72b8d9a965,7,7,1,49,7,0,05030,1
1871207253cfe24e53a91d13c465828e,19,14,3,44.333333333333336,19,0,01012,1
14a44397ee1e8c5f8bd138b11fe27e37,206,92,5,288.4,186,20,05040,4
67f658589e17dc9aa36a78735aa20d5b,24,21,2,84,24,0,08315,1
766b1db78b99f3efcc38bcc24db3b885,197,120,5,275.8,177,20,05030,4
5342f00e7e4cc6969b89f98feddc6d46,7,7,1,49,7,0,01012,1
00ca695616f5a5e87fe6a525b625961f,56,56,1,392,0,56,09130,2
a91df4c583f5abfa0233e3aa4741c922,107,88,2,374.5,107,0,01026,3
70693c8cad734f8db686434193715bb4,45,45,1,315,45,0,10240,1
40e356fcfcaf3d12df44b31f4a3cbe58,10,10,1,70,10,0,12501,1
5ef4a20ebad64401ab145f4bc7214b5d,160,99,5,224,131,29,05030,3
735c6ed2e96adea0e84a174da78627d5,17,17,1,119,17,0,05040,1
410b9437c634c511ed23a8c9a04c23e1,34,34,1,238,34,0,05100,1
595d457b865b2d09df3b533f6136e154,23,23,1,161,23,0,01026,1
c57e98e26bf11926a8a7a544ce6cd14a,42,42,1,294,42,0,05040,1
351db5b89c2eab30f4ce4c89bcf3b573,36,36,1,252,36,0,01201,1
aeb849b86694c742638ab453178049c0,82,65,2,287,82,0,08032,2
d5576807e31194c23ddb2dc698021a5c,41,41,1,287,41,0,05040,1
f032ac144e21b20003aaef87572a72e5,270,139,4,472.5,124,146,10200,4
599f1489ffc5d7af724165c70b6ad9d8,162,101,2,567,162,0,01027,3
84fddaea6c2260a1f89476ff1bc6d413,10,10,2,35,10,0,10080,1
44e86d302a6f2b2829cd8a35d4d46bce,31,31,1,217,31,0,01012,1
6da91827e14c36aaf28cba9b7a521b50,78,76,2,273,78,0,09130,2
45b4a12c11d074534811ebd602aac406,19,19,1,133,19,0,04020,1
af2d313463d230d97575ef0b4ee40799,45,45,1,315,45,0,01012,1
61b967131ac390093e80a04e6ca6d68e,286,117,4,500.5,286,0,01012,4
77d8ea80dc93023f4127b1410fc74ead,43,37,2,150.5,43,0,05041,1
1b423c83adc48940cdfef8fe731b6c0d,47,47,1,329,0,47,01026,1
0df2b57612442d509995025b0d2937a2,155,103,4,271.25,155,0,01027,3
cd566f2e17c1af2ae8a8987480a3f8c3,70,47,2,245,70,0,05100,2
112ec1bc8607515547b1a4960aa2cb69,105,81,1,735,0,105,05030,3
20c7e0334f930a462130cd9d2258bce0,251,109,5,351.4,210,41,10153,4
db0baaf3a2d026ad05725f449b6eca1b,79,62,2,276.5,79,0,01027,2
57c57920c01bfb6491c76dea40ae34c8,107,72,4,187.25,107,0,10200,3
373f7f17c6ca9cc1fd766a6f4dc0bb5a,5,5,1,35,5,0,05030,1
a81c428dc219d59ddb809b351f0c8bda,61,61,1,427,61,0,08052,2
6984bbedb547c6d8001edb616ff0a89d,29,29,1,203,29,0,01026,1
0c5c8a69487734df080b155ea5b1a7a3,202,107,2,707,98,104,05041,4
34555a588ec5aaa9c5fdb8e98efa004c,34,34,1,238,34,0,03070,1
02318fdc10c7b29649329fbecc389684,395,138,4,691.25,395,0,05040,4
63aaad2e5761b6aa371e03a069413009,110,78,2,385,37,73,01026,3
6d7f36dfe6d747cddb68b8473a411a5b,54,54,1,378,54,0,05100,1
62c8eb3ce518b97432588285386bfffd,90,67,2,315,51,39,01012,3
be74abe8181fd5f9eb3758dc8b501da5,231,118,5,323.4,167,64,05040,4
53ab75242751b3a128e112d569b9200c,74,49,4,129.5,74,0,13930,2
9926e4e8800a195ee86573e4b68a66a8,134,75,4,234.5,101,33,05040,3
a4a025037abc100b1213ce1c99e5e79c,24,24,1,168,24,0,08010,1
18dc3a0d3fc9aad36944801bdfe682be,23,23,1,161,23,0,01027,1
67675967a9b0c6941f5f2bb0566d5cc6,9,9,1,63,9,0,06100,1
f615117ed89ae011a0cea2319f22a167,10,10,1,70,10,0,01012,1
87a9e16816e5dc8988fff938d072455c,110,75,4,192.5,77,33,05030,3
7dedd5c26a6b336e8a5484c2470866b8,16,16,1,112,0,16,12501,1
1d3b2db3cd430de0b6923e0b1c731d52,16,16,1,112,16,0,04201,1
8f074ca16b7d616782da548e069e7782,39,39,1,273,39,0,05040,1
fbf3131cf7568f630f35c5adb714263e,167,85,3,389.6666666666667,115,52,01012,3
6167b696ca07752d4b5dab92d33f4116,62,62,1,434,62,0,04020,2
663261806a273d36d716d35a9dd7b1cd,99,68,2,346.5,99,0,05040,3
d339246cff67170d715a974d69d45b7c,13,13,1,91,13,0,01012,1
b89dc5f1da4634e2c272fd84c497d040,183,132,4,320.25,158,25,03033,4
05d0a6836af2621075c761e4b08c6522,46,35,3,107.33333333333334,46,0,05030,1
ae2a49294daa5e23965345c2eebbd379,22,22,1,154,0,22,13490,1
9b1f990b141aa5a9f40a4b0b6784abf8,11,11,1,77,11,0,10141,1
bf5847f4085c0e187d3a47d9c808c328,51,51,1,357,51,0,05040,1
05d731ce8e11a0cc214a7b5993c07932,249,119,3,581,249,0,02690,4
14772b88902a804a8d118dc78806e837,138,97,3,322,47,91,11040,3
b8222d2bdb4e84592db99ff1cbc1bc26,59,47,2,206.5,59,0,01026,1
7fa748cfcf335c111f921c62bcfafb53,63,59,1,441,0,63,11100,2
f4e45392d675373cdb33301fea8ea1f3,22,21,2,77,22,0,02751,1
0783ab80fea2a4c50a1222c2b225f208,387,88,3,903,359,28,05041,4
52a797a0b282ebcc78a0a1c5c2f18cb4,87,73,3,203,87,0,10200,3
f187e2f95d3dbd3f77c45a2b5e5df59e,57,57,1,399,57,0,12501,2
405d8e2274980946c366dcb63101ab5d,104,51,3,242.66666666666669,104,0,05030,3
628c1df655ad5ab57631dbce4ac30604,175,106,1,1225,0,175,10200,4
a2f80b8dca6a9bb41f8ef39c21817cd5,42,42,1,294,42,0,03070,1
318bdb63c3c9a1b04c2dbc25e59b45a7,62,59,2,217,35,27,11080,2
a26f4db530d4d0094fd28ae1d9d939ef,27,27,1,189,27,0,09090,1
74d2fd48868866a76864940a7cbf4c41,15,15,1,105,15,0,05041,1
face3c923973bc77dd3bf8b4a3a89138,50,46,1,350,50,0,01085,1
90a1e0eae978ab06841ca97ae8f37eda,144,98,4,252,144,0,10200,3
411f4532bc6b3a85842ebe596a83bb95,165,101,4,288.75,121,44,10200,3
5b286f9d10f2acb311a2cf2224a0fdec,75,51,5,105,75,0,01026,3
2f1a6eafcae0b40ccf7e4b272a3d54d3,181,111,4,316.75,142,39,05040,4
317407e22caefeb074c16e709eef2cd4,46,46,1,322,46,0,01012,1
6a502c72fd06589239d01efa77287af4,34,28,3,79.33333333333334,34,0,05040,1
5659523bf357737b338d33a4f20ecf8a,33,31,2,115.5,33,0,13490,1
80c7e6dc44a6f244a1588dac504d2365,13,12,1,91,13,0,11080,1
348991ee4005b874b59f4c176083ebce,63,58,2,220.5,25,38,05040,2
3dac6075c967311a0852fb8549282f7a,80,65,2,280,80,0,05040,2
bb8104b634ede9b46bf4b53789ef50b1,136,21,6,158.66666666666669,113,23,07133,3
f6b3ba99c4bccd6b1564c20cab401dd6,13,13,1,91,13,0,04201,1
84766e2ae4232be05dc3884d2e8eb8ae,137,83,2,479.5,137,0,04060,3
5e3dd624c57a49fbd64517e3b39dc2c6,17,16,2,59.5,17,0,05040,1
14580e9dc206c505612aff5575021b0d,37,32,1,259,37,0,12590,1
861f93191a63842cd80adcfbd9abdfcc,286,135,2,1001,46,240,10028,4
f4352ba02712c3f76ff5c31e6df25537,177,99,2,619.5,177,0,05040,3
ebb50bb45666b6b0477373d6a5d4621d,47,47,1,329,47,0,09130,1
9d58e6bcaf253f2642bb0b9e6bb012c4,65,51,3,151.66666666666669,65,0,05040,2
58fb026dedc7144cd8bd45f8a29ed7e7,26,26,1,182,0,26,01012,1
585e36f12e38afddb6f9fc016facb96f,54,54,1,378,54,0,11100,1
fb58993becc34474fa66a4dcb14a6835,28,28,1,196,28,0,05040,1
21554ae6ef3675ddbfe5f520fd41239c,26,25,2,91,26,0,05040,1
4c144d0089bfa76c6a5a1659d1fc8626,22,22,1,154,22,0,09130,1
156280d76cfdd9038516fe983ef59e83,8,7,2,28,8,0,11040,1
c0623226a49e5c7a86af3a8dab48ba25,208,159,3,485.33333333333337,208,0,05100,4
df8bbfddd61594727161251e9b685ef7,10,10,2,35,10,0,13820,1
a1bb084799f944c3fb974e8a14c53e17,51,36,2,178.5,51,0,09090,1
36f907f27d812de02549697054e6ce18,81,44,3,189,41,40,01085,2
36a8cc5a74a6dc030ff03f571e262fc2,70,68,2,245,70,0,10240,2
672dc236e0842ca54bacdb055e032b27,122,82,2,427,122,0,01012,3
9a55d638b4bc2327c8002e2b095202bb,93,78,2,325.5,93,0,01012,3
fd3f317ff66893b7d84578ea98c7771f,94,66,2,329,17,77,05040,3
6e8986715a99cdbebfa3fe7561ead4d4,35,19,4,61.25,35,0,05030,1
cdb204688a97735fb394ec6146215d9c,27,27,1,189,27,0,01027,1
7d632f9ea8eac8f24b694fa023e0f8e5,28,28,1,196,28,0,12500,1
0a63e72d4238833a166f813f5d719f70,33,33,1,231,33,0,08100,1
f1a72dfd1e6a0a134d1b9975f31652d0,27,27,1,189,0,27,01085,1
e41c8dec94089155a57a06ca1d1cd9ad,42,42,1,294,42,0,09130,1
abd1a281a6bc8c90906ba69dfd7716e7,41,37,1,287,41,0,09130,1
f3cc62d02fcb855744ae4e0fdb717221,52,28,1,364,52,0,05030,1
f32dbd83d813c158f6d5703adb088620,22,22,1,154,0,22,04060,1
91607ea470727f5455929567b953af58,97,86,1,679,97,0,05100,3
7f3aa63aee1fd37c4e6181fd7db5cfb9,38,37,2,133,38,0,10140,1
6022960d0c53f63093dddaf2c878481a,116,86,3,270.6666666666667,62,54,04020,3
934bd29848575e1db7fd609179742007,67,54,3,156.33333333333334,67,0,05040,2
006943e45e018b299391c85d64609b6e,51,51,1,357,51,0,01027,1
4c740b8fd834b002639fdb08e17fc28e,433,180,4,757.75,391,42,01085,4
1fa3110af1aeeca5714a51ad587a8d23,43,36,2,150.5,43,0,08010,1
6ae6b22b2d832b8eaa7ca9e165621f1d,37,37,1,259,37,0,04060,1
eea38b47ee41c6d9b16abc175c79a46d,76,50,4,133,56,20,06100,3
87be5c40ca138e79eb6d9d1c5e868853,73,68,3,170.33333333333334,73,0,03070,2
0c01d193c00a80a6d55ea882020257a6,223,85,3,520.3333333333334,94,129,01026,4
0035f17abc612d48ae4d0f5c38c4ec00,157,74,3,366.33333333333337,86,71,08314,3
5082c6d897ef343654df4a3e982e7183,29,29,2,101.5,29,0,01013,1
8aee835d281e217ef7d943f5def77bd9,52,44,2,182,52,0,01201,1
4a658d0751525ecd87375194b7fd0634,206,97,3,480.6666666666667,206,0,05040,4
e43dad296c47ac2005bd1d6cb3fb3fb7,15,15,1,105,15,0,01012,1
90c4c317aa3156cefc6f8aafba58570d,185,127,4,323.75,124,61,01026,4
8813a9b7630bba7ca1d26afe6d614b36,97,55,5,135.79999999999998,97,0,01026,3
767652171e743158fa7f5889462d267a,40,34,1,280,0,40,05030,1
134083761165867c0f0c799679f0614e,113,113,1,791,113,0,13877,3
ca6500f62be72f1a7af636eca0a4e822,176,76,4,308,176,0,03070,3
adba64bbe019e5141257fcaa88f849a9,19,19,1,133,0,19,05030,1
d68433df72d77a35c8c0c731dcfe75a7,56,44,2,196,56,0,05100,1
51beb93be80b5efa51a7bef4235b5709,70,54,2,245,70,0,01013,2
4ac4a18694dd074a552a87164a7ef4bc,227,124,4,397.25,227,0,01026,4
8361ca108ecf7ac8f46ad0ca419d77cf,387,130,3,903,101,286,01026,4
14ca50afd821344f06500d0a67730654,202,131,4,353.5,202,0,08052,4
a00012b02c10ab17ee0ee6976d578661,59,59,1,413,59,0,01026,2
a8a8c91c0ed374858761bd3623f4601d,26,26,1,182,26,0,05040,1
dec47bef498e1d5611d7f34c641a4bf0,7,7,2,24.5,7,0,05030,1
380ccf9f922d479673f9586cb4f66ca1,40,35,2,140,40,0,02690,1
379a6177acf27f29681b5ccd44f86089,103,71,1,721,0,103,02620,3
8ee5568ff93cd233427770076fb6a931,41,36,2,143.5,41,0,12710,1
769815afc144144fdeedaffb2af1de7e,44,29,2,154,44,0,05041,1
ba0f07525b82ce313962a18fb77ce58a,162,44,4,283.5,86,76,10220,3
6e601b5ef2591b58faa6ebd6c8a81b27,246,78,6,287,148,98,10200,4
ab6c1c5db22effc8cfc5d4c8fd9943d8,44,44,1,308,44,0,05100,1
7461a7c6a13d5f168be208215d470232,87,68,3,203,56,31,01201,3
bdabf4d7d69889a620514831086a6c6e,34,34,1,238,34,0,05040,1
d50f560736611c6d9b67d8df6bcba8ee,54,54,1,378,54,0,01027,1
37b734de94bcf3554408e46b0ad2db99,483,176,5,676.1999999999999,483,0,01026,4
bd4f33f753ced90486de11cee27ffd1f,17,17,1,119,17,0,05041,1
09a5b2457f033a86c8dcb438e1bdf0b1,34,34,1,238,34,0,05030,1
45c2d1034c2d48f47839585c6de71da0,101,84,1,707,101,0,05040,3
786f13d0b5293324cbafa20d05055d5a,161,76,2,563.5,161,0,05100,3
e24774ee359ca1da369d5cd696dc80cc,307,146,4,537.25,307,0,01026,4
68d2f4623ae295259fb192e4f5d377d1,20,20,1,140,20,0,10153,1
516a61735233aae4f5439061e17fedd8,8,5,2,28,5,3,08100,1
7a3cb072cdbbbe490af37992f740940c,28,28,1,196,28,0,09130,1
a24788e3fc2cddc2e22db24b1291ebeb,113,57,3,263.6666666666667,113,0,01012,3
468324fa05f8e71d2e7d281285dbf0f2,30,30,1,210,0,30,03070,1
50896dafa05f31b291e15a003ad5fe44,35,23,2,122.5,35,0,01013,1
8e995bc8e2042f6e80231d9e076b7976,516,170,4,903,415,101,01027,4
0c5fae0aeede53d0474f18fa63a99585,15,15,1,105,15,0,05041,1
361152d2995cf9b408065175e8f39315,18,18,1,126,18,0,07141,1
86b6fac3b2ac4e30203cfbef1a40dbe5,421,131,2,1473.5,40,381,01027,4
87f35aa9fc30a5a42f31a5ceb69d71d5,19,19,1,133,19,0,05041,1
966f3924cc3b3de527fdeeb6e0142366,81,48,2,283.5,81,0,10240,2
8e3ce5303d27aeacb0864ea23d8ddf13,93,47,2,325.5,69,24,01201,2
e8026c32f6c8521dd3768aa43a6a7f82,68,50,3,158.66666666666669,48,20,01016,2
8d4c33b33f386e6b02f39b539d334197,178,79,5,249.2,138,40,06100,3
cbc926033ae8df164cec333f241831b4,185,79,4,323.75,185,0,05040,3
d9498a40d1867908930526fe598e199e,25,13,4,43.75,23,2,11040,1
f2be52eec2aa3270ff558c4accb236c0,77,60,2,269.5,77,0,05040,2
519ea815d8e14648be5a817a2f6ef518,140,106,2,490,81,59,03050,3
bfaf98736fc8c0f791b5bf8d9e2cd4cf,206,97,4,360.5,146,60,05100,4
45d74b449045448b0e5f5c104e75e5f2,35,35,1,245,35,0,01026,1
53a49143ed4fe45b58d6b6f37eff9344,44,44,1,308,44,0,01012,1
4c1dc7e6d503fc4cf712467c9ca22183,347,119,5,485.8,296,51,01026,4
65d178e47ea8a36a1d57f6490a174214,41,41,1,287,41,0,01026,1
29eb3840c9cfa2af6cfda42f8b28b344,17,17,1,119,0,17,09010,1
1e6ba845a9b07d2a09fb3000cfb10383,25,25,1,175,25,0,02620,1
00537326bca29d951445cd364b8b5151,72,48,2,252,37,35,01012,2
0f6b82a71f2192a6db191d0a0914e7ed,104,83,2,364,104,0,10200,3
664ba37beb803822358803a5ee924421,63,63,1,441,63,0,05040,2
d9b2e601ea27a5f3ab78009bcdc1fc79,313,106,4,547.75,295,18,11100,4
b3dd9a289af8be67d57df1f48af30532,98,80,1,686,98,0,01085,3
129b259dc3beff9ac59c82470127a1d0,9,9,1,63,9,0,11080,1
15d9861c490e5bb2c8d8a38dfb02a914,40,40,1,280,40,0,05040,1
5b617eba7da703f58533e83c02c320d1,53,53,1,371,53,0,05100,1
825b0f8eb03c59373c3c76e75a27c2f2,226,123,4,395.5,194,32,01026,4
b2775b37943b0245e022f1ce50efd379,22,22,1,154,22,0,05030,1
3ed2d8ef802f071c8d221f0f0f7a2eaf,3,3,1,21,3,0,03090,1
85fa3269d334dbbb1a66a830c028cc9b,96,61,2,336,96,0,05040,3
3827a03f6d6a37046379bc0e4616d1b3,35,35,1,245,35,0,01012,1
a34442bb5766d48fdb1ac5e651a6007a,6,5,2,21,6,0,08480,1
456cebd7c3865fdfa64cb652a1c366be,489,222,6,570.5,442,47,05040,4
68c1a918305b175d90822cd3517edeeb,38,38,1,266,38,0,01201,1
3a30c46202c8d148aaeb9eead3fa31f4,23,11,4,40.25,13,10,05030,1
139c84e9b214b2f8e1ebb6b6cebcfef3,45,45,1,315,0,45,03050,1
d4964792274844f1914ad44c639db3d0,121,69,2,423.5,85,36,05041,3
9a59c74a2df08f277a04317ebd3349ea,394,195,6,459.6666666666667,334,60,01012,4
e6d995cabf47258f4b2cb0e900959416,24,24,2,84,24,0,08052,1
c68e3378c40a2574f6891448a8198196,123,80,4,215.25,123,0,05040,3
c320228127c3dd5e565412f1a3840fee,241,110,4,421.75,241,0,11100,4
a51cefa714222a7e26c2e0d86f5e635f,19,19,1,133,19,0,11040,1
169d3bfb377d39ac9faec2f3a474311f,54,49,2,189,54,0,10080,1
03bdcdc7ca07b66a455cda5030e6f4d9,23,20,2,80.5,15,8,12742,1
070f07a4c8b431275929efa9111d339b,186,143,3,434,101,85,05040,4
b78a73d0807bfc6be058d57b77fb862f,103,73,2,360.5,103,0,01085,3
48a7184df6c0290925fd1c5febbe983e,378,179,5,529.1999999999999,324,54,01013,4
19e618544baea2a7f75959c82ea8e277,36,31,2,126,17,19,05030,1
10e59cf7a3ac3bf5e51df279e06266e9,88,63,2,308,88,0,01013,2
b48b1bc018e7adf6256c06e22729e5d3,478,160,4,836.5,273,205,01026,4
a1654c5302b66933c43706cdfd1850ce,34,28,1,238,34,0,08150,1
b17e2dad2df04e9f800ea7976ae21a10,24,24,1,168,24,0,01026,1
e756ed04a834e93c441714bf3fafa9e1,184,73,3,429.33333333333337,36,148,05030,3
b21fc0f5d88aac69d98f2af96da58387,23,23,1,161,23,0,01012,1
71d0e8c9d8c56b4c874ccc4d963e4b6c,197,108,2,689.5,105,92,01027,4
7bd49ae859a4b1c56c0afb718fa96d68,147,75,3,343,147,0,05040,3
2d46dcd000cfe8975f3efe75ed2046d2,40,26,3,93.33333333333334,40,0,05030,1
530d891a03a9dc41801bdca3389d3b84,125,96,1,875,125,0,05040,3
9187cf42ba2ec0bfb683b1734f91451a,35,20,1,245,35,0,10200,1
be3d9d37ee50d47cf0df06e13dcd66e8,183,108,2,640.5,183,0,05040,3
3f9461aa47e5746f8ae6c3125aefb704,42,42,1,294,42,0,10200,1
fddb9ea8fe615dc56961242a3ff71196,58,32,3,135.33333333333334,58,0,05030,1
38369e802c089be2ef024445f5755275,61,49,3,142.33333333333334,61,0,10200,2
6b6185232621c25050ba621c9b708741,231,145,4,404.25,193,38,03050,4
d0899bd3e6a1eec37f2915dfdcbbcdf9,57,43,2,199.5,57,0,01026,1
1a6953a0afb980c565fd181354c54d8f,121,80,3,282.33333333333337,121,0,05030,3
eb0dd7b7c4d6b9b6a0682901f55aea11,26,26,1,182,26,0,01012,1
9dc2f70e3d56651a52671eae25125c2f,6,6,1,42,6,0,11040,1
a6707e754280837414275d63309976fd,38,23,4,66.5,38,0,11040,1
22bbc97b50cdaaa7e2ad205cd5bc63f0,10,9,1,70,10,0,10240,1
d9034d7d851719b098d206416f4d0392,8,8,1,56,0,8,10040,1
be285bfb4f7f56bb8e975e42be747290,115,81,3,268.33333333333337,115,0,02751,3
b7cff0e4227b845dded8d306ac35d439,251,137,4,439.25,251,0,05040,4
ba87778a1a8ef73f364b7151925c1aff,32,32,1,224,32,0,04080,1
6f20507abb09c257e8fb30c501d78009,23,23,1,161,23,0,01012,1
a5cdc5f412199bb0b64c6feb2c90945e,128,95,2,448,53,75,10200,3
6d41be5837f5e361cb709e7f2d7f1940,200,107,3,466.6666666666667,159,41,04032,4
1d2752db2edec443a9ad72fc27ea5ec2,29,29,1,203,29,0,05030,1
431c7317f38e9acc1451e02409d9c2e7,74,64,2,259,4,70,01201,2
467ced2716705ad9f1dcd6e833f1560f,36,31,1,252,36,0,05040,1
f3c47b6a61c81482fdb31585a8cf52a6,14,14,1,98,14,0,12501,1
a778b2515408067ac358db5f52880086,26,26,1,182,26,0,09130,1
3945f95f891b47b3498b60c9f56a23e4,52,52,1,364,52,0,01026,1
f1184e46207a4c75b362f5df9830eafb,28,28,1,196,28,0,01201,1
27183bd1be5e5294ae75d4af47379396,52,46,2,182,52,0,01026,1
16bef9c7b875061eff6db93c5548e346,56,44,2,196,33,23,11040,1
92ff2b1c0728ddaf688a3d69b1e0cc19,204,101,4,357,204,0,05040,4
f00d888049c677214f0aa1742caaee41,72,62,2,252,32,40,08100,2
1e83315ac779fc89216fe414ada2888c,30,30,1,210,30,0,04060,1
ed46f9d085e37077a11d0b1782b919f5,89,63,2,311.5,49,40,01027,3
3b2e205ce378c5e97da692ae507a8b45,57,57,1,399,57,0,01085,2
598b70e48e7fa169fb942ccab1d40ac0,75,59,2,262.5,75,0,05040,2
47b015915520df7dffb8f3c04d7932c4,61,61,1,427,61,0,01026,2
6d48b020bc1be8711d58325f5c12dd9b,59,52,2,206.5,59,0,01013,1
6e167f6d486f8cf87a12f0e065ab1fd4,125,79,3,291.6666666666667,125,0,10200,3
b0a55e9f719949ae1fa29b69e86cb391,31,31,1,217,31,0,08132,1
0edfb8b67749fc2c7aa29a37f7811434,132,93,3,308,132,0,05040,3
cfa8a59fa3ded67a2a39ad932b7eb3cf,22,20,4,38.5,22,0,04020,1
a70b9c44e36629c139583f663b8952fb,65,53,2,227.5,65,0,04060,2
8ab59ad8298029633260f1677c51f9ad,49,49,1,343,0,49,09130,1
015b8c00ac1668c3c81f733fc9f0698d,54,32,4,94.5,54,0,05030,2
650df44d9d3b81ba843ce870c475f92a,44,44,1,308,44,0,01012,1
64d6686fc0e4d0cb8f43deeaf91df4ab,21,21,1,147,0,21,08230,1
604e0ba09c47666f6d6d915fb0451dd4,120,75,4,210,115,5,01027,3
080bde487af7478aeba5d5910f7123af,9,9,1,63,9,0,01012,1
60791a9a23878741f7a45b0c86cf8281,72,60,2,252,38,34,05040,2
c99242dc499348419606660b76573e10,134,99,4,234.5,134,0,01012,3
913e2ce59d5f13e72dfd12220f04aa00,191,97,6,222.83333333333334,168,23,12501,4
faedf9c1f5cdb33cc7dfa95de35e7a67,38,38,1,266,38,0,03090,1
c00aaadd417c07abb89d14944e8c248f,94,84,2,329,38,56,05100,3
5c57a963d934f862294330787a0deb0c,4,4,1,28,4,0,11100,1
3c2befaf93227e2864237086e1808522,49,45,2,171.5,49,0,01027,1
2cfab67ab81ee67a56e6f491fdb253b6,34,34,1,238,34,0,02650,1
72c0e6d3e044cdbff21d1d29b736098e,28,28,1,196,0,28,12470,1
ba21ae50bb41ba5bdcff87b200441560,450,136,2,1575,149,301,10220,4
0cfe56421e31014ff53601ca13f7bc8d,195,110,3,455,195,0,10240,4
77fabe6ee58c238bd74a27481f5fb8d6,30,30,1,210,30,0,01012,1
debb0aedfeb11b08a0e2c0b255e1c3f2,43,43,1,301,43,0,04020,1
ba52be95edb0e93ffecbc020dfa73a8d,32,31,2,112,32,0,09130,1
169fe79ac2945f916a9df332668b94fa,19,19,1,133,19,0,01026,1
bc31349212eace24a507a8734b2adb6f,159,90,2,556.5,26,133,01026,3
97fde354d551abfc3d6388b51aa3a467,76,67,1,532,0,76,01085,3
8f2c1855dab9c3b6a7cb15e0a4c0865e,24,24,1,168,24,0,12742,1
a1bd099d087dbef1fb347416e690d651,33,31,2,115.5,23,10,13820,1
35ba9020cae8275dff53883807b79681,18,18,1,126,18,0,01085,1
b1c5872f87a91ccbfe4ecb55b8d88e19,42,42,1,294,42,0,02650,1
67f111e6cf1d4ec1035c837fcc3aaaa1,128,94,3,298.6666666666667,128,0,05040,3
36f228e4fadb456b433e7e74de93bc24,106,49,3,247.33333333333334,74,32,05100,3
ac96331937fdcd94b10a1df131bdbf04,247,131,6,288.1666666666667,170,77,06100,4
32004bc6fe5e80cd5c869b2573e8cfdf,203,94,5,284.2,173,30,01013,4
dad8e018cffda3efcea697c13c076bab,32,32,1,224,32,0,01026,1
be4bab1a6b38b650035bf207a8576065,24,24,1,168,24,0,05100,1
58ad6cc2d50b5a3ac4aa362910618722,23,23,1,161,23,0,09090,1
e2a7b9f2d6de4f50bd834e8d093a086d,167,72,6,194.83333333333334,106,61,09150,3
8750530023b78f137e5714b2630c5af9,29,29,1,203,29,0,05040,1
0a65a72461c62b29f142a9d1f2deefd7,25,25,1,175,25,0,01026,1
9195229f9712d5a80bc4bdca1cab4969,40,38,2,140,40,0,01026,1
67a06a45c65f5bbe4b24be8beb134e06,158,103,3,368.6666666666667,158,0,01027,3
a85b44d69657947f5a628ef33581fceb,52,52,1,364,52,0,11140,1
723de193050853cd29212880ad5b0ff1,60,43,3,140,60,0,11080,2
bfee52d6d6c782f5891cb4e81eaa0eb7,17,17,1,119,17,0,08452,1
3612d26ad9ad13e0114c73a2daf97c2c,5,5,1,35,5,0,05030,1
86fab13229f1f6958e454d42fdd06701,81,60,2,283.5,32,49,10080,2
7af834bcb3a6582e947ce84d678612a3,103,77,2,360.5,103,0,05040,3
ae81e493bb36509e00aacfa1210d935c,107,67,2,374.5,107,0,05040,3
b3579d95a5c4a2b830c4de38e36fa997,12,12,1,84,12,0,12650,1
314923aa14e6214d1808dab8c05bd01a,148,76,1,1036,0,148,10240,3
347f23bd74769a2437a96a485d5f9582,329,122,1,2303,329,0,11040,4
065eae30725c7a147eaee954a646b680,64,57,1,448,64,0,08052,2
02b87716b8d4a91a48d9c27323649a05,17,17,1,119,17,0,09130,1
b19732879c5ba881a8c9bfc1851e8783,110,78,2,385,29,81,03070,3
0a4d56ee3304ad651eee5372b3255d4f,43,42,2,150.5,25,18,12590,1
772e69a8b22a9bd74f8f364569862a17,69,58,1,483,69,0,08010,2
da414eccfca4de05e1a585b1fc86046b,27,27,1,189,27,0,04060,1
ac397f88f5d99c4f82f4449122565499,27,27,1,189,27,0,05030,1
550b9fed87a0ff60bd4bbd309b202ec1,48,48,1,336,48,0,10240,1
c2c84717bbb2f36e2242c60a231f8984,2,2,1,14,2,0,05041,1
db8f1a40a15f7a69e224e48e7613722c,28,28,1,196,28,0,09130,1
756fe893aa47e803eea4cf3728620df0,37,16,5,51.8,31,6,05030,1
937a1d7e3fefc51d3d6b10fac989376b,18,18,1,126,18,0,05030,1
203e74d5e7e0bce83c75201357217616,118,94,2,413,118,0,01026,3
d66fc72db8366abbe59365fe01a96f88,86,61,3,200.66666666666669,65,21,01027,3
0dd1e66433ff6e2152e90c31a392dda4,153,67,3,357,153,0,05040,3
6a4da8dc8d9d97dd4477f0a5399687a2,127,90,2,444.5,36,91,01026,3
699108a76214e78b6947fda42ab752fc,81,63,3,189,81,0,05100,3
742032d3fd6edd8498712536611bc811,70,58,2,245,70,0,05040,2
a8170c6f621678d61f9481ec130765d6,363,128,4,635.25,363,0,01012,4
9c9be627042b3dedd1d844b5debb4cf6,17,17,1,119,17,0,05040,1
34439118922fe02439d26059e9692c37,22,22,1,154,22,0,05030,1
e475f5b47e802803118ab7c64f1025c8,19,19,1,133,0,19,05040,1
f19622143ed2d4a45c6b3908e6d9bdef,24,24,1,168,24,0,05040,1
6af22f861b9fd8fab62416bb141f06fb,29,29,1,203,29,0,01026,1
2be93c3d08aecd6ad6f79b50b6e4ba65,15,15,1,105,15,0,01012,1
bb77810d70af35ecc1fa4f6b7c4a6114,267,135,3,623,267,0,01027,4
16835eeca0906ac7aa53f751fb013332,63,45,2,220.5,30,33,10153,2
43bae4d968b9bf6287718006a90d1698,5,2,2,17.5,5,0,11080,1
04ed9e318acfbb205b14de6f86a0e219,28,28,1,196,28,0,02620,1
9192eccc4347a1a4d1f608d0502d4809,26,23,2,91,26,0,05030,1
e1600dd095648182be8fd001bc5a16c1,29,29,1,203,29,0,05040,1
36384cc3861131750ddf8481e1c9fd18,220,118,4,385,185,35,04020,4
daeed5b48b1abd86bde218b748d422b6,9,9,1,63,9,0,10281,1
114b32b6a417cfeb162422ca32dc6e75,33,33,1,231,33,0,05030,1
1760e46cea0a554e148cc0e481edad68,121,82,4,211.75,102,19,10200,3
67e87f339b0796f6a659f315992aefba,7,7,1,49,7,0,11100,1
e7057c21bbfcc7b07112d3067687dfad,63,45,2,220.5,17,46,03070,2
7b4058804f8cab879000fc43847f4be2,25,25,1,175,25,0,09130,1
0f8a2208006403479c0b6ced8119ae95,49,37,2,171.5,49,0,05030,1
868250bd093c120582984d4d093d3432,86,66,2,301,44,42,05040,3
d24710fd1d55fcec1288654198f3adb4,37,37,1,259,37,0,13820,1
cba305176155e8f8de02d426a8f74a13,246,75,2,861,246,0,05040,4
698889efa61ba51ef567e79518bdf94f,191,85,3,445.6666666666667,191,0,05100,3
a1179646c84e10ae5bc3ff8b58028e97,10,10,1,70,10,0,09010,1
ec0bee50dd3cc07ac824614377d37d3f,19,17,1,133,19,0,05030,1
30e851720726454a44c774d50ae487ff,82,69,2,287,82,0,05100,2
7682ceba7e56e82c221aad6be4cc57a4,331,106,3,772.3333333333334,176,155,11080,4
8832abd046013f0c8729c653a6a3fb52,141,79,5,197.4,83,58,04060,3
c8b9273bbd341553834fc9dc4156e98a,20,20,1,140,20,0,12710,1
b0195194a9fc5c1ed300b48d8cfea8f5,194,104,2,679,194,0,03070,4
af71abd9fe643da989a90f263009e358,69,46,2,241.5,69,0,09110,2
5bc195b0c6afa461d6838a3a99dfefc1,187,80,4,327.25,187,0,05040,3
a121972b5c88c837b97c89f49d86a08a,56,46,2,196,56,0,05030,1
cc3b168d469a1909314c05b3497b6371,93,88,2,325.5,93,0,09130,3
abcff2b37e6451257c92352cc97f83b8,77,65,2,269.5,40,37,01026,2
c937a2ffc2e670c1436e16cc758baefa,16,16,1,112,16,0,09030,1
78c54678ce22da63cc15d130d138ad8e,32,32,1,224,32,0,05040,1
8e04554fde3360661f40563cab1eaca6,39,39,1,273,0,39,09150,1
c21d8791681732373be4a9a2db608dfd,14,11,1,98,14,0,05030,1
9c9aa0ec4a75706f55704d94cdc1caa8,96,72,2,336,47,49,01026,3
33858a3d54c3d881abd42a984abb7cf1,10,10,1,70,10,0,12501,1
337305ee5df0463c929d977c13344614,27,27,1,189,27,0,01027,1
b55f430c06e9b35bf9c5f22fe26b635d,6,5,2,21,6,0,11080,1
520ce23c73b09d448e317d396c22cea0,417,133,3,973,157,260,05040,4
8c9ae651aa282a54875c0366c226fbcc,276,104,2,966,276,0,01026,4
54fee37f5bf444f0707230c14546d745,14,14,1,98,0,14,05040,1
3a725d459fa424ac83963486877d411f,5,5,1,35,5,0,05030,1
40316821b00b84d26346b0de0b47f36e,48,48,1,336,48,0,05040,1
f9b2b419d98a70d7b93bc26a6581a230,9,8,2,31.5,9,0,02750,1
2b4da4faa0dc63aee46f923d2545e6eb,48,42,2,168,48,0,01012,1
8cec46089d699699ed97d94f548471c0,72,66,2,252,30,42,01026,2
854f3c15fec6b32a07dde6ecda2f0f35,138,100,2,483,138,0,02690,3
4ce8aa6fba2533f70186b3e5deb2d773,24,24,1,168,24,0,05041,1
65dfc26e671a5a840a74d5bccccb810e,111,68,2,388.5,16,95,01012,3
700700215fc0808213ea8d6e2c3d97db,155,119,3,361.6666666666667,155,0,10240,3
ab9240bb81fe761fd730757311b4dfdb,64,64,1,448,64,0,05040,2
b27e42905d630c03845786afa0692133,16,16,1,112,16,0,13830,1
ad822db84d3965942b2b8966a0ef6e4a,28,28,1,196,28,0,09090,1
32303d069e6cbaf6038c1e24dec1d0e8,71,64,2,248.5,71,0,02650,2
e4cb512f9868b43489658ff26ede9847,137,83,3,319.6666666666667,137,0,05040,3
be97df446401b14e926b765deeff0cbd,2,1,2,7,2,0,12470,1
2dc6ca36eca7e50961b508428cf62445,15,15,1,105,15,0,03050,1
cc5f1f7ecf9be6b2625fd1f72a080169,40,40,1,280,40,0,01026,1
d9351ea250f4990362acf5e9f80eef5c,208,107,6,242.66666666666669,174,34,02691,4
ecc49b015eca78ad70d39a1bbd13b773,101,43,3,235.66666666666669,101,0,11140,3
69872489b37d9e9716aa0e6289769258,14,14,2,49,14,0,01012,1
1a0673b5f0a365e4d29f4b21bbf2ba28,19,19,1,133,19,0,13830,1
8696c4d10a43604f6dc51b1c8825ab5a,8,8,1,56,0,8,08230,1
5374f908d2139a8443d9959a01edcb6d,30,30,1,210,30,0,01027,1
d49f47d7a4cc86a549ed34f3d56bcd75,18,18,1,126,0,18,03050,1
57f12a16064467dc168f0b36c953b362,32,32,1,224,0,32,09130,1
479279f3f547aeac406e1e98b570056e,30,30,1,210,0,30,01012,1
490f3c8a555eba0c3bc81b5aa6f94c3c,128,83,2,448,128,0,08230,3
1e666f708c2cca58670f9a884649bbfc,49,40,2,171.5,49,0,10200,1
71a7e489a64189ec807194fe1726b057,25,14,4,43.75,25,0,05030,1
0bd319804b276dd3bf1c692040277314,60,35,1,420,60,0,01026,1
c11ff0bb2bb5ce17182631eb30a843ce,70,53,2,245,18,52,11140,2
ac7606347ad25478eaaa9825b703d65a,40,40,1,280,40,0,01026,1
17ab8ef72bbe57e09be658152d5ef3f3,18,15,2,63,18,0,08051,1
6dfe9e827c38a227c6e6b6880cdc61ff,83,56,2,290.5,83,0,10200,2
920a7c205cb8559b9276000aee01de90,55,46,3,128.33333333333334,38,17,05100,2
97bf7ddc7cb739ba0dbd375cf3c1b5ef,43,38,2,150.5,43,0,01012,1
1b1337d26ecf9585587f7f6db4090c4a,64,53,2,224,64,0,05041,2
eb50b46c930152a1c5b466c08aaf6bdb,15,15,1,105,0,15,05040,1
0afac0925f369de611c3e47d6dbd4648,82,68,1,574,82,0,08052,3
79c66677bafa8e25bb5c75ecbe22fa20,4,4,1,28,0,4,01201,1
b33a6b1b3acd696c74127d9c90e23d65,28,28,1,196,28,0,09130,1
a73324290c805728cb4598d8ec95ac41,8,8,1,56,8,0,11100,1
1ffaef44a242612b518523d466fb5a92,52,44,1,364,52,0,05040,1
c530be18f5a49ab3d9fb28cc255b4db4,13,13,1,91,13,0,03050,1
b521a1a67586f377339a22ef39eeb883,151,76,2,528.5,151,0,01027,3
028bf17d4a7df45e30177ecaa51ab468,127,67,3,296.33333333333337,127,0,09030,3
2cccd1a5f6a3d2420cc0e6ceeb1e8523,35,35,1,245,35,0,05040,1
8a68e9477c9bd3499c44b182435ee539,97,60,2,339.5,97,0,01026,3
9a1b1cb231859eb2922ab4dcf4fa734f,86,54,2,301,86,0,01201,2
d97b99f6d0b68bc6978860a0b847db75,51,51,1,357,51,0,01026,1
1b6ea3b1424c9aa712039da639ff88dd,30,30,1,210,30,0,10200,1
448dc9765b18b7f96aa32a70322109ab,431,108,1,3017,431,0,08314,4
ada6d91a5202c8e3179d06d57fe69a14,135,73,4,236.25,135,0,03033,3
ecd9799fcf42532c27b818f5ad2e6a86,19,19,1,133,19,0,02750,1
c464d6089249f644eaaa6d72379396b8,14,14,1,98,14,0,11040,1
5ec58a3bd614832200c3e385279ae539,68,52,3,158.66666666666669,52,16,02751,2
6b9ddba8ec8aa28870d514282f35c162,14,14,1,98,0,14,05030,1
a3e41502d5db5d3130c5d77b38dc447c,78,54,2,273,78,0,01085,2
36101a2c238246b6fdeb50d7168f5a3f,20,20,1,140,20,0,10028,1
eadf7f6216f4d48379877f58402fb6e9,68,54,3,158.66666666666669,68,0,10200,2
51637b80f14e3b69f438cb2ab404f7eb,259,100,2,906.5,259,0,10200,4
f47506d035f012d6a84ffa555e0c9a14,16,16,1,112,16,0,10200,1
5656603cf1ebc819366f3ea8f297e67b,194,98,3,452.6666666666667,114,80,05040,4
2fad145dc8acf82dc15a01678ac13b65,281,137,4,491.75,281,0,01013,4
f7073d19a35a0a0f67089f34b7480bd9,35,35,1,245,35,0,05040,1
5af8e3e4a57dff79859cd222374eb7b4,37,34,2,129.5,15,22,09150,1
aebe70017c17035eaba7644c123062f8,232,146,4,406,172,60,01013,4
d9ac7990d8bcfe9e2f3fe0da3be1c257,70,45,2,245,36,34,11080,2
25625da154705d47c75b7dc7ac12fae6,285,207,3,665,285,0,01026,4
adcfa7af34e2d869acd5c44eb97e6770,232,95,3,541.3333333333334,211,21,06100,4
fa0c680221e79226ac2897339a87cdff,90,48,1,630,0,90,05041,3
c15035e058fc3c86652cfd5f776aee71,26,26,1,182,26,0,05100,1
4e938cbf1cea3a1a253a886cdd84c3c5,21,21,1,147,21,0,01026,1
e05ea2d54f860bae03ede664a0b3e55e,17,17,1,119,17,0,03050,1
b98627f7b867d58544e518e28ddc3d94,701,155,6,817.8333333333334,528,173,08314,4
2353146d8e41b9620132280a9002018e,65,53,2,227.5,65,0,08010,2
277c3e747080dc168685e030b8e1bf49,64,54,2,224,64,0,04060,2
8931db187d1bee788c53257c87a575ea,12,12,1,84,12,0,04020,1
55b94b41e31d99a15ae938b05d9dde3d,65,57,2,227.5,27,38,02650,2
bd483a80463db124483716dde3524761,146,103,5,204.4,146,0,08090,3
377f667fde3db43cf99bb93d2e4a2116,96,76,1,672,96,0,08032,3
f6ac166ad13f698beb365026ce082995,112,84,3,261.33333333333337,112,0,07141,3
8df5fd1c89177d6ca17843ec0107b369,10,10,1,70,0,10,01026,1
10fdc6555d99563669e2e9b377b2f336,50,50,1,350,0,50,01027,1
93da04636244aa5c9c85df5948931b60,76,62,4,133,43,33,01026,3
33e18b88b9f280410c7e5bd718c36894,53,53,1,371,53,0,05030,1
1d033078e50e25c629372f8ae06bb225,137,102,2,479.5,58,79,01027,3
8ebcfb2c82137280084dcd94c096309d,42,42,1,294,42,0,03070,1
40859308b0db585df9a2e6da434583e9,53,53,1,371,53,0,10200,1
fb3735d02e4594236a170e7b98220a29,53,44,2,185.5,53,0,13930,1
2683780ff4de63abbeb723801e2497c5,41,39,2,143.5,22,19,10200,1
124abadbf15dca8db42972ebd1052590,33,14,3,77,24,9,01085,1
d32797ec1bae869dcddbbbd7319322be,27,27,1,189,27,0,13830,1
82fcfa3e84af2771c9810091f58a9e85,90,61,2,315,90,0,09130,2
2452a6dd0915fb81875d9974d9c77f12,4,4,1,28,0,4,04110,1
488136d0995dce4769706f858acff0aa,255,125,3,595,88,167,04020,4
75a478160807aca9ff004c0aad1df50d,51,45,2,178.5,23,28,01026,1
e6ccf004534b653d36027a1228a332b4,68,56,2,238,31,37,01012,2
59096c3d271e3a73aa7c83c8e30c5633,22,22,1,154,22,0,05040,1
161ca874f261bedd7f17b2375893c21b,203,121,2,710.5,203,0,05041,4
4eceef30b9889c42c34877089d15e2e2,32,32,1,224,0,32,01012,1
39b0cd5e4ee43a32c4b5ec8b4f675fd9,64,61,2,224,64,0,01027,2
ae02f202d97adb934c414e5c22d43735,33,33,1,231,33,0,05030,1
42b0fffa2260691dff16f2369194de2d,20,20,1,140,0,20,03050,1
5203e783e7d04b1380a6cf8b7ad18231,106,71,3,247.33333333333334,106,0,01026,3
8bf158a568f853bd58d5791895bbb5fd,85,51,1,595,85,0,05040,2
b7806d07a9ef0fac4548140ff2347737,13,13,1,91,13,0,01012,1
2e88d5cd73d5b3f32587e38d6ba04f9a,57,47,2,199.5,57,0,09010,1
2ce91fde0461028eda44794772e0d10c,46,46,1,322,46,0,02650,1
51c3fc6fb36c8e8be911c970174074ae,17,17,1,119,17,0,01012,1
3eef5bd2f37878654ab92958ecfaae3a,64,58,2,224,64,0,04060,2
24a2dc56db5b39a11cb6ca1b2868fd32,27,20,2,94.5,27,0,01085,1
c543eaa83d1d959a3c1c9baf44b189b1,248,132,4,434,248,0,05040,4
0226597d999fe50ce62a687b1eb2655b,179,122,3,417.6666666666667,179,0,05040,4
61e3a712c9e778381779845e767c2699,211,114,4,369.25,211,0,08314,4
0efeadc251f3d33cb78205c02717e1b1,359,99,2,1256.5,276,83,05030,4
f7c2de3cdc84e516fdfa7d7a68abee38,140,93,5,196,119,21,11080,3
97c16251e03f5e890cf26c38635db932,30,19,3,70,30,0,04032,1
ee2ac15adf19e22dcb2a88378e3a5786,323,167,4,565.25,304,19,05040,4
f3904f93a464a87cae5da8725fb27240,77,58,2,269.5,77,0,08012,2
e52c2bfce41a25e6a8e56ae66709d3f8,48,48,1,336,48,0,01012,1
6b7cdec33563b7524d56fef8e5713ecf,63,63,2,220.5,63,0,04130,2
35bf8b5f32694c550ac7da088c9f4809,54,43,2,189,13,41,05040,1
a1efda83ba0fe8022f51ddf38115a3ba,32,32,1,224,32,0,01085,1
0eb64a78ae7032380a0200686e1e3f3d,119,85,2,416.5,119,0,11100,3
6f2340fb74cc402b21acc8e9fd01b042,142,102,4,248.5,73,69,08090,3
f29cd2fad74690c3c1eb4fbb74fd6916,160,79,4,280,141,19,08090,3
74d1ad6cd4c129188a07bd6ee7aae17f,21,21,1,147,21,0,13953,1
468bd4020474bc89167521a9a22236d0,107,85,2,374.5,107,0,05040,3
2fda43a6fc99a242b98c25737394f941,28,28,1,196,28,0,05030,1
f0686dcf8ed05cef8b9bcf03c7e0f6b4,9,7,4,15.75,6,3,11140,1
3a701878c8f0487c328b899afc4cf093,132,70,4,231,99,33,04020,3
dfedfb5f3345ce90a30f49ea4737ffb2,58,58,1,406,58,0,09130,2
561c71d33086018e2ddb764232bbd7a2,7,7,1,49,7,0,11081,1
1412f7c9457947dc6e361809d3f3a4b1,119,63,6,138.83333333333334,102,17,11141,3
2f9a25cb5633d0c29115ecb2c6e55ff6,37,37,1,259,37,0,09130,1
690397ca91a781c70d093e5f5b9d2dc2,11,7,2,38.5,11,0,10220,1
c5d7965db6f0c1d6873748757a7e98e6,12,12,1,84,0,12,05030,1
23e6e4910194b4f89bde545ddfb394b8,52,41,2,182,39,13,01013,1
8b1b0ecdaa43ba814da65a71a0458eae,24,23,1,168,24,0,11040,1
e8d2b70d24409863b539ec00e81cdeca,176,90,3,410.6666666666667,176,0,11100,3
425916816daba97be776f64f1150f984,33,33,1,231,33,0,09130,1
c4340364bc02a2225c920053331a51f6,51,39,2,178.5,29,22,05030,1
1021ac81261f41603d29dc2729fa0ed3,26,20,2,91,26,0,05030,1
3c372def0c465799f2eb2ab86a5087e3,145,81,3,338.33333333333337,100,45,01012,3
7061f432235b3c72327ab5eaeb7cb664,49,39,3,114.33333333333334,49,0,01026,1
49c42093e785fc581773dcb5667ec4ed,112,54,3,261.33333333333337,58,54,10200,3
16a5d98a7847fc97cb813a81285d97ab,47,45,2,164.5,47,0,09090,1
161dc1379006a0c2bf2e2d0906003148,80,43,4,140,67,13,04020,3
57eea8e23100910d7a77f1cfd6a988a1,2,1,2,7,2,0,11080,1
abe1d3045a43432fc93fc47602cc0a24,72,50,3,168,53,19,01027,2
ec0b781f151f7d077bcb76ad5fae1f33,15,15,1,105,15,0,09010,1
6a0a70d2e27b47c36213f995f4783362,14,14,1,98,0,14,05030,1
66389a309af6caed038fdd992b08fc2b,40,40,1,280,40,0,01012,1
fc43589447a4e968c1d3fe4aea5e73ca,120,93,2,420,120,0,01026,3
a38aa5e4ebfbc6ae12891fb669cc2ce3,33,33,1,231,0,33,01013,1
b1bba1ff1861bb71e1272eb692cda0df,198,78,2,693,27,171,06120,4
38b430269c38b06646769708d7e296cb,43,33,2,150.5,19,24,10028,1
60c6db97d4b83bd59f9826f92c37a9ad,254,135,3,592.6666666666667,254,0,10200,4
09932e4c84d7adb3e86b914fd5d3505e,59,51,2,206.5,29,30,05030,2
a91ae429add77094a2aeccbd151d70cd,49,44,1,343,49,0,08052,1
6e981e6b187938066bf2df7003065662,29,29,1,203,29,0,03070,1
f7b0bd06091adfb7e187c4f1311da04b,54,33,3,126,54,0,04080,1
4d940894ade0dd4ab0809c7a6b7bda91,217,99,5,303.8,191,26,10200,4
ad69e9b716e34cf4833ec3c9e898ce2d,61,46,1,427,61,0,05040,1
1f96400ef524203196b3163ff0396a5f,383,145,5,536.1999999999999,319,64,10240,4
d794c629c424aada0e432f4cfc234fb7,40,29,2,140,40,0,11080,1
76b28d3bce41eac6891836a4bb163b8e,31,25,1,217,31,0,01013,1
f1be6e539e69f3385116becd7f9aa0f0,80,58,2,280,80,0,11100,2
15976d25a0467520627e30d795f1e67d,39,34,2,136.5,39,0,11100,1
4ad0523a82e899fb5b3c06ed990a4ee1,19,19,1,133,0,19,08314,1
6ba7ab6e8f0a60ebfbab85d1e3327457,219,98,3,511,219,0,05040,4
c7231010107e5f54d6c06fe48b7ea449,47,38,3,109.66666666666667,33,14,03070,1
523c0742ef46c7b8291554316c3884b5,60,54,2,210,60,0,04080,2
34e91605a081dc92b819293a4c31896c,255,117,5,357,230,25,05040,4
7e23a0dd5a197928c9b0bf58ed8df071,29,29,1,203,29,0,05040,1
a53778f14fa69bc3363105f2ddfa9e52,167,98,4,292.25,123,44,05030,3
0aa1fe2a06d57b41f8424f063c98867f,280,131,3,653.3333333333334,280,0,01013,4
01da301552bf05066725bb2261508150,197,121,2,689.5,197,0,01026,4
097009c2157ef9303ea3552de677c90a,250,117,4,437.5,250,0,11040,4
e32e1153b765d0e9c20ed018cfa1d7e9,36,36,1,252,36,0,01026,1
3b3192fecf54f72b49b324b11c9fff7f,36,36,1,252,36,0,13720,1
6d808a0fc85f19d45bc635cc8176d83a,85,57,5,119,85,0,11080,3
696636e6f1b78a0e70b9d7f4217e82d6,11,11,1,77,11,0,01201,1
5f268aa99ead519461ed3dd4e431fa58,14,14,1,98,14,0,04080,1
d833eb2e4d4e0afa69dff9215a31061a,23,23,1,161,23,0,09130,1
d749bad3186be95e729ff0ca51c2f6e0,7,7,1,49,7,0,01027,1
c09ad67a5296e6f9e54d1c04dc880d2f,89,61,2,311.5,89,0,11100,2
6668433beac2a393d52d28f61f0f56f9,25,25,1,175,25,0,01012,1
fdb65cf0b1f049944e0dbca69a473b1b,37,37,1,259,37,0,01012,1
2209be3f9251ea4d7dcccd2bb975a462,26,26,1,182,26,0,02650,1
3eb14c8840ea54f3c3fbb0c839127cbc,89,88,2,311.5,32,57,01013,3
9f8271a75cb4eec26b0c4019443a3cfb,310,150,3,723.3333333333334,160,150,05041,4
89bd7f3ba399ce51fee9f56800a0b641,301,147,4,526.75,211,90,10261,4
6aa8847956beb51223998b47f12c147d,137,87,3,319.6666666666667,137,0,09130,3
6e5a327650ac2debd2b417813a7664e5,124,62,6,144.66666666666669,106,18,11080,3
2763484b7eac90e57a88e13c871adf2f,8,8,1,56,8,0,03090,1
729b7bee71f7e6c456ac4e1c0b95a5ab,399,149,3,931,367,32,01026,4
2434e96766087a9bb75f3a5295a15e5f,166,71,2,581,166,0,05041,3
79569f0ba2f93f20a4e9f32953b0e9ee,128,98,3,298.6666666666667,98,30,01027,3
123c18d78fa1ad8dedd675b57ffd320d,229,93,5,320.59999999999997,205,24,05040,4
20d8baa5bd436734795c57cf4a154f0f,81,56,4,141.75,81,0,11100,3
9c0c564dd536d2b0bec0d1aa304e2116,69,56,2,241.5,69,0,02620,2
347301eea0581c928f8d0c6f7f0cfad4,51,51,1,357,0,51,08314,1
9ca358ea66346f19a9d837f3b8aa68be,111,75,4,194.25,111,0,05041,3
00c4baf60b8075463725910d1bf60ff0,446,134,4,780.5,363,83,08314,4
ec77040bdc025bacf4272ae0af4f34d9,137,83,4,239.75,119,18,11040,3
e16390b820fff75653533ecfaed784b1,155,78,3,361.6666666666667,91,64,01085,3
9933b1aad12535b8e131f6c229309ec8,78,70,2,273,78,0,01027,2
d090c3b690832e1147ee5b952c961cac,30,30,1,210,30,0,09150,1
3ac96507cd31dde7e322d5fe46ec920e,49,43,2,171.5,49,0,05030,1
ac32b9daa507e80327b710ee1a42de97,357,128,2,1249.5,326,31,05041,4
b72e25613bf12198f7c83cdb9214fe1f,180,96,2,630,180,0,01026,3
9394d53b79d0763391159ee6f23525a7,49,39,2,171.5,25,24,05100,1
e2f7c59cc296113d08fe24e65de0aa75,58,44,3,135.33333333333334,58,0,05041,2
edea92a5ed6823e7c3eaa2a309a818d6,46,46,1,322,46,0,09130,1
c79f5123233545ba4634eee9a594e942,110,74,3,256.6666666666667,66,44,05040,3
3763a3b4b27580d3699a9a99796124ac,23,23,1,161,0,23,05040,1
3fc56e23c1871ac274bc10e7b996b8dd,123,62,4,215.25,90,33,12650,3
bfdd2e0acff65266950c12424632db66,223,119,4,390.25,166,57,10200,4
ff19527d278e13cf30d2e5b2410aeecc,10,10,1,70,10,0,05030,1
519324ba65cbb95b69c2b14e441b3bad,66,66,1,462,66,0,03050,2
b84b39778b2f04a3e8e8f047f0ffce42,35,25,4,61.25,28,7,01201,1
849a0de90ed327b67233a3b768adf791,85,57,2,297.5,47,38,01012,2
c6f5fc743919c1b467e91cd86482cdd7,16,16,1,112,16,0,01085,1
2a0d406e990e7edfffa1acbc0ff3a8b3,83,41,4,145.25,43,40,01026,3
21bf5b7139b6f1bb52cbb71392c8bf0e,144,68,3,336,68,76,05040,3
36238c0bb0f8eeb50ca8d84491cac077,13,13,1,91,13,0,05040,1
71a905345e62c28d7006606c52a3338c,145,79,3,338.33333333333337,111,34,05040,3
a6b5c172e0c7befe7c5fb23ee7ac5d60,161,80,4,281.75,124,37,08010,3
70bdf0bc02eb9ac3f390a3610dbbb6fc,17,17,1,119,17,0,10140,1
724ffdb29e4417d1b5787797402a7709,88,68,2,308,88,0,10200,3
6d5d7747e8bd8e70f314f2a60b214bd3,193,102,5,270.2,152,41,01026,4
1d0533eee12df93a1cda58826746c886,742,179,4,1298.5,366,376,04020,4
0db7b6d080d98b66fa75383e626418fb,40,33,2,140,40,0,08010,1
0427cffe085b77a0e961dd24fa75d214,1,1,1,7,1,0,11040,1
11f371beb3be20eec0dd101d61b71255,48,48,1,336,0,48,02650,1
0f61b3be0dc38455defb28b440b92e15,49,49,1,343,0,49,01027,1
3db1d18e696b945cd467d1a41f4429dc,9,5,1,63,9,0,04032,1
a8aac2a9e239614cfe4a0f7a31770e12,32,27,1,224,0,32,05041,1
d83d37b127df7dd9376502b926bd1d53,23,23,1,161,23,0,05040,1
4f0c2fb3b2373c0febe7938e3dd25362,90,82,2,315,35,55,01201,3
88ce1f8cc2132beeb600ac17d5e02fba,26,23,2,91,26,0,03070,1
8868149b908aa5dec4b475c030b8b1bd,152,94,3,354.6666666666667,152,0,12500,3
a7713d480b14e59a6bfc0568a36d1dd8,60,60,1,420,60,0,03070,2
a90beb1c1bc997965de144168e03bcbd,30,30,1,210,0,30,01013,1
88bf3e0049103ab292246fdb966fb367,5,5,1,35,5,0,10240,1
f59f68c81e3558469e303fd19c1141ba,73,60,2,255.5,73,0,01012,2
692cb0f624423733b52af9f9739369fd,96,81,3,224,69,27,09130,3
4d6e4264475bfd8aa3ce5ce7c7a896e0,68,68,1,476,68,0,09090,2
e12b73b24d9e2277a7d82898aa7c78b0,109,56,4,190.75,109,0,01013,3
f0d55614976c20f8e48f2e6a67a35eb0,17,17,1,119,17,0,10200,1
139531fccddea33207c8f437bcec9369,141,91,2,493.5,97,44,01026,3
edca8c86d3b6667444633ef7bc3ac88f,35,35,1,245,35,0,03090,1
060da050114b6ceff1370c6b8ddeab9e,87,56,2,304.5,87,0,01201,2
e0a20b15da2b3d07465f5b73078c4a24,68,51,2,238,34,34,05040,2
1dc30db2cc090b6f0bb52e444fd3b33f,199,105,4,348.25,164,35,06120,4
2a710ab7ace9b41ac0845703aef388ad,79,69,2,276.5,79,0,01085,2
06187d9870156e026bfb70d957e8f23f,188,122,3,438.6666666666667,188,0,08312,4
daa694a2176b38aba06d183a70275dfa,28,28,1,196,28,0,12710,1
31ba8cf846c04822e8e903d8a32ca52f,291,115,4,509.25,291,0,05040,4
3cecc384f34eef79a3f9bda0d2097200,141,102,2,493.5,141,0,10200,3
9a3536c8571be71b41fb13ce9e90c5b2,164,116,2,574,164,0,08090,3
d7073b6e54e5d0e3ebe151208e753b61,55,48,2,192.5,17,38,09130,1
572d0d81d4dfefd3ba864d0c28e79c0d,38,38,1,266,38,0,05040,1
6e42df3fca20bba21d8c071de5b0a4e9,36,35,2,126,36,0,11100,1
c46f1c4dc8020e51726972602b1cb6a6,40,40,1,280,40,0,10200,1
5b7c5bf51c26eef8bda6066bb10eba96,317,181,4,554.75,260,57,01026,4
f7817325657311459b5147ab28c21681,186,95,3,434,186,0,05040,3
3e1f8fc4ba241cac063e86bc5a5d9c31,39,39,1,273,0,39,09130,1
afa082d1b76a572ea3536b84c7f315b0,68,36,3,158.66666666666669,68,0,12670,2
e64f52e58b1ccc62ff31d60e0630be77,32,32,1,224,32,0,02650,1
c71400473c1d647818fef323658a043b,65,46,1,455,65,0,07131,2
f717204fcce63fbdbc6c93969fc94eef,78,78,1,546,78,0,05040,3
90e8d678c5b047376d0e343010eebb90,27,27,1,189,27,0,04080,1
466bacfa7f9967575d5769437d73dabe,102,66,1,714,102,0,09130,3
5c1898d9e6e6c578b38a93c6492c2450,235,116,5,329,203,32,03070,4
4a51c9aad8b0dadcd70a3508739a3272,9,9,1,63,9,0,11100,1
e92a4e8dcc2c2aa2e0aebfb5959230b9,34,33,2,119,34,0,01026,1
c998b8b85cee33e336d698604b505a4e,83,58,3,193.66666666666669,83,0,05030,2
e806884c3617c46b77c1dceea965008f,155,121,4,271.25,155,0,01013,3
27d757979b844d6272c28861f445ac8a,170,98,2,595,170,0,05040,3
d2e9bf36a1089b05ec3d080eff93c081,8,6,2,28,8,0,05030,1
098fc45bdbd17938ebdea356a468f592,50,31,3,116.66666666666667,25,25,11040,1
d7ee8ba28f1da785f3c6ff2bcad746ce,28,28,1,196,0,28,09351,1
6f871e43891d326dd591720403f3e033,9,9,1,63,9,0,05100,1
536aeb1cb9fda32650dc4fd975c661ee,137,87,3,319.6666666666667,137,0,05040,3
35466e7431019a12786f4fddfc6682e7,398,101,2,1393,330,68,08031,4
1a3f26e0aee0d2863d88ba3b9a230ddf,70,57,1,490,70,0,05040,2
86d1fe5c0e7ac48ef07e222a67606c5b,143,59,2,500.5,143,0,05100,3
3673975614608f4aa30bac2feb020d75,160,96,4,280,117,43,04201,3
4a7a67ae63154b81a4a2f628485fb43a,46,36,2,161,46,0,08230,1
5a1e3667a3e628765aa771fccfd2b3bc,167,90,4,292.25,167,0,05040,3
3fbf85662f21bb1816c2492c1d45866d,27,27,1,189,0,27,01012,1
39d40656a72a645e1961dbec81219fa7,23,23,1,161,23,0,01012,1
64d366c43cd4d35f22623198b4797c32,73,55,2,255.5,73,0,01027,2
c04953e94a56cc03e121b304df06a8da,44,41,1,308,44,0,01026,1
b3fd020a7027675ee5284a42d6568ec3,87,72,2,304.5,87,0,09110,3
ade0bd603ed29442d7d62a98bdc2775b,26,26,1,182,26,0,09130,1
e19d79b5b52feb6af710897450b15e48,99,74,2,346.5,99,0,05040,3
8eff405c5fc82fcef04db76af960bd50,44,43,2,154,44,0,01027,1
189e0da417bdf75b2a3a222a163c3684,218,93,4,381.5,196,22,11140,4
c7ded3b3427cfddd9eb542687a79a8a1,18,18,1,126,18,0,01013,1
d1948df12bc1e92da9d211efc2036afc,9,9,1,63,9,0,05030,1
da2e1f8d4858e6cd7bbc5ab1ee3701e4,4,4,1,28,4,0,09030,1
e62f60cec0568c91e3d970f6bdff381f,32,32,1,224,0,32,08052,1
22a4f83f828e6e40dd01638bb45629b7,16,16,1,112,16,0,05040,1
3aa312fd483ed878b1a0282aa35811c9,230,113,2,805,41,189,08010,4
824a90cedf7d6c129552e40fd0c37230,25,25,1,175,25,0,05030,1
6eee959916c0addda0d82a0d1d129b0f,125,66,1,875,125,0,10220,3
e8276bb00b072f8f1fbdf2c8ed52e667,224,107,3,522.6666666666667,224,0,05100,4
bdc47a3212a1a3ba50f6f7c5a1f756b0,13,13,1,91,13,0,01027,1
b40b3f2b6cc9e4deaeed992f57bad772,51,43,2,178.5,51,0,04020,1
481736c61b14a9f1044b64f19755988c,26,26,1,182,0,26,03050,1
9306a0eba5dea7bd1eb1c681d8df9b98,42,33,2,147,42,0,11100,1
ba899274d0df68cc65ea1dac42925e1e,45,43,2,157.5,25,20,02751,1
181ac506d3f53fbe78070b7022fd15d6,26,24,1,182,0,26,05040,1
2130877a6afe5e030e556659f64829cd,57,52,2,199.5,18,39,05040,2
559a39ad36d842926e54d9f2851853d3,134,103,2,469,134,0,08314,3
e24effc26ca2a0ec116a48b0135cbfcd,227,114,3,529.6666666666667,227,0,05040,4
66f2fce20961ddab76c2932efa826b9f,40,40,1,280,0,40,05040,1
3b1922f91daed84dd1f379d18cab03b8,157,99,3,366.33333333333337,118,39,05040,3
ddc5f130e4ca3f6a6b42b82508c5e622,85,57,3,198.33333333333334,85,0,05030,3
b43b20be96abdba9b252229bdef8838c,8,4,3,18.666666666666668,8,0,11040,1
591c5473e2e749b6ff97edfa79a89d66,6,6,1,42,6,0,09030,1
f1af757aa018cca5a93f9d07ffcd9f4a,72,49,1,504,0,72,01012,2
f1ff4f5499b9d390cfcb9be947e8a308,482,170,6,562.3333333333334,398,84,11100,4
6068723331e11ab6b7df90ab920f951e,13,13,1,91,13,0,04031,1
8aa7158bd2e09631c9eb8bc8807272dd,72,61,2,252,72,0,01012,2
f9098299a0bed2f3758a843008717165,87,69,2,304.5,32,55,10028,3
f1129b4007ccdf863c3c3c176ee4cb96,14,14,1,98,0,14,04020,1
ac5d8c0ede982e08b162c23446a98cbe,132,82,3,308,132,0,05030,3
b5093dca0eb65a4031607a2c788cf384,11,11,1,77,11,0,05030,1
4cd6c9a70943400bf08b1a8bb93445ae,41,32,3,95.66666666666667,29,12,14301,1
3de3ec5f29077fa358eda44319081fe9,12,12,1,84,12,0,05030,1
b49a93e2ed42d3a1e39a6e1506e0a1b5,31,31,1,217,31,0,05030,1
5ecd710518f1655e13dd76fa250cab41,167,133,2,584.5,167,0,03050,4
6065d76cdbb1904d4ce21d3dcf55341e,15,15,1,105,15,0,09130,1
0e2a4f3e021011c459cc660399127513,94,65,2,329,94,0,09130,3
673358914781bdb032c195f94d16db67,83,65,2,290.5,37,46,08052,3
2a6d1d46ca14f39f486ab1039531efd2,269,146,4,470.75,157,112,05041,4
03138b9bc68531411bd606d238ede7f4,38,29,3,88.66666666666667,38,0,01026,1
fcb44ac1e0a614fa045dc2be7020e727,17,17,1,119,17,0,10028,1
30a6a673ade54acb05ed228bf3489890,29,29,1,203,29,0,05040,1
b841902ae0c34f24f9e160cba87d1cae,161,109,2,563.5,161,0,05040,3
dfd34448270024b935fd8fe6bf684c3b,144,87,3,336,144,0,05040,3
6fafbdb8e281b8654f9399c2340a812f,28,28,1,196,0,28,08031,1
66c2eb63a97fea8714324f8e004e4b47,135,92,2,472.5,135,0,09091,3
01341fcf24ab00e6ce4dabe3c628d027,139,71,3,324.33333333333337,70,69,01012,3
3c9be4e53b6c97f305c8ffee9b8b9ba3,40,40,1,280,40,0,04020,1
617ae42691ede942b011f3de4064e52e,221,97,3,515.6666666666667,221,0,11140,4
7ac614d0988190f98fcfeb435d2cfe66,314,151,3,732.6666666666667,174,140,05030,4
54b7a2648b055ef813ba2b97c48ddc81,25,25,1,175,25,0,12670,1
d307c44e843c89947d2b4faa6fbf59bf,17,17,1,119,17,0,11080,1
a0e0d44e01086df263e349691e980887,90,59,4,157.5,62,28,03070,3
d8ea63cf2891d80faa35be690846b1ee,31,31,1,217,31,0,01085,1
1948a9366b61181364473ce6a7efc893,30,19,1,210,30,0,02650,1
523648b6ca5b421d5bbe761ed1338267,13,9,2,45.5,13,0,11040,1
387e6a2b59b831cc4422bfa86ece261d,68,48,2,238,68,0,01012,2
d3fc08521fd4cf8c2396aa1707690498,323,126,2,1130.5,323,0,05040,4
83016134c2d53cb3d2931a2d82b30301,118,110,2,413,118,0,01026,3
050cd6bc16c4e576414a872719839865,51,45,2,178.5,51,0,01026,1
d75158f7ebab53a9976c957085c8ae21,79,43,3,184.33333333333334,54,25,04060,2
2465dd81a5b6505c1fbe63146869422a,73,65,2,255.5,28,45,10200,2
604757e9a99265bddf54cd58d5869e56,37,24,1,259,0,37,11100,1
5af06c4adb3f63548e9057fb8f2a0957,70,51,1,490,0,70,01012,2
73ae6383837ecf0bdd209631af2d5e10,57,34,3,133,57,0,11080,1
ad62a70b3a652e18fc713772a72ae2a5,53,34,1,371,53,0,01012,1
5430f1527c68d4c3823bae95ac5980d8,34,34,1,238,34,0,08010,1
bd10c22a5b30930c0e2c83888230d6f9,4,4,1,28,4,0,05030,1
158ff76ecec8b342e940dc6aa69316f9,143,98,2,500.5,71,72,05040,3
b9afe0e360cd7af6ca82dc42f9e7629e,30,30,1,210,30,0,05040,1
e5856be0babdb28dd2763f5338e22fc3,216,135,2,756,216,0,05040,4
35f37454223ef11af5b05bd2a142158b,196,146,3,457.33333333333337,196,0,01012,4
1688bcfcf0f2d5862dbc8b755490bd71,280,91,5,392,235,45,05030,4
9412bac88d8eca2ad8dac6aa909aa25c,95,71,2,332.5,18,77,05030,3
337e0684cb51f7650e2c2978640075f4,16,16,1,112,16,0,05030,1
91be86ef41ec714b55775606846b0906,34,34,1,238,0,34,08314,1
fe020b6d6af3fb16a8d2c85ca36d6e10,26,26,1,182,0,26,10200,1
dd9dca26e0e9d9ebca7970a3542722b1,28,28,1,196,0,28,01026,1
16be95dcd9d3c4a9d5963b7aaf772320,26,26,1,182,0,26,03070,1
6fd956f454984ebf0b86368baa3bb942,294,161,5,411.59999999999997,201,93,12670,4
7efc99ec498ea7e547a420d05bcf9cd2,186,107,5,260.4,86,100,01026,4
dc53c78bc63b1320fc2913ffd31148d2,14,14,1,98,14,0,10200,1
941eafa6dd7ac5ba498ee8e2e854aa34,13,13,1,91,0,13,01013,1
bb249dab3c986f99632c6fdf64cbc502,48,48,1,336,48,0,01026,1
3cf54c0b0d09b807aabb42dacd2079aa,85,46,4,148.75,85,0,10220,3
43ae952d6169ba03c12ad52aa68873b8,45,45,1,315,0,45,11140,1
e5a2d96b99b994995b14272316b49d70,34,34,1,238,34,0,04032,1
3e2a2a4d0fa874100926c11c2c75c47b,55,44,2,192.5,55,0,01013,1
00b7fbd8a76e2f91a59363333d7af94a,36,36,1,252,36,0,01026,1
10bba4f88988d82d4759324c95808482,27,27,1,189,27,0,09131,1
03fb6f8e5ebdb803c7ab9eac1e127753,5,5,1,35,5,0,11040,1
091478b099870fba092619de3fd43f28,51,50,2,178.5,51,0,05040,1
eaac552539aeda15e00fd12a4861e8e5,36,34,2,126,2,34,04060,1
4e2ba7ead5744bc1ddc94037616c3180,67,44,2,234.5,67,0,01026,2
96e0ea55b048b749ed06fe3c30827da2,136,82,3,317.33333333333337,71,65,08100,3
6437f2a15899aab4e0cbc85d214aa13d,106,63,4,185.5,106,0,05030,3
cbde396f3e9cc7ad319d461cf66ce6ab,133,78,2,465.5,133,0,09010,3
6ff0c2d66f53eae8d57abe5a8cb9c245,167,116,5,233.79999999999998,137,30,01026,4
9deaaddba2dc65990449a235d34022f4,46,46,1,322,0,46,05040,1
524f0d3d3d9e9c7015ca0fc025668806,20,20,1,140,20,0,02650,1
eca4fa41dc00c46df3d5e6a0d78c619d,81,43,1,567,81,0,05040,2
ce5115a171a6ae220ced6638411e9682,512,155,6,597.3333333333334,417,95,05040,4
d76838a3bd28709907eaf0e554760da0,130,76,1,910,130,0,04032,3
72c71b822b4c0969231132dcd32cc0cb,51,35,2,178.5,51,0,12670,1
e2a133b6aec563c3336c6fe5701be4c3,45,24,2,157.5,45,0,11100,1
921fc38d0e87c6712c1d4a5e22033ebd,302,91,2,1057,302,0,05040,4
dd33cb276af520085b47f766d64f24f8,28,28,1,196,0,28,06100,1
bfb6e7d7526ab0a139a242da681156da,28,28,1,196,28,0,01027,1
02c112b6f00a8199c0a3e6a66a353cea,4,4,1,28,4,0,05030,1
cfd0f59a625429dea9bc615f12f1a0f0,124,76,5,173.6,97,27,02690,3
c102a9ef47f26902f3b18be240af26ef,171,99,2,598.5,132,39,04060,3
58a7854adb4525ba8e2630dacc4a7cde,77,61,1,539,77,0,01026,2
c172182503c0ed575173b4d64a3d98ac,136,66,3,317.33333333333337,136,0,05040,3
2afa866e817475e13458817c88d242e9,33,33,1,231,33,0,02651,1
57b79a4a13c208570811706eab2d1d01,24,24,1,168,24,0,01013,1
8177234768429bf0b1e335b0b40a8722,37,37,1,259,37,0,05040,1
79ded613badd7a2104fc7a13bef395da,170,96,2,595,170,0,11040,3
2e2368cd8f3169a88ba6299694117855,514,226,5,719.6,317,197,04020,4
cedef8842c5aa9c0ac34d78e73fba7d8,188,89,3,438.6666666666667,188,0,01013,3
e25b4e62f5039bae46a16c53a44fca37,139,78,2,486.5,139,0,05030,3
2f52c3ca29234c4a453bbdcfb31dafad,25,25,1,175,25,0,11140,1
9c826aaba14d6689eb071bddfb64daf9,82,69,2,287,82,0,05100,2
265372c259830aa8e8cc910a389791de,44,40,2,154,44,0,05030,1
9cc7c0a801ca0f1af0fc29ac58ca4647,152,107,2,532,77,75,10200,3
bf5354ef6d959d0ba903f2e2e30d6ed8,38,38,1,266,38,0,10040,1
afb24c206d948cd4bff2ebbddc0a9698,44,44,1,308,44,0,12410,1
808808524ac5ee82c6a10c6cc7a7490a,26,26,1,182,26,0,01026,1
5f3d5e42ba07a45d5deacc32a2b99c63,22,22,1,154,22,0,11100,1
59d4639377a8953bbf72e60b17e84dae,36,36,1,252,36,0,05030,1
9f69f76efd776d283b759b098ed82ea9,21,20,2,73.5,21,0,05040,1
627f67d20d83fd9a6e81c73b5c78884e,12,12,1,84,12,0,09130,1
54490cdf5b216dfcf0316e57c7637635,311,113,4,544.25,220,91,04020,4
9bea717fb32855359c8c17568657742e,125,75,3,291.6666666666667,125,0,12670,3
85e350d753fb76cfd5d0adebe97b6db7,124,102,2,434,124,0,05100,3
cf03c444fa64314c0586ea1cca6525ea,236,155,2,826,236,0,10200,4
43523299c1b63ececd7c0faa6cfc16f5,249,144,2,871.5,199,50,04020,4
9693ed815f41ba4d23218311228bebac,41,41,1,287,41,0,02690,1
fa2fe9ead3c798097cd411c6b8785c5d,402,153,3,938,291,111,05040,4
f8654a3fbbe74498d72feb8cc6da50e9,154,92,4,269.5,76,78,01013,3
1807e66be2db29bf6a12d1a0ca3c8d3a,66,38,3,154,66,0,02620,2
ab86c77b7d3f12e5b1d98d4f42d510e1,18,18,1,126,18,0,09170,1
c654626cbd758ae02d18a48308b3835b,13,13,1,91,13,0,11040,1
c28181a30fc97151e0de5474d376e661,33,33,1,231,33,0,01026,1
11b91d8d100849bbefc6a71f2413516b,215,120,3,501.6666666666667,215,0,05041,4
9f2731d946de421881b6b951a1de5b5c,59,47,3,137.66666666666669,59,0,10200,2
a7a8b1cfda2d3d916b70ff3869e84913,94,75,2,329,2,92,01026,3
5d4a89edc34acdf2b861e2c9bde329cd,61,55,2,213.5,61,0,11080,2
27249b3beab92e6ed34eee5e1c220ab6,282,111,4,493.5,282,0,05041,4
1028a6ce8fede300782417443ae2bf34,432,107,6,504,282,150,05040,4
8ed32e87258d96753b7e6c50423d6430,60,60,1,420,60,0,09130,2
b79db8d8812abf80db7d603b4debd201,8,8,1,56,8,0,12410,1
3659e62bebec929a2521092ce8cefa2a,11,11,1,77,11,0,09010,1
8e30eff0806360393f14033b9596f790,8,8,1,56,8,0,04200,1
67aaa4ca495ba4ac1ee38c482ec94b8a,139,94,2,486.5,30,109,03070,3
fd9bf5d2b02a52465494be57d75f6756,50,34,2,175,50,0,05030,1
cae74202a5c41ae85127d6354513947a,75,42,2,262.5,34,41,01016,2
783e0e459efe63da049cce59b6def10f,192,97,3,448,192,0,10281,3
15da9f40e14fa6194035629da2100ebb,97,77,2,339.5,97,0,05040,3
4f220e8b6013f95a69c5a90240c53155,169,122,2,591.5,86,83,01026,4
631785d28dd9476e12dd8c9da4757710,76,76,1,532,76,0,05040,3
9acf4c7d3b566989e0dce8de2224fd7b,51,30,3,119,51,0,08100,1
5fdd5a7962032cd01540eabe1adc76a8,29,27,1,203,29,0,05030,1
4e9a2072adaacf7a8b7a01db2c2b8bd4,122,84,1,854,0,122,01026,3
84518f2505e36ce5ebed32d648cf6867,69,61,1,483,69,0,03050,2
234ac8bc9e0bb1306906ebf1eb801679,14,14,1,98,14,0,01201,1
5b2a6c668d0359e7dffd6dd2d5ababf5,433,115,2,1515.5,433,0,09010,4
3a74f65613118dc980be158b3507c9db,38,38,1,266,38,0,01026,1
2423a8d0c8552616ca2cb2690cae753d,35,31,2,122.5,22,13,09150,1
0508099be6a2d2d0a017c096c8eff976,170,135,5,238,144,26,01012,4
cac568876d3ff669342a58cf4f12f061,170,91,4,297.5,97,73,01012,3
8cb67e142992757ffd325c3f95bc4dde,16,16,1,112,16,0,08032,1
af77a744152ea8aba062b123979ccb5d,21,21,1,147,21,0,09090,1
aa74d12312bce7d25e1b920dd934cedd,75,75,1,525,75,0,01026,3
bdc873afa181f014b53b56ee255a15e5,20,20,1,140,20,0,10200,1
5931a2c0174a881450a42a404b7e0572,104,78,2,364,104,0,05040,3
87b20e3611e9b20b3a190d08c97134c8,18,18,1,126,18,0,01012,1
605107c745231b6b5acba7fbef52fde0,108,82,2,378,49,59,03050,3
db2ec6a06baebf0fa2601272564cc5c3,188,99,3,438.6666666666667,111,77,05040,4
7e7c3c4d55ce4df9cc60923b5d6ca722,191,112,3,445.6666666666667,191,0,01026,4
23704259c0deded5c1f016752792c055,54,43,2,189,54,0,12670,1
ad343149cc133e244dd9d286b123ca32,37,28,2,129.5,37,0,09090,1
c124fec06a0a54031735a0f98faf6638,133,89,2,465.5,57,76,01026,3
7700a6c59a1df48106745560d412f740,86,60,4,150.5,70,16,05041,3
e9f6eebbe24b2bc32333e25cae6ee105,274,93,2,959,274,0,05040,4
64357be271cfb78225d51afb95701bde,30,29,2,105,1,29,02690,1
81f9d2a25f7e7258e5f6594fb797f192,50,46,2,175,50,0,03090,1
505f97a0a42a10056cfc491308875751,225,80,2,787.5,208,17,09130,4
bdd9b960e894de75c4b1752257e08e39,158,94,3,368.6666666666667,126,32,05040,3
7a6cdfe8edb33bd1750f4f3190cb1def,124,74,3,289.33333333333337,124,0,08090,3
6faa829e842d0e06c406f3b0d36d52f1,114,90,1,798,114,0,01026,3
c46ded6ba8b6351f7a26e5875152256a,180,91,4,315,100,80,05030,3
e02465a0d90976df3f2ec51b238c95d8,64,64,1,448,64,0,09130,2
181803595cc7804fdb3b9c69001706ca,13,13,1,91,13,0,08134,1
bd3499ab81957cf5f1fc2a4f9e316dd8,161,81,3,375.6666666666667,122,39,11100,3
8b65ff88d8afc74a0e8e138904ee4f14,13,13,1,91,13,0,01013,1
d8892ace9e9852a8450df6810c3e59c8,31,31,1,217,0,31,01013,1
fc64a887c577d71884cfe2a70fc716bc,74,57,2,259,74,0,05040,2
564159c1e501cd7a1108a71cc69278b3,145,103,2,507.5,50,95,05040,3
624208cd6babd2d17eaa1f5524682619,245,144,4,428.75,198,47,05040,4
1800cc98c67657b46fcfdeba1c23e169,18,18,1,126,18,0,12742,1
63bbc4bfa33492434914ab78e3859e90,25,25,1,175,25,0,13830,1
1c037f796f68e24233eba4f4d40ba918,13,11,2,45.5,13,0,10080,1
6201ef1f85b3717cc6dc93a4656e1255,47,38,2,164.5,25,22,04201,1
4e9b65f8308db75b6ce4e91b36cf2982,6,6,1,42,6,0,11040,1
b5ae487684ae3d828a5a8e1900f2d3aa,175,104,4,306.25,175,0,05040,3
0c125929b467ae02eb18ea219583ffe9,31,31,1,217,31,0,03090,1
5d0dd4b71db41e3c9eb5d33174bc8691,33,33,1,231,33,0,04020,1
948a60e17cd13014a39ffc1a9e29d02a,375,191,5,525,257,118,01027,4
34f3f5d47d2e34cdc847e7882e83ee0d,55,37,3,128.33333333333334,38,17,11100,1
fe1eaa589cb44f80f6cdeac444581e4e,201,102,4,351.75,163,38,08051,4
151243ad0a8ceaa21971a4e995b746d8,156,83,2,546,128,28,05040,3
52d0547f0111fd3c2b7133e4da7d4379,12,12,1,84,12,0,08312,1
73ffba1e759273c0c94aa06617679d9f,93,72,3,217,60,33,05040,3
1492f8fcc3337d22603ea35c4c9dfd4d,2,1,2,7,2,0,08314,1
b8e10c5e393360f665f4a23dcb0d20c2,66,57,2,231,66,0,08314,2
4d23df278aa36a284dd37819bea04821,37,37,1,259,37,0,11100,1
73c988d4d74df4ab0941c0c6b88f413a,20,16,2,70,20,0,12710,1
4f368c269d108bc0db22f77c165ef81a,92,56,2,322,92,0,01026,2
b696a741777b8b085b4568de2dfff0c9,166,107,4,290.5,132,34,04060,3
ad878540b8172d46e25a569bf87b0532,40,33,2,140,40,0,05030,1
df3c952460ee96f0f51959c3e40de4b0,417,147,5,583.8,389,28,01013,4
77664f098f5846db1e310567ba7bc711,135,109,2,472.5,135,0,05040,3
0dceac2e9e315e027a9e23abbac4c692,53,47,2,185.5,53,0,10200,1
829dff29b2fd617f957d592ec8ef9c81,11,11,1,77,11,0,03090,1
f194edd82ce95f92a208a01c2e4739b5,34,34,1,238,34,0,01012,1
a8de493e9395dff390d9318be793f670,41,41,1,287,41,0,01026,1
e78da12c3b81aa0e89b662919b1baa7c,109,65,3,254.33333333333334,70,39,05040,3
094dff68f0cafff5e1c22413f326dc3c,23,23,1,161,23,0,01012,1
bc0ed86dcf951be7fb378eb2458d3cff,53,53,1,371,53,0,08010,1
2b9e1470ee7f5ded5380bc7d6410fe4d,372,126,3,868,348,24,05040,4
4a29879267f289fff9b42b67f872a76d,27,27,1,189,27,0,03050,1
85463d976da0719c583f2661f24c7bf5,176,97,5,246.4,128,48,11060,4
2d07dba2444aed359c9d83913c51dec4,123,99,2,430.5,63,60,05040,3
a666c9d6d5e6dee55baab704c5ee8cea,193,89,3,450.33333333333337,106,87,05040,3
298bbd2ca44d21f3e42c37ff23f9a71f,36,36,1,252,36,0,01027,1
4d60f6aebf4f93adfcd4a39e08edacf4,141,105,3,329,141,0,01012,3
249ac58c966a732c725cac6f85b3a019,139,74,4,243.25,89,50,01013,3
f724cd844d658cf9898e5ed98bdf4e32,42,42,1,294,42,0,10200,1
d052a38d75fba48f8672d97042da9498,69,69,1,483,69,0,08032,2
fe72101547fdb4943c460e9152f67177,176,83,5,246.4,152,24,01028,3
1fb925ae5496dc74942276bcaa6bf6f6,15,15,1,105,15,0,11080,1
5331ca0d85a87db19076dd9097de61bb,10,10,1,70,10,0,10101,1
afed844d1850a764bb10b1b61d4c3a6c,85,68,3,198.33333333333334,85,0,02691,3
a033012ea7ca074e083a80547025fd10,14,14,1,98,14,0,01026,1
bc2d241df747716bef1db889958c99e7,35,35,1,245,35,0,05100,1
72a96626fc7ce1c9b0da7f8ffca12fae,32,32,1,224,32,0,09130,1
a9bb0c1add6ddb84f03ee4efb490e0e4,108,63,2,378,108,0,01026,3
31d7f58f17ecbbf7b82a7e2a23ea0231,42,42,1,294,42,0,01026,1
f48a59f80f6393f9ed99a7029a977c3d,55,48,2,192.5,55,0,05030,1
0657dce5c9aaaf540416bbbc57ba130c,137,88,2,479.5,137,0,05100,3
ef2a19bd40acca6db6e34c3f6d60aa7c,4,4,1,28,4,0,01201,1
626c3f0919cff6d15cf03af8432f6000,56,56,1,392,56,0,01026,2
1cabed384a69ed199fa2c74b42b24b04,143,89,3,333.6666666666667,143,0,05040,3
e3751fc791bd34e366b84632d59d53da,101,47,2,353.5,101,0,01085,2
a96a0b494b8a01bacba47612c68767bc,40,40,1,280,40,0,09130,1
461d4eb253baea02638e422aac049562,32,32,1,224,32,0,12500,1
671473b427bfac9993d8d45efa495eae,103,87,3,240.33333333333334,103,0,05030,3
3bed44d2db36d4f21dc82cf0e2b0e418,3,3,1,21,0,3,05030,1
bd5dd5f9f34f5797059ccc6c8ebdd2f3,148,78,4,259,76,72,01026,3
1642f32941ef98ae212575d207630734,122,90,2,427,122,0,01012,3
999f1433517e32a62cb781c5ab53e63d,23,23,1,161,23,0,11140,1
d84058c5b515f2f9024e66291a5583bf,40,36,2,140,40,0,08314,1
d351bc18548e8a4d3705e787f6deaf66,44,38,2,154,44,0,05030,1
092359acb7b75b24c7a0a5f1a9bdccad,140,92,2,490,140,0,05100,3
446085e707ef314dd28ed8e94a53580b,26,23,2,91,26,0,01016,1
db107839972a12c6ccdc217138d09161,61,60,2,213.5,61,0,01012,2
bda48e00da74b15eeb75f77b86027e85,64,64,1,448,0,64,08052,2
64e117bbf0dfc21bbd5217eef84c5c3c,44,44,1,308,0,44,01027,1
05d0645c4057e4133ffc12d47a195146,17,17,1,119,17,0,09130,1
3ee01de6adb80e0500128231fb56d90b,81,53,4,141.75,81,0,05041,3
ce6081abdc1977b6ddad0412daacad26,167,84,3,389.6666666666667,167,0,05040,3
68704850a20a5c5f7b471ad2469c7487,38,38,1,266,38,0,04020,1
b19c87550bca90072735496dbf6f4678,192,147,5,268.8,152,40,05040,4
e37e46ce4563b3093b6e28fbbfac9631,227,101,4,397.25,107,120,05040,4
8e1ed3fd351902a3bc2a8f6a3d3032a9,62,51,2,217,62,0,01085,2
782633f1143cf1b4754d459efe60ef04,114,74,2,399,114,0,05040,3
4ce5dfbb803597cd432d42a2ad33e799,15,15,1,105,15,0,09150,1
b5bd068300f41f978bdb25daca55a0df,9,9,1,63,9,0,05041,1
6915f9965a96cd7ea2fc1ee5fb883761,44,44,1,308,0,44,03070,1
e41ae1af671992d75d36591ed3400d45,29,25,1,203,0,29,05040,1
f4b41e65f3400307a5f045a2afa847a4,65,55,2,227.5,65,0,08100,2
6b5718b4596457ce3ec36a22d549a7a9,61,53,2,213.5,61,0,05030,2
3bf0b9eca0911a585214830e4a46adfa,63,63,1,441,63,0,05100,2
5084e8ba86870c791e0d2d1803cd93fe,82,64,2,287,82,0,09110,2
8d617846e4d1196a2032df3676e31ddd,71,71,1,497,71,0,01026,2
fdd8017dd0b141a215c7c4b91e689f30,489,109,5,684.6,330,159,05040,4
1f8d9a2ebee9e0194edacb87394e0dc8,24,24,1,168,24,0,01012,1
dd36149164065092a206ca63136c8c29,22,22,1,154,0,22,05030,1
398ccd03e1b7eb15151c3f16426c0d92,93,73,3,217,32,61,01012,3
c69877fcb989671bf73f16fdb01d4bbb,67,63,2,234.5,67,0,01026,2
7ec8161a12cfa33f523f752e588dfb73,76,57,2,266,76,0,08010,2
f44eef3d0201365ef5ac45c08e8a2939,12,12,1,84,0,12,11081,1
b47c5aab31d878e1df61d78cc8e491f5,86,37,3,200.66666666666669,86,0,04200,2
67506c4be0fff8a5ccfbbeaaa5908b4e,9,9,1,63,9,0,12501,1
d042be7a319ac19fc3536bf7ede20e93,31,31,1,217,0,31,10200,1
bb22aa4cc7ce22c78bf4f2373b43a1f8,71,52,2,248.5,44,27,05040,2
5af8fbfab7d00e9a87659b3da887f751,62,50,2,217,29,33,01026,2
fd9ca4795f29b55169d997c15013d187,42,36,1,294,0,42,11080,1
8bf7213cb8c407bff05f0274be3e4a2d,83,66,2,290.5,83,0,04201,2
d0a054cba71b2787f546e3583ec773e7,63,56,2,220.5,63,0,05040,2
dcd8616d4346aaa3c9850efed7979764,28,28,1,196,28,0,03033,1
c44de530d2c0140e6659014a5066cc59,26,26,1,182,26,0,01026,1
9f2618d2881eb00c760060db3c88a5b8,37,35,2,129.5,31,6,05040,1
6a3c1fcbe72bf9981bd4dd04a6d3458c,62,50,2,217,32,30,01026,2
9c367df0ec1f01c491ac16877c733863,218,102,3,508.6666666666667,193,25,08010,4
f1f8e2c8596c6c2a22feb95bacf644da,136,70,5,190.4,108,28,05100,3
ca606b3dcbd0dc1e0326c97ed58fa5d1,145,77,4,253.75,122,23,01012,3
0491c163655f74c0a84851092ba0aaef,150,99,3,350,75,75,01012,3
3d5ba99ebf4ee10d3763cede9027a39d,48,40,2,168,20,28,01027,1
05a0fe60c66b67e0bb617dafdd19f0fe,86,62,2,301,86,0,01027,2
6822994f03bb190b0cd737c733f712a6,143,82,3,333.6666666666667,120,23,10240,3
be63bb7b1062b156f1a28ae7f21fe955,79,79,1,553,79,0,01013,3
5154e0de1b38374f4f94a6d7b98133f5,28,28,1,196,28,0,01027,1
c195f78429c6cc274d7cde2aa125706d,21,21,1,147,21,0,01012,1
2d2104909c67bb4c0ba07ac0df0fb807,51,47,2,178.5,51,0,01027,1
c00e4482d6331f01386e87d2674731f0,80,54,2,280,39,41,01026,2
8d33a91c8921b72507c9ab1cf98c2356,150,93,2,525,150,0,09030,3
bb6511e6e2a3a6f8223d8e04423fbcf3,41,41,1,287,0,41,01026,1
333ce9792308e964a9d84399594ecc1e,128,82,5,179.2,112,16,05030,3
b4006c5b43564b64b1178233efeb967a,57,49,2,199.5,57,0,05040,1
c2d324593ce86c5256ac0b0c70dd9e1d,33,33,1,231,0,33,01026,1
11953af10dae3659921de3569b4a0f15,70,60,1,490,70,0,10200,2
4e7ece91d0e8efd3a3a27080ab55d859,141,90,3,329,141,0,05030,3
a0e6d1f7c97fafcc7b4941cc1e6e8116,114,70,3,266,74,40,04060,3
5aecc8464591ef8846b1007f72856e06,202,130,3,471.33333333333337,202,0,08100,4
4bc66251af77594d478e854cbfcf36b4,16,16,1,112,16,0,11080,1
9f8ebf6424fdb091856bc43dcf125638,31,31,1,217,31,0,01026,1
6c37d9488959c1162371f7fc13bbb8a7,31,31,1,217,31,0,04201,1
33f43a7d294c26bbda3c302da70af94f,15,10,3,35,15,0,10200,1
7ca70567ec9055fb54361c495f2816fb,38,38,1,266,38,0,01013,1
4ca60dea7d439aed9db5ecfe086416bf,196,97,3,457.33333333333337,52,144,11100,4
322b283eb85919b7763c891cbf2c99b8,106,65,2,371,59,47,11100,3
54af36089a5e505e168a6fa1c65326f5,38,38,1,266,38,0,01027,1
90fc7ad5c6e3def731b2c72c867186c2,101,60,3,235.66666666666669,73,28,10200,3
71f3d475005aad01fb95d908498b0fcf,76,48,2,266,76,0,11140,2
c45c5d4932cb517fb22e4c6feb8eaa5e,118,96,2,413,118,0,05100,3
2a619f82879f5985b0963083fdea790d,48,32,2,168,48,0,05030,1
2db3e775c194b890e021d4f75d1baf4a,25,25,1,175,25,0,01013,1
2ffced32e27aa0b02cc8667d174f6205,81,60,4,141.75,71,10,05040,3
227abe4fa8ca09c62f987dc1bd6e3a75,6,6,1,42,6,0,12501,1
33b4c704cd203d129ba63498ca11c516,237,137,3,553,148,89,05040,4
103aaa93f3268fbc61bf56ad7e6ba8ae,27,27,1,189,27,0,01026,1
9020599c0248671b0494402206a853c4,109,64,3,254.33333333333334,109,0,04020,3
0770e9911551de8984afd351cc4914ca,300,120,3,700,219,81,05040,4
80716ef13a867ae147690b6d30ce9a72,174,102,2,609,115,59,10028,3
29c1b0b02220aa1f3b368b2f5d67662e,110,75,3,256.6666666666667,89,21,01012,3
efdc7392c3733852b234227a528492ae,86,63,3,200.66666666666669,86,0,01013,3
440576b986aa5027f851a08c518342d2,317,110,5,443.8,289,28,01013,4
057eaaa8ad2bed2fb74d5db7104f75f8,53,44,2,185.5,53,0,10200,1
960126f55abe66b3eb0907f97b5c96b7,15,15,1,105,15,0,11100,1
706ab74d92c043dccbd4e215a8c30cd7,43,43,1,301,43,0,01026,1
fd2ab965c4ff282fe75525bb645e0b2d,15,12,1,105,15,0,11140,1
410723e358a8e2ac34d3a4b707316185,83,83,1,581,83,0,08052,3
2dde71addeeb26f4da342440f13aa096,32,32,1,224,32,0,04060,1
be3fec7d5bffa3ff8ae11bc339431ef5,26,26,1,182,26,0,03090,1
3bc467492dc6a88341b9c706c536601e,138,100,3,322,96,42,08010,3
c8306227837ba031d1e3755870a6e7eb,210,132,3,490,210,0,05040,4
ec87078a0a3038d10aaf8418a1ce7c63,41,41,1,287,41,0,05040,1
201dbd5f13ca56757e36b7bcebdaa663,64,42,3,149.33333333333334,35,29,01012,2
ad257a8e1a81672465c3da1bb9e49d76,21,21,1,147,21,0,01027,1
ddacfe0932983dab3ea2ba33c4108663,223,134,3,520.3333333333334,148,75,05040,4
a31b2da2ee03330c09690545daf46cb2,73,58,1,511,73,0,05100,2
e0194b3a9475a5ba2536b0344e14173e,287,126,5,401.8,216,71,01026,4
29860272ae7dd070dd5816a6fefd10fa,68,34,2,238,68,0,08110,1
57735068917ab8c9ddd000eb8c1fdbd6,88,66,2,308,88,0,04201,3
3b8d4707040d1610854eb37449737a02,25,25,1,175,0,25,05040,1
ff0b1f60f4bae0bd6b6078e5dae7a296,33,30,2,115.5,10,23,07141,1
613e886afb1e6447a1a5fbc753f9a563,177,95,2,619.5,117,60,01026,3
bcbd01b35ae89c303d683871ba2cf8fa,31,25,2,108.5,31,0,11040,1
5373a63576d5bc1a071abdc6ff4be4fa,67,53,2,234.5,14,53,03050,2
d5522f73b2d727b86dfc1364f5bb85e6,174,83,3,406,174,0,01012,3
461dc77e61a6fdf412a28d9cdccdb546,20,20,1,140,20,0,01026,1
51875b3f9b93a7bca559eeb452a1a2fc,76,56,3,177.33333333333334,76,0,05040,2
8f15be1a481ad724c30d24996eb5c166,16,16,1,112,16,0,05030,1
700e5d5a9d924d18d0da357f21e54655,33,33,1,231,33,0,05030,1
5650f65569ed3cc65756d4cfc66089f6,61,61,1,427,61,0,01026,2
2071ac14033d698730c7107f814f123c,231,126,3,539,177,54,01013,4
7157a5392714a385cd7767ec24cf67f0,142,87,4,248.5,142,0,05041,3
9dd0eff07f83d89c1e6aab4f4ee76630,42,37,2,147,42,0,04020,1
21e54849d894ea8ec5fba78045550925,167,98,1,1169,167,0,04060,4
c158a22de8cf19a5d9e7c8862c47d584,21,21,1,147,21,0,10200,1
4f6fdd0c8e944d41331073731fcc4a00,75,63,1,525,75,0,01027,2
dc4ad3dbd3629c864492b6a926549498,18,18,1,126,18,0,12500,1
9d3a841e8a2938d8cadf9ec3df1aeb4f,106,67,4,185.5,106,0,05030,3
3222c3f3dddc6d6f76292a6ec4a80b5a,50,36,2,175,50,0,05030,1
342b1f91abf41334074ab1b32cdad955,33,26,2,115.5,33,0,01013,1
3db97edd13ee03f0e099bbca9dc9f9af,38,25,3,88.66666666666667,25,13,11040,1
36d3bd8f0fdb2890929a5a62dbaf8fab,35,35,1,245,35,0,04032,1
8dd692de063b07102d16381cc1f9369b,11,8,1,77,11,0,08315,1
05e8c8e9d06f6fb34378156646fddcd5,39,39,1,273,39,0,10200,1
9989e677605b8da1eac2dee66850bf8c,74,62,2,259,34,40,01026,2
0c960e7591fee2318041bcab5a262af7,261,166,2,913.5,198,63,10200,4
86afa4b84c27aeaa8a42f95aa991ed72,114,88,1,798,114,0,05040,3
74d82ce47b2fe4fca70710b41c6449da,7,7,1,49,7,0,05040,1
24f5fd3005e84c73868a0ac3ec0a88bf,116,87,2,406,116,0,02620,3
3f3e5a912c1801a2a958614bebe15293,126,64,3,294,31,95,03070,3
b51353fcf07cb61280eda45e33679871,138,82,3,322,105,33,01026,3
0d3e5c3071f10986cdeb2c3a0b2926d5,109,75,3,254.33333333333334,109,0,04060,3
0bb0fbe5ecfc94d0efcd01653ad51740,23,19,2,80.5,16,7,02750,1
6872eabedc0598b4a7b11e7ab5161319,29,29,1,203,29,0,12500,1
6590f7198b701679c6bffd39747a4b2c,28,28,1,196,28,0,02650,1
a1ecaed765b5d6ebef5ab9cc279a39f4,15,15,1,105,15,0,09170,1
5c725a9a5b915a2b8c8495017b96cd9f,86,67,3,200.66666666666669,60,26,01085,3
2c2f193691a07b6e9f2fa844dad77b5e,185,67,4,323.75,165,20,01026,3
9935159e544d270a3be4ebd642751456,112,72,2,392,112,0,01012,3
ef39ebecfa70027f8604ac4dc5a38d12,329,170,2,1151.5,170,159,05040,4
6525e9b9094e8f385eed66964c4307f5,372,169,4,651,372,0,01026,4
6f5eafc878e0efad2b67d9f7ca1d4562,156,97,4,273,156,0,05100,3
ec3554c4e682d00a7aeab6586256bcb9,31,31,1,217,31,0,01012,1
eaeb2f9cba5b0dc2cd18e426e3965f63,31,31,1,217,31,0,01026,1
99da33400ff3465f39416ac91d529cb0,33,33,1,231,33,0,01085,1
90c78aa37067596b58863c1b9b48632e,18,18,1,126,18,0,02620,1
76e4efb18439af4e3b56b3f0eb9ad12f,32,32,1,224,32,0,09010,1
61018a14aeb80a42c12ac99e1ab0f077,14,14,1,98,0,14,03050,1
5a282c0930b7992e165a929d447e95b8,77,47,3,179.66666666666669,77,0,01085,2
6e01510964d9f1cf127c4e28ca3d8340,67,59,1,469,67,0,01012,2
1bcd836ed0486384345195709dc41702,91,69,1,637,91,0,05040,3
f33923e179138a880b6ae8d352a8be14,25,25,1,175,25,0,08230,1
9d55d9679356018c8ee42c422eeeaea9,78,60,2,273,78,0,02650,2
85a46411ffd7636e38712310743da8c2,11,11,1,77,11,0,12500,1
d8a75fca90d76aeaab733a8d70ae046f,361,179,4,631.75,361,0,01026,4
96e9e1d8159a4546a4686e1bce0af252,1,1,1,7,1,0,11140,1
ad92c790f3cb8976776c6d5abb21c95b,20,20,1,140,20,0,11100,1
b46cf140619f94a127c42ba81ecdd5b1,15,9,3,35,15,0,05030,1
c0da4bf77e45ce0b18adf33b6d43b79a,98,71,2,343,51,47,01026,3
4286eaa69619baa52ff325c96524e5e0,70,51,2,245,70,0,09091,2
c431706eccab59804d3d83ceee734a8b,19,11,2,66.5,19,0,12670,1
aec3e86c5d913e1c46cc19d49453d77a,4,4,1,28,4,0,11040,1
cd9c470a57882274f7888559454df43c,118,77,2,413,42,76,04012,3
fca791727da316629c3a0e8cef4c9877,15,15,1,105,15,0,12590,1
1eb44517fc8bad96968fa1b385cbe484,10,10,1,70,10,0,01201,1
5db4a87908033f24df7401607463b477,79,65,2,276.5,18,61,01026,2
4fd611eecabfcad33f956df631283efe,36,36,1,252,0,36,01026,1
9d51eb4634a05d9e6d040f028d0f57ab,143,86,2,500.5,143,0,12500,3
b8293accb1e57be3bfc3111c776f8c3c,52,39,1,364,52,0,09030,1
4b938a3fe5c2831d824c2e49cdbe3883,3,3,1,21,3,0,11040,1
98eefb3135a44f7a3d199656bdebaf4e,48,45,1,336,48,0,11080,1
711ad2e94ad2007bc483c48af14398bd,6,6,1,42,0,6,13490,1
ad8530002c688ff4fc39155d1960c320,150,107,2,525,150,0,01013,3
5b9de62516a924c3ac03d133a6d9bf7f,107,56,4,187.25,82,25,01026,3
6c033764ce0b8ddc486b89ba85404d38,111,46,3,259,111,0,10200,3
bc0da2ce99998cde443664499d8ddd85,19,19,1,133,19,0,05030,1
3ec6b63aa0b3c44153262acaf652dcc5,49,39,2,171.5,49,0,11040,1
ae9046fc40c65330c40ee9da7fafc1db,15,9,2,52.5,4,11,12410,1
e2bbd4115d76cd4276558fd10ee305bb,15,15,1,105,15,0,01012,1
497c41677e657cade173aba2cdd63be2,186,62,2,651,90,96,07122,3
08b9588b5fcb0b2ce56a5f47b804c4bb,198,82,4,346.5,171,27,02691,3
524701bf43cd45bff7638e4effb57ab5,40,34,1,280,40,0,01027,1
f02658f13f60c5ac78e6bdb126d8bea8,106,79,3,247.33333333333334,106,0,09130,3
4c6b14bf3886f29b4215987b559aa389,42,42,1,294,42,0,12590,1
c3cdbae6fcfc3ac474f0d562464307a0,20,20,1,140,0,20,10028,1
5bf5c0bcda22de660d2b989025cc34a7,32,27,1,224,0,32,05030,1
97f0e2ee04fd298f0abc1a900799f37d,14,13,2,49,4,10,11080,1
330200ca67ea70be109da24641360a57,55,55,1,385,55,0,01201,1
1701a15181dbde3a87683045e54b8cb0,38,38,1,266,38,0,01012,1
b508421860bab0ca6dba8da3852363d2,70,57,2,245,70,0,11100,2
d94c44215a843fd07f0f28d29bfe0e4e,108,78,1,756,108,0,01026,3
4b84a68d732270df3a737d75b7da8ad3,172,98,2,602,111,61,05100,3
e14ec620c1b734c4f8859dae568ea380,17,17,1,119,17,0,11100,1
ed3b5a73a7593eb577b6f881d26f282d,28,28,1,196,28,0,11140,1
272ffd312f97b521dc57e9ddfaa65e70,230,141,3,536.6666666666667,69,161,01085,4
18b327a26881e9789b00361239c66e15,52,40,2,182,52,0,05040,1
b01630d6cb1994d63947f8d4ee117834,71,43,3,165.66666666666669,47,24,05030,2
d5b0e2f6b2eb73a7e0e3041ff022a94d,319,158,6,372.1666666666667,252,67,06100,4
ed8c4ca907f308e20185dec8ab0d91fc,42,42,1,294,42,0,02750,1
04b26a04ca7fc332e85a92a2a81e0969,240,137,2,840,240,0,05040,4
5d3ff7358a5e9d30b584c661b957b75a,32,32,1,224,32,0,01012,1
1d7d4b09c48017896cd79d73852328b4,101,75,3,235.66666666666669,86,15,01013,3
c70e72e5f87e004c55e647f31e47f40f,43,43,1,301,43,0,05040,1
38efa263b709bfd18e17867eeddce6b2,158,113,3,368.6666666666667,92,66,05040,3
c9eb43334d6b4de977e637cd0d29d438,307,95,3,716.3333333333334,307,0,10200,4
577aa4477dd89362dd8e848fde7d0b62,68,51,2,238,68,0,05030,2
cb9570048aa23505bfed560d3dec29bc,156,100,4,273,156,0,01026,3
822a86b808ae357018dd7440dc44be5a,59,48,2,206.5,25,34,05040,1
8a77a12db66d7ca635a857e4d4543a92,184,103,4,322,184,0,05041,4
dde12003184174314f2a609154c4872e,251,145,4,439.25,203,48,05030,4
13c27a0233ea6d30308679361727246f,323,118,4,565.25,296,27,05040,4
b2cf86d13f0b94e50306e8c1bf692ca3,25,25,1,175,25,0,08452,1
3c47a00a1e937d6f632899373c32b4ec,59,48,1,413,0,59,01026,2
05817d85ee8070e303aa8d897b0f8929,35,28,2,122.5,15,20,05030,1
a6a894e188c31600698728748f8a9227,24,24,1,168,24,0,05030,1
2fd6a8830578ec2db555cdfa3943d2c9,50,35,3,116.66666666666667,44,6,10028,1
b85a6c9a40983ca9528d31f93c6a5934,118,60,2,413,118,0,05030,3
62891d8dab2953758b0439c4fe6d7e9e,29,26,3,67.66666666666667,12,17,07143,1
e2d181d75927051e8a4dd5368f5c2eaa,37,37,1,259,37,0,01026,1
145e37b9dd9e3af85db0400b7f3b1e5c,90,56,3,210,62,28,11140,3
aba225da14bb4e2793cdd9ad06384474,146,80,5,204.4,105,41,01012,3
71c862d55610424a9c466feea0ff7bda,55,55,1,385,55,0,08090,1
1f761211ff3e89731415136972efa901,88,65,2,308,42,46,05040,3
98be9decd942419e578e2239b91eeee0,25,25,1,175,25,0,05030,1
3bbb1d933966e5d371a856a63ffa5223,68,54,2,238,31,37,10220,2
036dd25540bf69249c3ff3598579c3c4,48,40,3,112,48,0,01026,1
ca5dd8fb8889d8d2d2ef124d4badc632,2,2,1,14,2,0,11100,1
305d19b96165e5a825cc513df982d6c1,36,20,3,84,36,0,05040,1
0235953ad7a5dfaa348a6db4337cb3de,23,23,1,161,23,0,05040,1
07100ba48d0707a23847da7663e47c86,20,20,1,140,0,20,05030,1
081ddbd7df3f6c5134c7cce47d74fe0b,63,63,1,441,63,0,08100,2
ef9badeeee9f9ce28c720e55fb3abbf2,77,60,1,539,0,77,11100,3
dbd8f002a7f7027ab408b22d7a6a2f16,38,38,1,266,38,0,05040,1
975425aeb717422090bae907c64c0538,228,113,3,532,228,0,06100,4
07cfdb7dde16f9ff58da6c209d8072a8,300,127,3,700,102,198,03050,4
5fcaccfa3d232a8b0a684f032837de8b,209,126,3,487.6666666666667,149,60,01012,4
3281d0ebc47330bdab02de7b37a68254,261,78,4,456.75,235,26,01012,4
5e687eac1b091409c0f81df816db019b,32,32,1,224,32,0,08010,1
5fff0275d0bb5c04c62f8b9bc1d09d34,69,48,2,241.5,69,0,09150,2
60c867de2bdc33039e895e9f88065628,41,39,2,143.5,41,0,04020,1
b6bfc4c141cd8d9c9789d2eb4b79f922,22,22,1,154,22,0,05100,1
6f2aa87413a7cd5caecf929527b24794,123,104,2,430.5,123,0,01027,3
b78eb712ccd5670f89ddcfa3e82e7cc1,121,90,3,282.33333333333337,50,71,08100,3
0177026248d407202ee791b8404c2658,137,93,2,479.5,137,0,05041,3
26421074e529d3ad5760cea2ff53af0e,11,11,1,77,11,0,05041,1
19767a9273d599497d6f4d02fd16ef61,96,74,2,336,43,53,01026,3
72bed535a3a4f226da034d1dd45d8bae,427,188,4,747.25,427,0,01085,4
48f619250e74d4303b8733e14255846d,159,57,2,556.5,43,116,01012,3
2a0959bab679aa5d030281201fd3cf6a,40,36,2,140,40,0,02650,1
8f90cdda3df99026864493d1af5d4a56,4,4,1,28,4,0,08314,1
15b3e469d0d47e930ea8bc7bbfcfbd6b,28,20,2,98,28,0,11080,1
beeb4339d5a75795a16fe30bc2fcc00b,355,139,3,828.3333333333334,355,0,05030,4
c294303149ef1e7eca9cb6604bf18908,8,8,1,56,8,0,05030,1
1a7c120e3cc83449b3016161c767686a,128,103,3,298.6666666666667,128,0,05100,3
23ce2d7720622df61db73babad413cb9,140,94,2,490,86,54,05040,3
286700717f5ee7c643a2ea20ff81f2f5,40,40,1,280,40,0,09351,1
ef6427b4ddbdbe0e567b5b36cfb13e2d,178,128,2,623,178,0,03070,4
3051012749a921405d1e4b717da39ea8,95,66,3,221.66666666666669,82,13,04020,3
d850a1f72d57135627befb18b350ccf8,41,41,1,287,41,0,01026,1
8fbda980683ca3ab753b08102f1c74ee,16,16,1,112,16,0,11140,1
752d78d9d1e81d6ba378f41b95377a8c,59,43,2,206.5,59,0,08052,1
8f3d49d18626818eb41ebc9889d866af,309,122,4,540.75,262,47,05040,4
eea13abc5cd4ef7c7292270c0b16bb5f,94,65,3,219.33333333333334,94,0,03070,3
a5d1659bbf411805290b5d1fa06bebbb,40,39,2,140,40,0,01027,1
c0e9323fbc3ca252e07bd8e03ec5fb3d,24,24,1,168,24,0,05030,1
4a894bf665b3228c2e5d0199b8574b85,56,56,1,392,56,0,05100,2
2a181a10bed317d7de8f5ee58ed1ad7a,149,120,3,347.6666666666667,149,0,05040,3
1872d3259faaf25ed266c4d637728bc4,106,50,3,247.33333333333334,106,0,08134,3
684c1eef4d3275a03cdad2a99ab54c4a,34,34,1,238,34,0,05100,1
72cf09b01880d96efd410644cac3f42d,52,40,3,121.33333333333334,50,2,05030,1
dab8752108399e79426665be7167c983,211,121,3,492.33333333333337,211,0,04060,4
4abb9a1e09e8473981e98c2111acd42d,186,88,3,434,117,69,05040,3
a1772471bb743cb407acfd80eb6663cd,269,115,6,313.83333333333337,243,26,05100,4
9ecb21394e11fa1a2321bb3872cb7b56,27,27,1,189,27,0,09010,1
34da024ba1fb3630a5bbd56676d439ec,164,104,3,382.6666666666667,164,0,08052,3
8bd80ca153e457b295b422d32334dea3,24,22,2,84,24,0,10040,1
792b3def23747e69a694b834af6c0f77,56,36,2,196,27,29,05030,1
55c3cc8bf89aaedd77df16a7b89ef4c6,55,45,2,192.5,55,0,02690,1
d76ef4028f0109bdf483af3096b819c4,41,41,1,287,41,0,11100,1
f24155b6579ff547d37eda1d558af56c,56,56,1,392,0,56,01026,2
76602190038773af3fc453b457d45cbf,12,7,2,42,12,0,11040,1
d2afb4deb1be0e14e270ab457cd5f8be,29,24,2,101.5,29,0,09110,1
00b0f6eadb0d8e62e9048dbea5580e46,67,50,5,93.8,56,11,05030,3
246ed14085cbf92cbf2583726ef998c6,1,1,1,7,1,0,11040,1
697a35c9d2ada58e036dc9c942150a26,52,42,2,182,52,0,12501,1
fcd113bcf0836f648ced5f2519ed0973,19,19,1,133,0,19,05041,1
1035c7b232c34944caff80b602ef3ef6,118,81,3,275.33333333333337,118,0,09130,3
7bd8bd1e70924d2cd2a8570ddb3fbb13,146,74,3,340.6666666666667,146,0,05041,3
6bd91ccc9aa0744e119860623beacd2f,69,58,2,241.5,69,0,01026,2
6e21e73b81218a6b3036363a3e44414b,56,45,2,196,56,0,11100,1
8cd31a362344e21f37883bfcefa926f7,21,21,1,147,21,0,01027,1
a2919a61f30e40109ba3c6137765625c,31,31,1,217,31,0,05040,1
81b7293fd3043c2500d7c5dd8b7fe995,58,44,3,135.33333333333334,58,0,05040,2
65fc5fdc7b9488ca5af4ebb6c59ee106,45,45,1,315,45,0,05100,1
2c684d2af799bad9e5268a12518802bd,5,5,1,35,5,0,04201,1
6dc8138f11259cc48b40825605fed17b,77,66,2,269.5,77,0,01027,2
2530fc74f117271b3f14bda87191391b,168,116,3,392,168,0,05040,3
576ef8f988594761f455bb977a988a7f,157,46,5,219.79999999999998,157,0,05041,3
69d3e59cfff2e188d5f3e44eae52e3b3,80,63,1,560,80,0,11080,2
302a9048c273b6db198c00d4b6ca5e9d,3,3,1,21,3,0,08091,1
7f3321bf3ad950e485986df7390d55e7,26,26,1,182,26,0,08010,1
9c28728d57cb760d8cc2010d3c9968c6,139,91,5,194.6,100,39,10200,3
bbc7410d22d7480a64b80470c3fb48b5,192,102,2,672,1,191,01026,4
d260820a0d6fbf6807b35fc9efd27eb1,24,24,1,168,24,0,08100,1
cc8debe7a4734e118e98886494d4a3e2,645,269,4,1128.75,127,518,01012,4
63b4dcabac026d419639933d390243df,38,26,3,88.66666666666667,38,0,02756,1
589f8148538f8325d8a169f791a9f8a5,4,4,1,28,4,0,06100,1
2f5068dce34a68ec5a30a00f24bf2822,55,51,1,385,55,0,05040,1
c82954fb5f9fb121afeec0d251563556,21,21,1,147,21,0,01012,1
d94d71c5580164d0f97423086d3470d4,56,48,3,130.66666666666669,56,0,01013,2
35e22de00bbd42e3114e301aac49f299,31,31,1,217,31,0,09130,1
c067780ec0f474780bb0e43c41a2fb30,25,25,1,175,25,0,03050,1
2bbf3193ce271122eba57da9294cd6f3,34,24,2,119,34,0,05040,1
764ab557a66ed8a97e0bebb0c27050d3,86,55,3,200.66666666666669,86,0,11040,2
9c730c6b24d3ca5e8eb01dc79bed4650,105,42,2,367.5,67,38,01012,3
87b3f13969f348b520f0ee11598bb785,83,59,1,581,83,0,10200,3
37bcf6fabca25dcbde74dda689f713ed,78,61,2,273,78,0,08313,2
0a51fbb9dfd6363ca04e6bd27f61548f,10,10,1,70,10,0,01201,1
be4d06a6c3fd8e8e75a4de6db49c943e,66,51,2,231,34,32,01027,2
fa419a50f8560f33a87bf0f89fad10c1,7,7,1,49,7,0,01085,1
5bc88747946828fa96338dd60c968441,383,161,3,893.6666666666667,137,246,01026,4
3ce21f250e19bcc4c027607d1c5c3638,28,28,1,196,28,0,04020,1
7f0a3cd5b4eb89d0546971de69b309aa,14,14,1,98,14,0,04060,1
b4109d534b05f1e3fd533045d3180cc0,30,30,1,210,30,0,01027,1
e1100847dfe270f4a7809d14564a463b,27,27,1,189,27,0,09350,1
a28470eefae8b0a880a74ed130db6c19,94,65,3,219.33333333333334,63,31,01027,3
71483b54d5bdc52f6d35cc12eed0817c,62,49,2,217,62,0,03070,2
9b72077c3c089a144d0b4e2fe8ee2b2b,31,31,1,217,31,0,05040,1
4f7d63d90ccf7d3956099b188f640314,16,16,1,112,16,0,01012,1
326788a14b9bbb24fb73340e079b7f47,25,25,1,175,0,25,09030,1
916fb313b829d052f37564a917ec963c,63,63,1,441,0,63,11100,2
6d7a4478b33bbbe8f9ce6c7694b8748d,46,35,3,107.33333333333334,46,0,05030,1
de28fa637e99c24aa26d8fd6481aeb6f,26,26,1,182,26,0,03050,1
01dbdbc27b4904cf9d26978409fad3b4,19,19,1,133,19,0,01026,1
b2daad370b3316943bd75dae42acb00b,9,9,1,63,9,0,10153,1
6320ed78e34e972e90a0fdb2f5ed40de,33,33,1,231,33,0,01012,1
ad5d6c59ace0933e1f999c3a79f815f5,408,161,5,571.1999999999999,356,52,05040,4
c0f4c4e8fed00601f54e38d391d0f349,21,21,1,147,21,0,01014,1
25b06e2adcb5743ce6f7ba49c44d1fc8,59,38,3,137.66666666666669,59,0,08150,2
aa24da8380055069bd4364b2a36ec440,17,17,1,119,17,0,01026,1
a2e68ac1165236b3742f119dbc9976dc,9,9,1,63,9,0,08090,1
5eb6c52e0807d1aaf93ab548b57d2876,57,47,2,199.5,57,0,01012,1
819f82d88ccf36d521a260916ae4f690,36,36,1,252,36,0,01026,1
264f265ebe02f1654c4c3357217ab003,337,141,5,471.8,293,44,09150,4
22fd6916dc95bc1483a8afc3a1c8e3e6,49,38,3,114.33333333333334,49,0,03070,1
a120d2d810f1b037662cfa9e6b83ed47,76,63,2,266,76,0,05040,2
167334c9498c6ad03ffc054d3f2862fe,30,30,1,210,30,0,01026,1
0962eae2253d8c3cc7d21bc8ef5f3f0a,23,23,1,161,23,0,09150,1
40694e5cf7b44ba23714f3fc14cab5e4,51,51,1,357,51,0,04060,1
9ffbd2b2b0139037e4c9d088b88b9e0b,212,87,2,742,212,0,02690,4
83c62c04d56e4b3bd64321d1521d07d3,8,6,3,18.666666666666668,8,0,11040,1
0cb6fddde02a5d10b17457ea104ffd4e,65,41,2,227.5,24,41,04201,2
4184ebea860129360aa04e3b22f4773d,17,17,1,119,17,0,03090,1
df84b5680531d3f07e580fadabb4154e,85,64,3,198.33333333333334,50,35,05040,3
67e0cae15313380ff0972ec76681057b,159,68,3,371,90,69,05030,3
ce915cd0768651655ed71ea121498c09,61,51,2,213.5,61,0,10200,2
fae0251eed6967833d32aafd2a45c8d0,30,30,1,210,30,0,08010,1
99c8b19ee6d51ce84430ac112655cd00,29,29,1,203,29,0,14301,1
d508894dae73d379fa48c918d1a16000,96,53,4,168,96,0,11040,3
612a9d507158839b9224fa312c910a56,97,68,2,339.5,97,0,05030,3
d5e89173732508bc8a3fd9cf799ff042,95,76,2,332.5,95,0,09110,3
1945204f459864b29f33ed332779d3d6,277,131,4,484.75,277,0,05030,4
3e411261f2157309783a21a5d2ab1e81,46,46,1,322,46,0,01013,1
7eed6700bc89042c6c74e00847e5dd18,8,8,1,56,0,8,05030,1
f49f25c0d59b5828621db85bec99bd0d,184,112,4,322,141,43,10200,4
04a77b78f33ca7e7b8d2a05e46e44aa1,17,17,1,119,17,0,08250,1
16e11be0be17e5df21aa5ac67d0c19f0,45,45,1,315,45,0,04060,1
e0d9d5ae78865dfc2ba3e1ee48bdfdb5,38,37,2,133,1,37,01026,1
9f0d54e1d661b5f046b87b09337acb9f,152,82,3,354.6666666666667,63,89,05040,3
f7953e35e9f50a4dcfca1d157056d750,504,190,4,882,504,0,05040,4
4fdf16afada4c8af470b879667f482c1,137,95,5,191.79999999999998,137,0,01012,3
6ce130e91eae07f9ad53d3cc55c394d8,32,19,2,112,8,24,11140,1
ca2cd6816cb1e420c2e20f207feb0d71,33,33,1,231,33,0,03033,1
7ba623b77730d2540305bfd3c01d1d37,218,49,2,763,119,99,05041,3
4e7d2db446ba3478c5612884634a98a4,22,22,1,154,22,0,09110,1
f19b522e74c16b979dc9c7ce3040ea98,38,38,1,266,38,0,04032,1
1c97d72b80fe8d88cded81555038e8eb,277,108,4,484.75,247,30,01013,4
6501c851cd3361621f8afe0788aa3f35,46,37,2,161,46,0,02751,1
44b98a65258ecde5c28294cc54cbdf1e,20,13,5,28,20,0,10080,1
eda0688eb4a93f0c697eab64694c1804,20,19,2,70,20,0,09010,1
e1123b34bd839e4310656d1863bf86b1,75,62,1,525,75,0,05030,2
6972af97ce7341dd62ca31059ba0c937,87,45,2,304.5,87,0,02620,2
ca7313ef55c4d4b1487ff94b315b21cb,168,66,3,392,168,0,02690,3
8976199f1c6249c5b98e7e95b626cd2f,21,21,1,147,21,0,05040,1
9426721209130098492f5b425e793ec6,106,40,5,148.4,94,12,01016,3
25d259d32a2bc254343715f2e347c518,21,21,1,147,21,0,01026,1
2833bb53d1c994e325aa874121e24a8f,72,50,3,168,72,0,05030,2
96eafb3f7924eba1385d1466d68ad99f,16,16,1,112,16,0,08132,1
5e8a3f2dc34e8eb719643076b681be8f,151,115,4,264.25,151,0,01026,3
3a83f336d664a0a0f34af4120f785dbe,6,6,1,42,0,6,08052,1
f22a8d08375f7cde3211a9a63315e203,56,56,1,392,0,56,09030,2
c7cc82c53450279d5237fece9d221b02,147,85,3,343,74,73,11100,3
079e27e2f031617338f6a63b709749e7,23,23,1,161,0,23,08232,1
7851244ceb64d8b374c14189ae0ea281,153,72,5,214.2,102,51,09070,3
fdc0c2bda1a902e2a888b40fa12592c1,29,28,2,101.5,29,0,09111,1
24d360ce223260589a024cdad101e62b,24,24,1,168,0,24,02751,1
630f468023b24f0dddc724cbcf4f81eb,140,71,4,245,62,78,01012,3
e4f3574dbdc3334ba0a61be57e25a9d6,8,8,1,56,8,0,11100,1
c4fcf9f0f127d8e70fe242bac793ba9f,504,140,5,705.6,440,64,01013,4
5535e2a643f0d8ee6e720cb111bf8923,52,52,1,364,52,0,01012,1
3e2761d71b200220a7737c3b4a35554c,82,65,2,287,82,0,01012,2
0dd0f4099ed8d0d2207494edd9d69d1e,114,79,1,798,114,0,08150,3
99584103fa512f7a6f848d54296eb99c,10,10,2,35,6,4,05040,1
499388526e11e9e9ce75faa7d30adab6,121,63,5,169.4,121,0,05040,3
b8ecc7f8ba0668da07a3552aa8568099,111,85,4,194.25,57,54,11140,3
ec03051c83070c5a8de5e8ce8bc21840,107,72,3,249.66666666666669,107,0,01012,3
d71764d00343ef2d0203bc7ee26fa983,331,162,4,579.25,331,0,05040,4
a620b37dd12b19e62b1de21c5478b655,17,17,1,119,17,0,10080,1
f774b46d7c2caede73ae649fbf42532f,34,33,2,119,34,0,05100,1
867e97305a0de7216abff6d280f00f0f,11,11,1,77,11,0,05040,1
7b0b93c12f77cb22810ffe70e05941f7,9,9,1,63,0,9,12590,1
2f29d2a472b204383544621ff3dd2482,138,87,3,322,65,73,10200,3
31251877702d6eb50a74908b1587ce42,116,95,3,270.6666666666667,82,34,01201,3
1ce633a4e7d20be4764aa229178b6c58,46,46,1,322,46,0,01026,1
6df0339e2ad6e46357d73c6e43248e5d,77,64,2,269.5,77,0,04201,2
38008c9f38b62bcc8c9b51bf5165ff94,37,20,3,86.33333333333334,37,0,11040,1
f52d072b498c0af50badf926f04cdf0e,303,94,3,707,96,207,05100,4
0a0e2bc5b0e184b62de7bb0614a78269,26,26,1,182,26,0,03033,1
6e565624a29a9ffaaf46b2e064049096,4,4,1,28,4,0,05030,1
39b0dc83d4800f0fd8b336c78021c0c3,67,62,2,234.5,67,0,08230,2
fd27810626a2990fa5ccb0e7ae12cbf6,66,58,2,231,66,0,11080,2
98fbae65791110a117fab0f174b55c2a,102,71,3,238,70,32,01026,3
78e4056f6b334374eebb1f9bde864cfc,235,89,4,411.25,235,0,01012,4
db2f85e42924c5a1c654cb27054bb0ff,18,18,1,126,0,18,05100,1
aff5e475d0a55442fc122ab8c118a58d,35,33,1,245,35,0,01027,1
6d7df368731b3c9200292f496abb4a09,157,104,2,549.5,157,0,01013,3
ea69479c0a9c875033673fad0b92daa3,32,32,1,224,32,0,01026,1
dc8908efe20cd7ce3a952f3d3fd9d787,142,64,4,248.5,142,0,10200,3
b8461283ebfcacf957f692c4f80c1d52,15,15,1,105,15,0,01013,1
cd13fdd6585ba7a253af69feaac87597,42,42,1,294,42,0,09130,1
ed53fdd2eae6152b53ff5c4da1e8fc30,125,66,4,218.75,125,0,01085,3
4f4d359226fac264e0244314d422f6d9,24,24,1,168,24,0,11100,1
1e03b443fb3897dd408365d53387c33e,106,84,1,742,106,0,11080,3
85bfdd51c3cc0c2c872309aa58e5e95c,488,124,4,854,452,36,02751,4
dc9606c4227ac07eefb3cade0408c900,15,15,1,105,15,0,05030,1
d2cc50c598ff5190cc7711c19ab77f2d,61,29,3,142.33333333333334,26,35,11040,1
5d8ca17a56a1942dadf81e8aa53c2bf2,51,44,2,178.5,19,32,02620,1
cab93d3e9bfb3f34eb079cf19229b884,64,54,2,224,30,34,10220,2
3be4defda0f886e305d8104323c1a3bf,86,39,3,200.66666666666669,86,0,05041,2
e8a4ad5b483bcc84f7fd1585d9ce0b12,218,104,5,305.2,187,31,05160,4
54f2a5b225184944f76b918f09a4b340,123,63,1,861,0,123,05100,3
c2ab892cc02e69417d51027e876f0fee,49,49,1,343,49,0,01026,1
a9c2718524beb0354a5e94881beac057,71,62,1,497,71,0,09010,2
2d4caf7120ef5e1599df3037d85a5291,63,55,2,220.5,63,0,01027,2
4f0e58ff6c96538e170ff7b59b72c1b0,28,28,1,196,28,0,06100,1
2f04f7c0e36c148b7b9681e244a0277a,70,70,1,490,70,0,02690,2
ce2f1c42be00a9acfebde646e553102e,166,96,3,387.33333333333337,166,0,01012,3
ef5809484cd8eef348a8f23c872a8c96,272,125,6,317.33333333333337,248,24,04020,4
4d1a13b95a2262f54c12bb8297e776cf,100,58,2,350,100,0,08032,3
4554a5c147aa2af749075cbad295cbb0,34,30,2,119,20,14,05040,1
dee4ffaa9aa745595807cd0b483ac578,14,14,1,98,14,0,02650,1
6dcfc8813988b1adde6e7478ccbd05b1,86,73,2,301,86,0,09010,3
202fb6e12755dadb99780cdb0a959409,237,139,3,553,237,0,11100,4
75c7b51487b57a15ee0024338fd77144,19,19,1,133,0,19,05100,1
87e924d28f3012bb03976eb37fd99899,44,43,2,154,44,0,09130,1
7661a69ee479318cabffcfc8e76c17e9,105,69,1,735,0,105,05040,3
598c3cbe6ba068d5b82c733da5763c26,23,23,1,161,0,23,12501,1
eaf034e6f464a1ab32cbb6e50f995694,479,132,4,838.25,479,0,05100,4
cb281fe4dcf1cc1bca52de84fe4ffca3,106,54,4,185.5,106,0,02690,3
d820a8fcb7b4385ff32d29b952e453a4,61,52,2,213.5,61,0,10200,2
87060dd6018290af12df656ea9c031a9,140,97,2,490,93,47,10200,3
8d815485cb8e291ffd572cec63ea21d8,24,24,1,168,0,24,05040,1
055d573048b7dafedda7c1ef41a42d78,102,88,4,178.5,72,30,03050,3
291629c21b16aaa73aef88f75760f70f,3,2,2,10.5,3,0,12500,1
b0b4a60cd15759bd700edf5a00a8aa58,23,23,1,161,23,0,12470,1
81c435ff51f45e92cd62f8b5bbed210b,333,134,5,466.2,297,36,10028,4
dcdfef864ccbc289fe9e6e6abd4d2035,29,29,1,203,29,0,08100,1
e7bd7ac667a1c9c896fda4466dc10e35,117,74,2,409.5,117,0,05030,3
be41c8d68c1be2e1e0dcacf3d9652bd2,364,118,4,637,364,0,01012,4
eabcb9c0781e14a7b6dac90df859b8ad,46,46,1,322,46,0,02650,1
2d7eae4ebda4279d75bcddc38d66257e,55,48,3,128.33333333333334,55,0,10240,2
e7623f42e35d59ef788d20a61b6c880c,15,15,1,105,0,15,01026,1
a3f8ab8935847859630dd87a61a92d88,58,58,1,406,58,0,03050,2
b95758ccace051c9f32d8b8df76f3a56,176,123,3,410.6666666666667,71,105,03050,4
2be2b36eb184ec2f216d8a7c5961f586,25,25,1,175,25,0,01028,1
f1b6570bddf318af97be24e8baceacd7,19,19,1,133,19,0,11080,1
3d68ffd64d7e4d974164759a3fcc3303,18,18,1,126,18,0,05040,1
471e743a10fdcaab6d5273123955af17,240,108,5,336,125,115,01027,4
5e0d0c020dc841e74c596f22e0580e77,63,47,2,220.5,63,0,04060,1
47853653f50bcc76461eb72288286b35,266,130,3,620.6666666666667,168,98,05041,4
8415f3699cfee306676719f1832a13ab,82,60,3,191.33333333333334,57,25,06100,3
d3f4ef3087b02dda4b0ef0abcbfc7b6a,35,35,1,245,35,0,10240,1
c82e314144a050117c1daa750e402fcf,32,32,1,224,32,0,08150,1
416c18aca3ce6d30750d765a26c0590b,12,6,2,42,12,0,08170,1
1f7e55fba5f6f36a8d38a9fe76243741,239,123,3,557.6666666666667,190,49,05040,4
df6ad7b2496f044eb5b28b411cc825fe,29,29,1,203,29,0,02691,1
3ceb82571abd0309cf844094415901bd,179,121,4,313.25,179,0,05030,4
1aa14137a3c6923c0c826a292c4b95de,213,109,3,497,213,0,01013,4
3ec90b6edbc0f2ba8a4b1775a6b58bed,477,171,5,667.8,477,0,05040,4
aea4db729395d90e793e96139dc8220f,26,21,3,60.66666666666667,26,0,08452,1
a465285ee20dcf9c1f96400ec5c1f1af,85,71,2,297.5,85,0,08090,3
6c9d941ad5f7eae0aec9f99b5925790a,225,133,3,525,225,0,10200,4
fede9817faeb3a5c54ab7fd7b51ebe7c,66,60,2,231,25,41,11040,2
d5a9290942a948330fde2f60bb702b50,93,67,2,325.5,93,0,05040,3
583cf92c439bbd347b93413fe95939e6,64,64,1,448,64,0,01027,2
7fda9a38f9e517beeb54fb00423c8ffe,68,39,3,158.66666666666669,68,0,02690,2
301b0312afa5b078c64a2cf950a955d5,398,160,3,928.6666666666667,398,0,12590,4
e4e4a204f02eb935ffe6529e31b41430,37,37,1,259,37,0,12590,1
dee2c88d063022849400c528585191c9,129,93,3,301,129,0,04020,3
5520de0f09126ae5921d02852049f730,48,40,2,168,48,0,01027,1
3e72e9706a3eff685013c2b3336152e5,55,44,2,192.5,55,0,05040,1
c3fa85e5504c1ea088f2d5064f7315a8,76,41,3,177.33333333333334,47,29,05100,2
b61e306f9eb41f3853e678bd9c7a6bfc,316,120,4,553,283,33,10153,4
7c8d6e39acecff5320e84828f39eaf88,35,32,1,245,0,35,08090,1
9dc5d11e8e2da08214f7b31a0591fb69,327,107,6,381.5,244,83,05100,4
f55c6c93967dce142a19ac86d4945581,25,25,1,175,25,0,09010,1
afac9d4afeff6e3e22b47473f41d1372,25,25,1,175,25,0,01012,1
0dc3873c4e3bae83ce11514ed9d39be1,42,35,1,294,42,0,10200,1
49753689f1a36f01a18fd6f440c61204,35,35,1,245,35,0,04020,1
eaf55fd89856b4fdd6c9190932a36a96,249,104,5,348.59999999999997,173,76,05040,4
142072739b166c68707344e9cedadb66,118,72,2,413,28,90,09130,3
3add3d77ce9acc3eed62306729ed3b1d,33,14,3,77,23,10,05030,1
0018ed38657fd19d98728f532388f2b7,249,131,2,871.5,190,59,05100,4
006b4dccb949a465d4226584f7f0a7c9,12,12,1,84,12,0,04060,1
96aa2dc57330ea98bc1a367e54551403,43,36,2,150.5,43,0,11040,1
ca9cff9996fe255f755b8c2545a016c5,133,98,4,232.75,133,0,11100,3
c135112e3cdab925bbc09465716f3764,190,98,5,266,148,42,05040,4
0f9e666afc5bf2d87fd7aec50027cdb1,93,62,4,162.75,93,0,01013,3
ce1c987f4694b6d175221f3897bad4f9,62,41,1,434,0,62,01012,2
c88f95be999e27f2033ff25c7628713e,16,16,1,112,16,0,01012,1
d1c07c9380a5e9342c58527a8d9f1637,80,68,3,186.66666666666669,80,0,11080,3
4c3bd42a44f2e737750454114e92a2d2,19,19,1,133,19,0,10028,1
46300a6df4c979644b8f6badf03e94a8,58,52,2,203,58,0,01027,1
ca2251fcf1fec1ff46d81404b698ae6e,369,134,3,861,68,301,03070,4
8f7f6aa65231ac70ec6e9d1a8c0e8f84,279,111,4,488.25,210,69,05041,4
145846a7739f83eb72df8333c2f2be14,22,22,1,154,22,0,12501,1
b649dc8b8f48436c6efa40009f8d526a,287,130,2,1004.5,65,222,04032,4
85c6f75fc1f8b046c855fc07f6576600,23,23,1,161,23,0,03070,1
3356580ef5357f44b1f2fefbc6af033d,82,71,3,191.33333333333334,19,63,01026,3
a2c3cdf28233de3b697beaf03f1b9dfc,187,113,3,436.33333333333337,187,0,14301,4
78dfa9615b8e339c741affa8720bdd17,27,27,1,189,0,27,11080,1
9f0470c5c2811e1bcdd0fff5b05bedee,58,58,1,406,58,0,08031,2
6ce83ab86a044b6ab61bde7a07bea758,64,50,1,448,64,0,09090,2
1cd9e9dd32aff09e7f475316e555fee7,52,36,2,182,52,0,12710,1
daa0d4fa9507521c3f960dfb1662f597,97,74,5,135.79999999999998,97,0,02650,3
3e7af12a5921a0366f5ce5c934a43b59,36,36,1,252,0,36,08134,1
4d30b476b42fb1181dde4978b8b254d3,104,79,2,364,104,0,11080,3
7d53a6f44026912398ae8ea0eb5af3b7,57,48,2,199.5,26,31,03050,1
6f4462a2c497985562d369c186d61b74,19,18,2,66.5,19,0,03090,1
792c764d148772ce48d13f8a0c71a728,23,23,1,161,23,0,04020,1
32bc3f25b32e954d65ff81e6b7f5c815,20,20,1,140,20,0,09030,1
b3b4ed6864b8bba05fcb2f5c225cf398,7,7,1,49,7,0,08090,1
5521871eec5cbde4f46b61517d1e031a,18,18,1,126,0,18,01013,1
4acd46331a1df4c405505ba753e3f5e7,11,11,1,77,11,0,01012,1
543118a7e4ebc11bc18a7f0533f6bc5f,240,128,3,560,240,0,05040,4
5449e57336ac6fbe6de39105944cff3d,25,25,1,175,25,0,10200,1
2afafe9474fa2d7504e6c84700b7011d,41,41,1,287,41,0,05040,1
045044a15cedf2d6168e4e05ad223309,15,15,1,105,15,0,05030,1
09c3c0e84bbea74ea6b9d229ce87d119,30,30,1,210,30,0,09130,1
d41dbd6c5b4d042caa8f1e045a710e7a,29,29,1,203,29,0,01012,1
5d568bf9e237fd096f48ddf87e118ff0,21,21,1,147,21,0,01085,1
18a7093171f2b1fce5f4c6901a286f2d,216,137,3,504,216,0,09130,4
9fcb92779482b96116d745d6c8de723b,19,19,1,133,19,0,02650,1
7a5456c0686c32914385aa8dae0dd172,31,31,1,217,31,0,10080,1
28e41423745c6f4347cc8643fdbec00e,65,50,2,227.5,65,0,05100,2
b31a5a4ec10cad9ce7ff03e92e73c8c2,12,12,1,84,12,0,11080,1
3fc6cbdf1704f930a4f783ffbf6acee9,44,44,1,308,44,0,05040,1
1bf91994b9ac0830bff2eeee5da8a066,52,41,2,182,52,0,05030,1
560201373b45cfaf4e32c43a7bae63aa,61,50,3,142.33333333333334,61,0,02620,2
ae98814552327e01d2ff592254703193,27,27,1,189,27,0,05040,1
70f84a669af814322fa5a28d4bc28558,83,57,2,290.5,83,0,01026,2
9e6b296017b4c8097158f4cc3486501f,361,141,5,505.4,301,60,05030,4
fb94e436533160f5cd9c0899dcbbb0e4,111,55,3,259,111,0,01085,3
679d7e868837f4c0a4651b62bba1c67e,55,55,1,385,55,0,02610,1
3389e180eb540af6904a33b998ede9ec,83,66,1,581,0,83,10200,3
31bcdc86785f8c2bf53345aa2ce669fa,38,38,1,266,38,0,01026,1
cc8dc5f8ef3dc49373cdce4c57e97327,34,34,1,238,0,34,12501,1
de369d97e9e249d85a32b792bccf2745,14,14,1,98,0,14,10200,1
edbf759493d0196a1bd188d27960670a,14,14,1,98,14,0,05030,1
2e9738c312fe2b6aff669fffd84cc034,98,63,3,228.66666666666669,51,47,05041,3
0f7ca97a17c37dc0df59430ef62c074e,28,20,3,65.33333333333334,17,11,11140,1
65ca5a3c5477d306a83b7a957fe3262f,12,12,1,84,12,0,05030,1
2f5711809c9bb20c4978dc0823bc0421,45,45,1,315,45,0,05030,1
f7369b6bea0d9432c39df3415be830e6,391,180,3,912.3333333333334,212,179,05040,4
b4f3a9fe91106342dcecce85cebd7fc1,68,53,1,476,68,0,05100,2
d423db6b45d37e8e203e2fa6c24ff2b7,28,28,1,196,0,28,04032,1
e0e6350cb1afb2a9e34b4a38229e0d17,12,12,1,84,12,0,08100,1
f83330849f114bccdabfe3364be83543,50,50,1,350,50,0,05100,1
c35c3f83daaa1bda1b6fcb8b557b3005,88,72,2,308,46,42,02620,3
9a799cba2d6cb8c6b8eeb9d2a3a60b2a,1,1,1,7,1,0,12411,1
df1491aca400904bc4dedc9d503d84de,64,64,1,448,64,0,02690,2
78b79c4dccbf29b7f2f944b321046673,97,75,2,339.5,45,52,01027,3
01599b295eb7a50450ea74b9a82ad693,105,66,4,183.75,63,42,04020,3
a6cb81126303fcc130c61dcf9cb9b203,193,108,5,270.2,147,46,13877,4
b9d536012c08f41f20556850a28bd8a2,106,94,2,371,49,57,03090,3
7f3e1d007c5e432c7d8ccc9885606c71,294,135,4,514.5,294,0,05040,4
7feee019820a6c4ae7d8621b437d3bf2,72,62,1,504,72,0,01026,2
9d3515931a2e8239b24b1f38dbb12f0a,23,20,2,80.5,23,0,04012,1
6e9695d18d51a971df3c56e1d991facc,338,207,3,788.6666666666667,338,0,01026,4
a8690d900ca3a15ee8d1377f6c6d2143,42,32,3,98,29,13,05041,1
b3f7d8ace9c0aa822bfc4ba5ee36e059,23,23,1,161,23,0,04060,1
e5b2cea838d64062b6bbcd1f3f7428af,30,30,1,210,30,0,05040,1
5438c6e29894f7be5cf4c999850c3a64,58,42,3,135.33333333333334,36,22,05030,2
5db855f8df842760ff4750dc82e36bc4,30,30,1,210,30,0,05030,1
ff57ff076179ca8dadf09fedf094b4eb,27,27,1,189,0,27,01013,1
ed3fb9d12358f7fb58e84fc3164227f0,199,137,2,696.5,199,0,01026,4
a72f604e25bcc0d77467019049f2d225,298,122,4,521.5,298,0,05040,4
868ceb95733dba070fea06aa653c3b83,604,151,5,845.6,475,129,05030,4
d1eb6dfe2b2afb33e8b1fac4f421c1b6,36,21,3,84,19,17,01201,1
c2c63775153d396f3157d1e28c23db99,89,63,4,155.75,52,37,02650,3
dbad922413407faed7eed0fa943b64c2,48,43,2,168,48,0,01026,1
9d972cb3e812063f9b6dd3ce467b0d51,460,157,5,644,399,61,01013,4
a1b1915be5aedb2772e40d171bb1154a,54,33,3,126,39,15,01012,1
6a57b03a960c1f954fc2198cfb5e2475,46,46,1,322,46,0,09130,1
183ba6e96a285cbe3a72556bbc31e76d,166,86,2,581,166,0,10200,3
f392ff01bf60e208a76aaf6e33e39e21,9,9,1,63,9,0,05030,1
2d063a8d6f6f651a83211a5c9959b8ed,34,29,3,79.33333333333334,34,0,01013,1
1fadaccb6bd5445e7cd4e62e347e23a4,93,50,5,130.2,83,10,12410,3
9593b8f74d4330f778a8f052cd626921,120,79,3,280,81,39,04200,3
bf871f036c6ab733b5b52167e8e8a6b6,159,117,2,556.5,139,20,01026,3
54ef72eee6e159cca3ebc5617bd8973c,66,47,2,231,66,0,01026,2
0156c5fcd108f029e4eb4d40f1e15847,56,52,1,392,0,56,05040,2
75426c8ca610ca9026e545297ba0fb67,28,28,1,196,28,0,05040,1
47a0190103624b01ff0bed85a254f52a,29,29,1,203,29,0,01016,1
1fd221c55c042830cbbe2073da3dc420,142,112,3,331.33333333333337,142,0,05100,3
64c7eaf418be99594dbfba7f0147eaef,135,72,4,236.25,109,26,01026,3
157ec8e09bd2b2bc73482948a091e352,216,88,2,756,216,0,09111,4
4573ac750a1fafb015df76ffb0234783,18,18,1,126,18,0,01012,1
b2c38883b5829ccd13cc07ee874cb2e5,113,82,3,263.6666666666667,113,0,01027,3
7dc912482a06680d735734caceb1f38f,95,80,2,332.5,95,0,01012,3
2f7822682e3d8af05cbe30cb0e1cfc88,69,52,3,161,37,32,11140,2
c8138921567eabde5fde502e033b32e4,45,45,1,315,0,45,10200,1
d552bf55d5eb7bc6ca9f16366fe142c9,44,31,2,154,44,0,05030,1
79b192eff18f1682dc631fabe7d2b1a3,108,73,1,756,108,0,01085,3
829344e768657c109ddaf776455a1e6d,93,52,2,325.5,93,0,07122,2
2c7f8919b4aeb27367d476f7555dcc97,130,83,1,910,130,0,09090,3
5cd999f31c123a9ec106635fb48a1ce9,84,55,3,196,84,0,05030,2
946e5a82c7acd9fed0727fdacc8723e4,30,30,1,210,30,0,11100,1
18d6e795cbc2fe6521c235090b0300c7,16,16,1,112,16,0,11100,1
0f1067075aa9d0b96d5dc9ac0e9ef105,328,139,3,765.3333333333334,245,83,05040,4
9b4681fa2601e67e2a7d3e653febc7ce,65,53,1,455,65,0,01012,2
7dc8f4d42fc3fa5130f8c085b9b27f62,446,203,4,780.5,446,0,04020,4
f8a6917dafe5590788fbb9d2e5ec7b2e,9,9,1,63,9,0,04060,1
b82811545728110e16c0bb448ba5fc2d,155,95,5,217,113,42,01026,3
bbd6d3215cd82534c1720c5bd4222598,2,1,2,7,2,0,11040,1
e6924c7c0986aa170c5ddcc8fc6fa235,66,60,2,231,11,55,01026,2
fa51baf913cd036145e978268e744393,25,25,1,175,0,25,01012,1
fefcd80fdd264be3b05cac5c89428bd3,15,11,2,52.5,15,0,11040,1
3ebc65fd7e1e42fcea215dec9163542a,10,7,2,35,10,0,08032,1
77d6bb0f67a7a819ff43d0b96bc0bcb4,22,22,1,154,22,0,01012,1
94a4872cd01a9c6fb0e6f2cb34a63f8a,271,134,5,379.4,195,76,01027,4
1844dcbe6627fb230b437bd456af98b0,58,41,2,203,58,0,10200,1
9d0f1ec53d85aed6e43a6c556be62ed0,34,32,2,119,34,0,05030,1
aec60563513567a54cb290ba9d2b006c,142,88,3,331.33333333333337,87,55,10200,3
46395158d5280b6f78e0333fff84fe25,49,49,1,343,49,0,04020,1
b6c6b1f2b5068d163dbff4c9be49c025,17,10,3,39.66666666666667,11,6,05030,1
f4d577589f8b335a6afffd93b2624391,157,80,4,274.75,122,35,05040,3
68664fb8d61464cc1b2526417d29da6d,398,126,3,928.6666666666667,368,30,01027,4
baf23e0c3470a22fbcff722e91cafef1,11,8,2,38.5,11,0,12410,1
bc137bb75951e7de92d6b54061800e99,90,53,3,210,71,19,11100,3
1bee970bf7c5eb9f28277929af334102,233,140,5,326.2,193,40,01026,4
a377ea45aae74797334b8b7436a7d0f2,95,55,3,221.66666666666669,35,60,01085,3
6267af12286f4013dabc9eccd6f8d6f6,4,4,1,28,4,0,04060,1
d4b555da90811f907891c796677747af,246,130,4,430.5,246,0,01012,4
004c726a1f31128ad5b9f70b9f6f000d,43,43,1,301,43,0,01012,1
facffd353946e0094f430e40bf57e611,32,32,1,224,32,0,01027,1
ee4948da2ec66a9fc653d14319f9d9f6,36,36,1,252,36,0,10200,1
48948c40e31c744e2831ac37221fd5cd,30,30,1,210,30,0,04080,1
df4c744da24e92905aa8056d36933fd9,21,21,1,147,21,0,05040,1
55e3e080cf7e406e1601f6590f1a893a,348,135,2,1218,27,321,05040,4
9dc7fbe01733740a6364ef40c1befbad,29,29,1,203,0,29,05040,1
21266bad207e02cf44f90f80e114a2fa,160,81,5,224,138,22,05040,3
f925ae0c6aaaacb4ea86f01ef49f29eb,69,61,2,241.5,50,19,05040,2
b93d1080e87d7de6ccf9c7ccc8f6148f,137,105,2,479.5,67,70,09030,3
b85b3411d0538591b3a97a365aae2ed3,142,60,3,331.33333333333337,142,0,01012,3
ee1d6b792fe7edfa110b61cf191a6ca6,27,27,1,189,27,0,03090,1
258eb0a5facb1ccab9e127314207d894,69,57,2,241.5,69,0,05030,2
6ae82fe8387c158af5b0123ff0cba445,339,153,6,395.5,270,69,01085,4
8ff5e73f8d95ec2d662be48a8be2b551,63,63,1,441,63,0,09030,2
a5fb72b6f83eb459977046edd04ec5e9,22,22,1,154,22,0,01026,1
3bc734fc7afd5026262cc858ba8f485d,15,15,1,105,15,0,05030,1
3c046e499fd6564e1ffe84a6df7950c8,181,129,2,633.5,181,0,04060,4
6db4fe1162fbaed816b9f9be65a6d04b,191,115,3,445.6666666666667,191,0,05040,4
915921500eae7405d02ec51290a79690,79,40,5,110.6,74,5,04200,3
62dbe4236076fe3f6c9f60ca9e80da23,1,1,1,7,1,0,11080,1
d546aeae42cf93ba59c867ced795b5d1,51,51,1,357,51,0,10240,1
643d1ec034fd6cfb2171a27aaf1b619a,59,59,1,413,0,59,11140,2
9657fb6d8654b5402af0a2ca8dc5ad01,107,72,2,374.5,107,0,05040,3
6d7dde9336a7011cee4f83175a4efc04,191,85,2,668.5,191,0,08010,3
1a7445d2526c9ad9ea6cf875bb27e2d2,36,36,1,252,36,0,01026,1
7b26a829ab5ce19ff9b42647e2db8486,98,77,3,228.66666666666669,69,29,04020,3
1f8e7217aa343f146ae530cd60029c55,141,98,3,329,105,36,11100,3
6d89645af101b71a15d9ca7b7bea3f38,6,6,1,42,6,0,01013,1
74fc6356c8e286b374200fb2b3ac18ff,31,31,1,217,31,0,01085,1
5eae4a4732fb7d683a13d8e529c0af22,16,16,1,112,16,0,02751,1
253bf2eaa5e73e326f5297fed8210aef,165,124,4,288.75,122,43,05100,4
d1b5288544823f4cf3c9b013c099896c,54,43,1,378,54,0,05040,1
e599b05d4c227bba1cddaec7ce240ff2,98,56,3,228.66666666666669,98,0,11100,3
d3ea2548a7a41b611774f8d62ad17203,33,33,1,231,33,0,08452,1
8d450895c5e98dd262b36a0d481f3658,24,24,1,168,24,0,11080,1
4924cd7502f5d82214b870a09479b71c,27,27,1,189,27,0,01085,1
c77485a1b9e3e0b567dfdb81a1535ddf,46,46,1,322,46,0,09351,1
e911eff384edc98830e52c429d977bb1,42,42,1,294,42,0,11140,1
d6dac323a0a6f45db200adfb937d843a,23,23,1,161,0,23,05040,1
c9c35bc9442c32907e9f529ec69241c1,15,15,1,105,15,0,01012,1
294970e5254e97f14da6c098e730b77f,41,33,2,143.5,41,0,13820,1
addf0b61370b45308e79b884c87876a1,25,25,1,175,0,25,03050,1
ca0ce69806920a976e37c412bbe9f13d,3,3,1,21,3,0,11040,1
1c7e9d85edba58fef3568249f9b3c577,243,139,5,340.2,210,33,05040,4
83ce0bf78cdebdd1e566f67218407cff,47,47,1,329,47,0,01201,1
d1af273a64027c58aa4614fe0dd8ef59,35,35,1,245,35,0,05030,1
c346e5d30994daa9818b076cdc729e7d,12,11,1,84,12,0,09170,1
70ccbe14b809b24f33da288704cac623,31,31,1,217,31,0,01012,1
5cf940a27b4364e4492677c11ea46de8,14,14,1,98,14,0,01012,1
ad8db9d09928529046dd7aabad4da7b1,69,69,1,483,69,0,01013,2
cd780e06c229c4bbbd1c82f8f110f611,45,41,2,157.5,45,0,05040,1
a3a2d656dfc0db24989a0c0ecc83529a,74,43,1,518,74,0,01026,2
0c5eee5b19bed214200251a5e3b235a1,78,40,3,182,78,0,01013,2
b2e11368888311d788ecc8e9607b5c70,104,81,3,242.66666666666669,104,0,09010,3
662b21c69dbc777a24508549691abd54,15,15,1,105,15,0,01026,1
69446461ec4f6bf0586e54f37c59d807,102,67,1,714,102,0,05030,3
e32846e900dbf65a02ac34ba00b9da5a,31,31,1,217,31,0,01013,1
3d56236ea1cc3de22b8e7718c290f82f,65,58,2,227.5,46,19,05040,2
212ca7c827e226ef1561f60910f386d4,36,33,2,126,36,0,10153,1
a1b50f6063f06bab0cedc3e74b70b48f,3,3,1,21,3,0,08100,1
49c7320d4b1764ac115966a1356bf062,129,75,6,150.5,102,27,11040,3
fea559ca08d18e0e81e18c3e3e3b469d,143,71,1,1001,143,0,01012,3
9237676f9baafc004bbaa52a5df5e11f,13,13,1,91,13,0,04201,1
944d3c130ff36cd586fbc1568d858ca7,33,33,1,231,0,33,02691,1
cf807ccab8fcd73b9d2b105ed8b2c8bf,89,79,3,207.66666666666669,89,0,08230,3
5406aa674925042d7a0bec4d1c6deff1,26,26,1,182,26,0,11100,1
e8513d6f98bc5ef0de529f7245104559,51,46,2,178.5,51,0,10200,1
014635187859f855633649a0e853940b,99,56,3,231,68,31,08010,3
710d9753cad854ac8c470f77ea5ce725,64,53,2,224,33,31,03070,2
0ae569c3572bb3b170b5687b6ac41bfd,26,26,1,182,26,0,10140,1
5c5aa1dffa4eab18020a9f386c315c33,16,16,1,112,16,0,01026,1
727289de50ab03feb1736968934bd0f8,57,44,3,133,57,0,05030,2
4ef1bbcb6fea66b66b8eb54acd8ff46c,41,41,1,287,41,0,01013,1
76b6bfb97ce648412dc7b2a923749b2e,26,26,1,182,26,0,01026,1
8e38ab2b16a69af4916affc29380d0cf,134,84,2,469,59,75,01013,3
f803ba6bb00ea2291ea294b529d1c15a,388,177,4,679,348,40,01026,4
85952557a9adb16f0146fcbd082b2a48,20,20,1,140,20,0,03070,1
421001441267263c496e26f6ad341eab,32,32,1,224,32,0,01028,1
d72b7b5bf8c9d63fc3fed9795599b3bc,36,36,1,252,36,0,09130,1
be6dbd368fea942f0cfaf451f3f51226,105,80,4,183.75,74,31,05100,3
e6cd2c3bdaeb32b3ace1d62136174051,8,8,1,56,8,0,12500,1
aa4ead4aa04d3a79ae63d429d4afca9d,9,9,1,63,9,0,03070,1
ac5cec3d6348331c20ffcc77c24d8f82,111,73,2,388.5,83,28,05040,3
deeee33114a375cef1ab32824576d100,45,45,1,315,0,45,10200,1
01739ec6a9f5d91ecc94ea509c50b44a,88,64,2,308,46,42,05040,3
35314c7f3378be7e7b64f3e343fe1ec5,36,36,1,252,36,0,04032,1
3034a687db3ba90403b00c11c54bbe1d,344,99,2,1204,3,341,04020,4
64233f9fc383df5437eb2350d42df781,79,63,3,184.33333333333334,79,0,01012,3
f06a8126832853ee2747b712ce71e2fd,71,50,1,497,71,0,05030,2
c84c3bb0def63c3098ca3d12c8740193,93,71,1,651,93,0,05100,3
100ea275c1df614f79de130520d61428,22,18,2,77,22,0,11040,1
33db19525a825c4db94f459c2d12c217,24,24,1,168,24,0,05040,1
75bac216795bb28f4671a92cc720a68f,217,115,4,379.75,217,0,01026,4
957ae92d7a79587d74821b8cc9760d97,119,77,3,277.6666666666667,16,103,05030,3
a4ac32929b4834c7a953b86272295979,16,5,3,37.333333333333336,16,0,05030,1
c0a09b4482559703c96ab1d23816ec7b,42,42,1,294,42,0,01026,1
39ff4c3716c4ead7c03b2da56a0f5b29,24,20,2,84,24,0,11040,1
8763e2eb78d94befe89225f744243510,33,31,2,115.5,33,0,09130,1
f8c22dfbdeb7e9f86424fe173750e5e3,442,130,3,1031.3333333333335,442,0,01085,4
36fb5c54e2844fb2e1e8d97000b4a87a,35,35,1,245,35,0,02691,1
2036572353b775b5c0eb6a7f6db1eb6b,14,14,1,98,14,0,11100,1
82bca9a006f24c4cc64e0f7cda040006,32,32,1,224,32,0,01013,1
3dbbba23ecbe634c720043f8476ca774,349,116,1,2443,349,0,01012,4
8d0fd2b45538a539a430351979211610,136,80,3,317.33333333333337,70,66,01012,3
75946b85a7f0fcde5ef58fb5efce00b9,16,16,1,112,16,0,01026,1
6151b625aca88c6065a613e118a5fc22,55,44,4,96.25,55,0,10200,2
d4096f7d78c4a642ed0c4a1fb064db32,49,41,2,171.5,25,24,08314,1
7785b3f29571cd19842d48893c78f011,44,44,1,308,44,0,02650,1
bc4946fa674f487b2f5b441d8e6af431,89,56,2,311.5,48,41,01026,2
f3b70a24dcd1b35c47f870154526e079,17,17,1,119,0,17,10261,1
494d45779d4a778e306eb98fe8a66a83,215,125,6,250.83333333333334,116,99,05040,4
b5d8bd1eeaf5f7e8efe335da23c74978,30,30,1,210,30,0,08314,1
86f86a85dd370b3d8ba1c6e4242ab2a7,68,66,1,476,0,68,05100,2
4bebd7e12e089d73e70444ba7b33d653,201,125,4,351.75,149,52,01026,4
72e0777f95eecc7c4d487c9fbe54f492,87,68,3,203,87,0,05030,3
cc84ed819cbe7dbbd8c435dc4b3472bb,28,28,2,98,28,0,01012,1
8e0e9fd6de5c8aac710d9938382595f0,81,65,2,283.5,81,0,01026,2
7a57a4f7450c3719fccd372c5fa2e487,122,60,5,170.79999999999998,122,0,09150,3
d64e9e8290fb182cd4592f18ea6030c1,30,30,1,210,0,30,09150,1
6aad42908f02b2476e4a8e60fbf0fcea,21,21,1,147,0,21,05040,1
852048053bd4fe0fe46b979e984687c4,22,22,1,154,22,0,10220,1
0934d79b0c2b07e738a6d5d965c60694,42,42,1,294,42,0,01012,1
5c062a311ad27945bba1bc6ae93baa3c,67,51,1,469,67,0,05040,2
464ce3b5ad146a4128cee1c353143e56,24,24,1,168,0,24,01026,1
66d5c47eb272eb3fe4522f06c4afb8eb,174,88,3,406,174,0,01026,3
5cafb9e9e7fa401a0717f1f92f642665,14,14,1,98,14,0,14301,1
41fbdda8bbb6297edc614064911eeee3,49,31,2,171.5,49,0,09190,1
a95b030ef50ca85c86db9d7146851c0f,21,21,1,147,21,0,01026,1
d836ab11f028445f827f7f90cad0d52b,267,106,4,467.25,267,0,05030,4
f6be7edf74ae709c730f28dbaff0c552,112,88,3,261.33333333333337,112,0,01027,3
fa7ff6a6d6bbf0fc2e384dd97301f901,48,30,3,112,48,0,05030,1
f250e71c44cbcc2b298b7c8bafcfd1ea,73,59,2,255.5,73,0,12590,2
17903c6be2eca58ea945822cb069eb86,50,49,2,175,35,15,04032,1
ddb421f9abe384b7f4e2bbe42adf7055,308,120,4,539,280,28,05040,4
47f3e242e6d04eb24234bd3f88f9a9d8,10,10,1,70,10,0,08010,1
fa64472780b62cc3d59c839bb1f8f47c,105,60,2,367.5,52,53,05040,3
ee17018aae57b7fde0b6b1e9f6e3694f,224,171,3,522.6666666666667,224,0,08090,4
9fbba902de76b34b16313e533c87f49f,186,122,3,434,186,0,05100,4
18b1a0540a7e96c6180538cfcf6ec6cf,46,46,1,322,0,46,05040,1
e320e94bae4868b5f00502095dc935a9,39,39,1,273,39,0,08100,1
3d70b12642da63a562480c090d483da7,32,32,1,224,32,0,10153,1
7f55529ccd020bfd44317174e9989213,158,103,3,368.6666666666667,107,51,01026,3
68d48466e2a1775d7951c1c3d9053c92,21,21,1,147,0,21,03050,1
5bc438a8a7add7fc67200255c6218668,69,63,3,161,69,0,08131,2
cda78e2e4dcd286d2dec97322fce7c9e,62,44,1,434,62,0,01013,1
b09a48ad402690e65d5fa9ba0472d487,52,38,1,364,52,0,09130,1
6146abecbbe5e2ed9a1a49df589c642c,57,49,1,399,0,57,01026,2
b3583ca044aba7a614f2b82652a77e7d,42,29,3,98,42,0,01027,1
cab9351ba4fd6f254e1d091837c512e5,51,39,2,178.5,51,0,05030,1
d620fafca0b487c700122f16d2da38f9,21,21,1,147,21,0,01027,1
65d34429ba5e27fddc181732f810a1f6,100,58,4,175,100,0,01026,3
01a247953015c71aa8b2d17fa8fe94b2,21,21,1,147,0,21,04060,1
5e4c7aac6f42a12138bbb97fe86596fd,199,118,3,464.33333333333337,158,41,05041,4
8fa37b04183fa8af777cc18f3fdfa2b4,52,43,2,182,14,38,05030,1
40049807a0c11f4d38249b97883b81de,52,52,1,364,0,52,05030,1
bcb9d0acd9a66b300ad5773182e6ce98,41,36,2,143.5,41,0,11140,1
ef757cc22464d58976f866af2caad396,34,34,1,238,34,0,08452,1
67938a7d6181e859f01fc2969e2bdb3b,19,18,2,66.5,19,0,10080,1
7a159aa46d3f4e7267a9c5758699fbf5,36,36,1,252,36,0,09351,1
d7a83f01f531c2b1b8a0e8a017569478,11,11,1,77,11,0,01028,1
c21d2e74f83447cb54f244447b51764c,146,95,2,511,146,0,09030,3
7e31c2fa7b2bf36df4560588bae4dce6,194,78,4,339.5,194,0,05030,3
bb5b228622da0b74892adcbaf5c1e110,150,70,5,210,133,17,09111,3
6193b4e5628cbf7bec0bfabb027d021a,15,13,2,52.5,15,0,05030,1
e426f5caba2cbe829def845e88bd76d7,8,8,1,56,8,0,11160,1
c9e043862468048934ddf98e8995ec1a,15,15,1,105,15,0,03090,1
e8f98747387099046abb8c1a19270013,74,58,1,518,0,74,05040,2
6e9d3a2ea50872a40f13b435ab3068e5,41,41,1,287,41,0,01026,1
828dc93af170a26f8161863afaf095ba,55,52,1,385,55,0,01016,1
227322016048b2cc2e54987eede6a632,433,154,6,505.1666666666667,372,61,01027,4
686cae4f3714af451262f388c085702d,118,80,2,413,118,0,05040,3
79048128f2cf2fb13556e521a251573a,38,36,1,266,0,38,02691,1
be0a11ee5a40529345006e8d1d16ec53,55,32,3,128.33333333333334,25,30,05100,1
e331eca58b3627e0a7ee67b5da0259e5,1,1,1,7,1,0,11040,1
c83d366c9febd2e1ab08abd7959f4531,25,19,2,87.5,14,11,05030,1
cb99f042a2448dc65fcd2f1e979e76f1,80,80,1,560,0,80,02620,3
75e87fea50a0e10c8fd9a2f99d10771e,109,69,3,254.33333333333334,109,0,05100,3
cd5d0fd4668889ee9b966ac9b9d40f9c,18,18,1,126,18,0,05040,1
826e3443bc0a9308f2283dd7ac24f2b5,138,68,2,483,138,0,06100,3
6c1f9c957261e0850b9ecc26a1697629,55,41,2,192.5,55,0,05030,1
997459a2e4ae400b9ffa1d5f74718fa1,2,2,1,14,2,0,08230,1
0060a6437f6889b40c6e28330f5022ba,41,41,1,287,41,0,01027,1
9bcc8e6143078ca46366ec9a22097a2f,135,115,2,472.5,135,0,01013,3
c6fd4d6c523f4503b0ad7b901aaaf5e2,95,51,3,221.66666666666669,76,19,12470,3
7db676e13e6a276a41c5bc12e041461f,79,64,2,276.5,35,44,10240,2
cdf2003836c4d2d0f87fe2de268fbe3b,27,26,1,189,27,0,09090,1
7e0d3b2ef312969e0aa69a6cd4981811,5,5,1,35,5,0,09112,1
25b5e12dea20d4236c1142cf4d33f4ab,95,59,4,166.25,73,22,10200,3
93b66fd7ede45c2adacc83e83455d6a6,119,60,3,277.6666666666667,88,31,08090,3
28d12bed652727de48cf17310faf056a,230,128,4,402.5,88,142,05040,4
48b62c6c90485b567e73ce0b0de563fb,160,100,3,373.33333333333337,106,54,01012,3
466e2eeff075b044fa89baf2c48fa62e,68,68,1,476,68,0,09130,2
8be5bccdfe8ae8fc76c9fe3c793c6d08,17,17,1,119,17,0,01027,1
e5e986209ed77a6e6122442e92d94aab,40,33,3,93.33333333333334,30,10,03050,1
c9f3417c5fedbf0e85f9607490aff945,144,66,4,252,144,0,05100,3
05426f8183d3060b5bf6d141677028a7,146,94,3,340.6666666666667,146,0,09130,3
907c476254474e45472485049fcb4e42,282,148,2,987,282,0,01026,4
96cd110d9224b3765db3cb984095266a,15,15,1,105,15,0,01012,1
3b07eadd7648d3371bfc40fe47882a6c,58,55,3,135.33333333333334,58,0,12590,2
be5486e71f1e93c7bfe64248dc4988dd,92,61,3,214.66666666666669,80,12,11140,3
943498888d6e973cbdb9540aeded8be2,294,112,2,1029,294,0,01085,4
59d27d3b5f1bc01f16f8e393d55aaaf9,256,138,4,448,256,0,01027,4
db12091cd88442d69cd87a90ccb0b7d9,102,86,2,357,35,67,05040,3
111424ab1e9e3ec203cf1ce8ef3c4ae6,10,10,1,70,10,0,05030,1
a135c264c7117aea5425a2f0718fec55,51,44,3,119,18,33,05040,2
9600e07fde953725162fede0b6dd8307,49,46,2,171.5,12,37,03050,1
16ca0f304502dceb1ecc26e036e35562,22,22,1,154,0,22,05030,1
0b670848d5037f74590a2ea1380cbecf,90,44,3,210,60,30,08010,2
43c032c2a26e4c3782eee329e60f6fc4,132,82,2,462,104,28,05040,3
57f396c0c41bb9ee4c10fed7d0af1a38,23,23,1,161,23,0,01026,1
c9a514f9af265949e3efd31a9ff41ab9,1,1,1,7,1,0,11040,1
8d4281ce81756133c3f2639a48d161f1,27,27,1,189,27,0,04201,1
57bebcd0ee00d54b07c48ec082e9a741,117,69,3,273,117,0,05040,3
58b251e8ea8d0f950700aea31d328abe,102,78,2,357,102,0,05040,3
436b60896dd21a70f2bb88a36befd3f8,214,112,2,749,214,0,01012,4
180cb1fea35d7d4ad1667df276bb3b35,32,21,2,112,32,0,05030,1
bd570c03860946999118a18e7a733196,37,37,1,259,37,0,03070,1
1382123899e8710ab48f6ff948cc4b1a,278,130,4,486.5,217,61,05040,4
f91e8f4db07e21bebbeceeb54a4ecde2,31,31,1,217,31,0,10200,1
186760719ad11b8159483761d9207433,31,25,1,217,31,0,12670,1
7b30c1d772e1155e0a4e4a6b512084fa,59,47,2,206.5,26,33,01026,1
6267b6281529ae905e02accb7a644b0d,306,152,3,714,243,63,05040,4
2863a1cf1f3e303fdc425f3d0a42317b,27,27,1,189,0,27,11080,1
7847a78dec84b5936c2a2e4b20b39545,108,77,3,252,108,0,08100,3
8b123fef4e2ce6668f7bcec8004ea288,35,35,1,245,35,0,05040,1
30574093b322c0c80a244ac0da5aaea1,252,66,4,441,102,150,01027,4
bee3b185e68102c6586021947a8e59ee,27,27,1,189,27,0,02690,1
eed47977e509d1b40121c5c43e0a1f6c,308,113,5,431.2,257,51,11100,4
c24325d533366b5fe1a3665b7d56d603,1,1,1,7,1,0,11100,1
ab8ac1cb680381c70a9fadcd13399a83,30,27,2,105,30,0,05030,1
59cc7b6f83e8e603d351cfaa66597b15,57,50,2,199.5,57,0,05100,1
4cb6669166c7c93df6092421d40d38cb,28,28,1,196,28,0,04020,1
86d7f483d7ab0dc111bc84490d795e8c,188,117,4,329,188,0,05040,4
1245b4ea0577e9c878d82d131138e208,36,29,2,126,36,0,10200,1
8d3e558aa23243e655954995b851914c,83,58,2,290.5,83,0,05040,2
b73165dc50c72c67fdf4a5e344af132b,139,89,4,243.25,106,33,10153,3
dd50c4ed277169c81183d75e9d1e6451,75,50,2,262.5,75,0,10200,2
dc755b5a6be52948b2698029ceb20400,70,52,3,163.33333333333334,70,0,04080,2
7f1042692d43bc54e1e93ad44f5a60c5,151,77,2,528.5,117,34,05040,3
6527f1da6d8c8835fa56e27a37054d0e,81,57,2,283.5,42,39,09111,2
5e857ff7b393c27e331cd2cad32c7ebc,31,31,1,217,31,0,05040,1
5f80cab3c2f4ab5a3d119815d8641761,312,88,2,1092,312,0,05040,4
5317566b75ab016340dab04c1501a785,1,1,1,7,1,0,03050,1
2c65b0b07ced5abd942f6239c2462d19,61,54,3,142.33333333333334,61,0,05030,2
baaea417ae6bb83d2bde69f95595dd2d,327,135,5,457.8,207,120,01026,4
6f515f3bad58ff20b5a0fe14473787ee,28,28,1,196,28,0,01026,1
4131577cb5a5527847e9fbc4b9b3ad6d,131,89,3,305.6666666666667,80,51,01013,3
716f7aac3bee5aff956f4207e803758a,55,44,1,385,0,55,11140,1
85324efa02855e21cd329a86293e32da,41,41,1,287,41,0,05040,1
64cede36912c2d92b83f3f7b41725a88,11,11,1,77,11,0,05100,1
d4a4c78aa22dd908f64d392147a89006,177,93,3,413,177,0,04060,3
d340ea0c2d3a5e8846ad0740b9a61c26,139,100,4,243.25,139,0,05040,3
5a7887b0523210cbae956f4b1b07310f,31,24,2,108.5,31,0,04020,1
ccc1850769ab7e53591cf20b954a8ee3,89,80,2,311.5,46,43,05100,3
aa02e179788357d05c9d47ca7482914e,36,23,2,126,36,0,11080,1
24601dd5509e7564e62801b829994054,64,39,6,74.66666666666667,46,18,11103,3
0ba4e21a3630da88b3f00cd839b933b1,124,105,3,289.33333333333337,124,0,10200,3
a775ec4a18027522c811a45bd2f8eb37,57,48,3,133,57,0,05100,2
ca2190723999cd1a3d9b7547b687c05c,149,60,2,521.5,58,91,01012,3
a302d7ccb42635ced5148ee00034757a,97,73,3,226.33333333333334,97,0,01026,3
707ef3ce92eb777e3517f14eeb701e59,123,63,2,430.5,123,0,12500,3
9e9b880c8ec43cb28ea01006bff6c461,203,117,3,473.6666666666667,203,0,01027,4
7e0aed6aa5fc08e072b31c67393d26b7,15,15,1,105,15,0,02620,1
fd994b056a0cee8d55f0fb4c320e4f04,9,9,1,63,9,0,08391,1
8851a9be88b199ae972c1099d5da7733,157,86,3,366.33333333333337,157,0,05040,3
30372881bb04f135b5171431b0ce5a5f,152,81,5,212.79999999999998,129,23,08052,3
6cef3a912b873e475bc324288ad7fde2,84,54,2,294,84,0,05040,2
ac04c51cfb901b66e899ca2b9ed0514d,61,61,1,427,61,0,02620,2
b3d12659086b11997bb6cf53f390c7a3,203,80,5,284.2,171,32,05040,4
5c454e4a4ca8bf1dcb3c3f953447c875,33,33,1,231,0,33,01026,1
2ea0a9cb1ede19675d7d90c37aa5adc6,22,22,1,154,22,0,01012,1
d5d39d02e786f054cfbff84df04fdac1,18,18,1,126,18,0,04020,1
bba648a36f0f2b21f34cbe3e3abc7415,126,88,3,294,75,51,01027,3
77079520f03174101f57b06373594273,149,101,3,347.6666666666667,149,0,10153,3
b75b54c30076ad1608f4a736789d9467,17,17,1,119,17,0,05040,1
16f536520cf501cbb40848e7e4545ad2,90,61,3,210,66,24,05040,3
0481748670897b807cb1e3819e6ec550,83,63,3,193.66666666666669,83,0,01013,3
99035ca3c66be41b73f62138e383d53d,331,140,2,1158.5,331,0,01026,4
a550c140515c681c9511740141d3756a,74,30,1,518,74,0,05030,2
eef0e687f6c986c7eed30573348e8df1,32,32,1,224,32,0,04080,1
7391ac64255cd0c0d0d00611c4a00f51,75,64,3,175,62,13,05030,2
a76728a392965ad38b9578d8fb4305c3,74,67,1,518,74,0,09130,2
02cdbcd836334fc7af94b4c692baae09,49,49,1,343,49,0,09130,1
0af4f9f87c18176a406575d7b8e78e05,219,97,5,306.59999999999997,110,109,01027,4
d02d2f43601f0296c342229aaf5a3356,411,124,2,1438.5,214,197,01012,4
b626d0583e05a3e81bc6e1f0ecdcb73d,74,42,2,259,74,0,01016,2
f2a2167b693bc39d147a9ee3a64da42c,23,23,1,161,0,23,09010,1
e584dcc43d93f52b493980a95dddc7cf,40,40,1,280,0,40,01026,1
0a0e87d73a41256284463359da24a0a1,170,114,4,297.5,107,63,04020,4
f794b2125988a39cf868af2792083957,46,45,2,161,1,45,05041,1
5963ee2a25d872d810e685d366711705,35,35,1,245,35,0,03050,1
c3f47018ce6edfbad2af48cc02c3cd5e,135,113,3,315,85,50,09030,3
7788425ec6c85e7c821d9ae8c0e69786,26,26,1,182,26,0,08132,1
c339f36a87c7fa49b7712de526b9a55c,94,66,2,329,94,0,11080,3
00e9f71c178d5b284e3c0fd0878bc199,49,36,2,171.5,49,0,01085,1
e647172b0afb2b317858a884a705effa,144,80,4,252,124,20,05040,3
b88a948ab0948a8bd7cb21ccf3437c7c,239,114,3,557.6666666666667,239,0,05100,4
6c70382fbf035343139c416a3a906b1c,18,18,1,126,18,0,05030,1
5f373f9630a75a501ae147baea90244b,28,28,1,196,28,0,05040,1
74782e0d1f87720658aba7e513069c24,16,14,2,56,16,0,11100,1
08a9f253e3a3c507c0886e0f7d21a8e4,36,36,1,252,36,0,05040,1
89ac85aae59a7737d31266d9071255cf,17,17,1,119,17,0,09150,1
cef982044b90977f0bd5d6d79c612539,28,28,1,196,28,0,01012,1
a835799885b55cbb843a2197046b0d93,14,14,1,98,14,0,08100,1
5a1faaed95b818df1f5c46de1b58bdd9,548,209,4,959,500,48,05100,4
dee715071d1f221fe176b724a5e639d8,24,24,1,168,24,0,05040,1
98ef2c373f2b75dbf0df164ecc366a7b,17,17,1,119,17,0,09150,1
dab82e04f7fb6d6b0f55df04e31ac3b5,34,34,1,238,34,0,03050,1
2f6a3cedd6f6c03e55243f1b6c25d665,96,73,3,224,70,26,03070,3
8e2c24b8107e30624bbebb029f8a2a61,298,125,3,695.3333333333334,298,0,01026,4
28e23744dbb4abf2324bfda57748ab42,127,62,3,296.33333333333337,127,0,09010,3
7ac03d2abc132877a99dfd2e184ea2e3,144,84,2,504,144,0,03090,3
b1380beaa7bcc234dac3cb76876c7930,103,86,2,360.5,103,0,03050,3
c488c2c5e7222c8b1fbfabc54fab026a,224,112,5,313.59999999999997,224,0,05040,4
4290bd68d2a376b45e3b5c317237e1e6,61,40,2,213.5,61,0,09170,1
31b20e802f83d577fde00819fd106ab8,114,90,1,798,0,114,01027,3
1d9973bfb8b44ad4af854f716de7a31e,3,3,1,21,3,0,05100,1
be4a3cdd6ab4e1131765b10c584e7489,145,77,3,338.33333333333337,129,16,01085,3
69f3931fa5a4c481cb99fff8ab457e85,164,60,3,382.6666666666667,116,48,10220,3
c5c184a4968854c9c4f4d79e50f2774f,137,72,4,239.75,110,27,01085,3
99220c23ad2f97bca367e0acb8a80cc1,248,137,3,578.6666666666667,202,46,01026,4
b77ba08f2932d0d873be391301ec1a41,20,13,2,70,20,0,05030,1
15c632ed5f0d3ce9078fd95b12447a7a,44,24,3,102.66666666666667,8,36,10200,1
40047054c83e593d49db94e03b12df5e,62,58,2,217,18,44,01012,2
a800cc119dc33c0f57ef2ffcf8b6c849,141,127,2,493.5,141,0,02690,3
4c225bbe871d50ae3e888346caead2fd,158,93,3,368.6666666666667,158,0,10240,3
335072c1f97216c60d13d3bc335c38f9,57,57,1,399,57,0,03050,2
0e83732723523f82996932a450f1c872,386,118,3,900.6666666666667,67,319,01026,4
ecdda789c7a278a2e6aa502944e93bae,42,42,1,294,42,0,03070,1
ade870cc5cbdfbec29b0e552e2a32b8e,23,23,1,161,23,0,01012,1
802c3629f66a6d20e3dad669ffa7b489,27,27,1,189,27,0,01026,1
cf0f60dce30221995b855e2c8f5e0f7f,45,39,2,157.5,33,12,05120,1
357fba51ccc2ccc33fb341b161a4b08a,47,47,1,329,47,0,09130,1
9520d5a19570c12add3de6956e08569d,531,97,2,1858.5,531,0,05040,4
3ec8706441ae5e6d6b653454d9cef08d,10,10,1,70,10,0,05030,1
1f4acae63d79d98de9a69a4d3615a78b,58,43,2,203,58,0,05030,1
d1f9dcd5669f93808cb6814947b7bc59,88,59,3,205.33333333333334,56,32,05030,3
5a23f9c16e140f0cdb840f7cfc7efbcf,110,65,1,770,110,0,05030,3
e3d7931ca20ede78f21ad7db0ec83511,89,64,2,311.5,49,40,10200,3
f652097379a3d6a02a9d99507bfd3c88,462,144,2,1617,19,443,05040,4
c9a6df80616ad9ac9f46c93b04d9eace,46,46,1,322,46,0,05040,1
f9495771119d83a2ac006dfe1dfed6d4,227,129,3,529.6666666666667,88,139,05040,4
89cc242024f9e8bb4d9454f171b3f24b,401,128,2,1403.5,314,87,01012,4
ac4663555f7977df4a28da9222165748,57,45,3,133,57,0,11040,2
9e42ff08057b46385f09b14f1bad6fe9,383,182,4,670.25,383,0,05040,4
369828f441b52327cada7444e431b42a,320,129,6,373.33333333333337,266,54,05040,4
7c7dbc20e67d50cbbc48494d318592b2,148,89,4,259,109,39,01026,3
8a19b29db8c7e32e8824adbba5673c67,87,53,3,203,60,27,01013,3
5a32555d51546954affb2864a434553b,102,75,1,714,0,102,03050,3
fc30ead38bbde86326bdea98116570d4,91,76,2,318.5,45,46,01026,3
9fe19cbcb5fe245054846852a8b359bd,44,44,1,308,0,44,01012,1
cbff9a04f0f24909050d4a07ba25f0d6,107,67,3,249.66666666666669,26,81,01085,3
97c169f64eb829ab5fe9a7b7ff4cd0a4,98,56,3,228.66666666666669,98,0,10200,3
ce013105e81928771de9bec50ed21679,41,41,1,287,41,0,01026,1
db8a9294331989ad59b76824f4eeae8b,105,62,3,245,105,0,14301,3
99c2bb703afd5b5d82ce353cb5cbac7c,43,43,1,301,0,43,01013,1
e481aac238e973d9c3ebab923b665953,171,95,3,399,60,111,01085,3
4e2c6e663d60417650515972b7489160,43,43,1,301,43,0,10200,1
ea05e37e82867774abafaa53379fc633,16,16,1,112,16,0,10152,1
f71ba2bb40f49f1de34f7e30c887bf20,101,75,2,353.5,101,0,01026,3
2635d92faf19a2b20e82a190f82d7bec,38,38,1,266,38,0,08231,1
eab5f878d3235b765e7926dfa861f80d,223,108,4,390.25,85,138,11040,4
01369e9d36628c742dc319bbf0a88259,14,14,1,98,14,0,08133,1
341e02dab3e532f7f5e4c3b86a90c12d,235,185,3,548.3333333333334,154,81,01026,4
b73342bd2c79a1fb0504f1acadee61f1,48,48,1,336,48,0,05040,1
9fee1aa21642c225f62eb337354b89cb,176,108,3,410.6666666666667,176,0,04060,3
f5b87646f516b69a2e4812f3057c4998,68,51,2,238,68,0,01013,2
f5a68eaca1c3e2e55d7142a192fd9c43,40,40,1,280,40,0,09010,1
752520da81b8f435bb84e49af7a6e060,41,33,2,143.5,41,0,05040,1
366bbb2bb20992132f3fb69863b44271,104,68,3,242.66666666666669,76,28,05040,3
5a4cc22b21652951a496e28e8aedfae7,99,81,2,346.5,53,46,01026,3
7f8cd512f5664d071cc476dcd89200af,7,7,1,49,7,0,05030,1
318e0c9b679503d70eb0ec79e8b92ff5,17,17,1,119,17,0,09010,1
e37b430e4489ac4d50de6f0f4511dec6,15,15,1,105,15,0,05030,1
a762aba4bd668fdbf8e12eff92274692,288,146,4,504,288,0,05040,4
6de4865f41e1876194ef5bd744cb5670,41,41,1,287,0,41,01027,1
4c40fcf3a5e42b1a2ec58adbcc0fdac4,253,74,4,442.75,209,44,11140,4
9aeb488730c272922a3d2f393bf693d5,18,18,1,126,18,0,01026,1
c8ecab5423c5d8e5edd0364f5513d66e,218,125,2,763,218,0,09130,4
907b88e063ad6887ca1a1cec7def48d5,23,23,1,161,23,0,09111,1
59e5484f49d15a00c4548405a1a2f43b,30,30,1,210,30,0,05040,1
a923e4ebffdf3b07d38a5edacff81413,12,12,1,84,12,0,05030,1
849f39406e2e5c31559847574a9d879f,664,163,2,2324,557,107,01026,4
9e4a143f9f4435127fe007e72cc9cecd,114,86,1,798,114,0,10200,3
62da5c71f920aacaf99af7784914c8f9,274,147,5,383.59999999999997,274,0,01012,4
cc41ad4f6033f07959497666547e3ec8,82,51,1,574,0,82,02690,3
bfded533eb2e9c7807d44e0a9dfdf279,45,37,1,315,45,0,11080,1
a66a1de8d9024c8579e41b87906be0e7,237,107,3,553,237,0,11080,4
889c7c208982f50328002759a8b1d951,91,65,1,637,91,0,01027,3
22df32601437345c730a7282ccadf38c,64,51,2,224,64,0,08150,2
729d545a315b730cd1bfa705ea149cca,54,54,1,378,54,0,02751,1
752c2a265989f74c2276681203c136ed,48,43,2,168,48,0,05040,1
f58c94043c4643c522e274e0183ad13f,16,16,1,112,16,0,05040,1
c52358fde87bbf3070cac0a51e7b3658,54,49,2,189,54,0,05030,1
033a3b19b7e8d7f97ff048b78151f476,19,19,1,133,19,0,05040,1
e98227ebe81460572db4256228fe0c45,48,32,2,168,48,0,08313,1
9942112e68a9c90ebb5dc4742211ba13,104,63,4,182,104,0,05040,3
65bb0f23152ecebfa500424797065f60,195,89,4,341.25,158,37,05040,4
7e6c9f72bfdda734dcd96337f636cc3f,15,15,1,105,15,0,03090,1
9a568d37d1d40e88611cc32ab78599a7,243,60,4,425.25,243,0,01027,4
2211f26efca7581048e80fa920eb24fc,79,59,2,276.5,45,34,01085,2
cb2d6d10a7fe7b032f176c4c3ce3b88e,43,37,2,150.5,43,0,05100,1
c78d9eb378827553e69608e9623f6898,576,202,5,806.4,576,0,01026,4
86607036abc802304069e169a9d4eb75,8,8,1,56,0,8,09130,1
280b750083d2f34f1f6b32785ec66bf8,24,24,1,168,24,0,10240,1
2029577e140195697d99bc3a0d5e7fc3,38,38,1,266,0,38,01026,1
9cf5b4d290ccd94b458f84efa9c9b273,45,45,1,315,45,0,01026,1
38ba2d82da0734dc28bda487d9e52344,18,18,1,126,18,0,01013,1
3b302d33c4ab84d761835e4a44a9a20a,141,104,2,493.5,88,53,03050,3
a88239135a26f934fdbf13dc4ff2459e,48,43,1,336,48,0,01026,1
c602ebf41d2e54ab273199b209351c03,557,158,3,1299.6666666666667,557,0,01027,4
3ec0127fb00e9b0dd15076e242ab60fc,103,73,3,240.33333333333334,61,42,08010,3
3e0beaab27164974fca1226c054fa231,47,36,3,109.66666666666667,47,0,11040,1
62f528b9bf06f46f22513af0fe900aaa,57,36,2,199.5,57,0,04020,1
d181aef4caa47c784ab22dafea460514,11,9,1,77,11,0,05030,1
c6a8afc7ad453cd6dc291b1191926d0f,9,9,1,63,9,0,08100,1
2a99d6f76f7555299ae695a966e6d474,569,142,4,995.75,416,153,01026,4
0b79334bde06527d80bf31121316e676,48,48,1,336,48,0,02650,1
0226b5b8372bf056d314f1257933106c,69,53,2,241.5,27,42,01026,2
5958f0e3b3f99df6053fd7bc6a1dfe0f,78,51,1,546,78,0,01012,2
f634df2ead09b01a073b73e7ad3e1d5e,113,75,2,395.5,78,35,02650,3
26777f886fe6fb9a7a3f0a1e56a95746,228,138,4,399,228,0,05040,4
331ee65cd1791ea5ce75e8db425e53b8,35,35,1,245,35,0,03090,1
4590d64a0e3386631894dd7663ffbc72,25,22,2,87.5,25,0,12650,1
f04e5bea16af41043e3b980b1d50b2d3,82,56,2,287,82,0,10200,2
bd1e2acbb67a80ff074db3adf5ce4255,223,126,5,312.2,223,0,01026,4
f3ee8e8c956648202446e38b518706ee,52,41,2,182,52,0,10261,1
d75b33d1e65382849d8c48a74859ad7c,11,11,1,77,11,0,05040,1
220ac8c4e04aa3879d1177fe447ed3f5,7,7,1,49,7,0,12710,1
ff09c846b08c10802eecd3afcc20ee80,33,33,1,231,33,0,05200,1
e90c744141ef07ab2f9fddf37fdbd85f,76,55,3,177.33333333333334,76,0,05100,2
002fcad093ac3fa5988b59e53788fd61,10,10,1,70,10,0,05030,1
769ac16b90eb6da7ca3c2acd87a71d0e,268,74,4,469,268,0,05041,4
f4ec58562ffd11e651ed9f9dffc88f52,160,74,2,560,160,0,09010,3
ee07a96568f3cbc200780e8b3e26d5a0,90,79,2,315,90,0,03050,3
df016e895d0dbc8bb4f152b373dd90b9,263,159,3,613.6666666666667,263,0,01085,4
d2870a7f672f02268d778e0c0bd17b72,38,38,1,266,38,0,05040,1
d6df9c55de8c0f0b61a849b2b0cc1e30,27,27,1,189,0,27,11100,1
f667d3c6f9587a36dbd0a78992a1c129,32,29,2,112,32,0,02650,1
a95ecfc5c23b5d49eda0be78f67b5de4,25,25,1,175,25,0,09150,1
e4d72b5bcfbdd79871a0725d680bfca1,16,16,1,112,16,0,11040,1
e3b13a65db7032fc66f8e8cbedcd248d,99,51,4,173.25,99,0,09090,3
685b6cfc2f1522dd649d72eee2986b0a,190,111,3,443.33333333333337,104,86,01027,4
cfef56e4de9c134fd7a40008310e30c4,33,33,1,231,33,0,04060,1
2bf13196f7b0c5998b695f49f0e35e81,20,20,1,140,20,0,09130,1
a9204be0d94d207ba49d3e0960789669,55,50,2,192.5,55,0,10200,1
2c16d84b74518076d2c6e6eaf90816fd,64,51,1,448,0,64,02650,2
30e41623d1b82d31f05f458845339f4d,348,84,5,487.2,173,175,01013,4
fd90403692f4bfa70bc90ac61657aff6,124,73,2,434,41,83,11100,3
e3d477ad1c79b45eb712a3916cd4f363,38,38,1,266,38,0,10240,1
9ed99e942eaff5f2d7d2980939539131,295,83,5,413,259,36,01013,4
0bde475ed4bee54851f7eb17f5086d00,23,23,1,161,23,0,05030,1
70db38d04aa45f26b18dfe7f75f91736,22,22,1,154,22,0,05100,1
3f1ff7c5f76085116d0d16a5adfa2cc9,10,10,1,70,10,0,05030,1
ccfa733c054d0b3c00e7f89136ad5a08,369,108,2,1291.5,309,60,10261,4
e924bd2df96ceddcd6f39fb506ae7f68,90,72,2,315,90,0,05040,3
0eaf211d9314f2170db85cf4973594ef,106,60,4,185.5,84,22,06100,3
27028ce7d6dfad397fd788bd12147760,66,50,1,462,66,0,01026,2
3e92606a05e9183fc72496ac0d929ea1,129,85,3,301,40,89,05040,3
72ee4c9ccf9fc9179cfbe55d14c238a3,56,39,2,196,56,0,01026,1
8b810c07707e960ec857efa7975a1a96,25,25,1,175,25,0,10220,1
6909696db56a19ad815773f6b3bcaeb3,29,29,1,203,29,0,05030,1
91a82d63a2f0869f13bc74a1ee3879e4,73,44,2,255.5,47,26,01012,2
040cb3931e307a07900c4e18059c19fb,18,18,1,126,18,0,01012,1
494477141e3a4bbf08e7826995c518ac,41,41,1,287,41,0,01026,1
bdeedeabc06b755e3f24c577a4b984bb,23,23,1,161,23,0,01026,1
9ff1516075a3525bca0d712add7181ef,15,15,1,105,15,0,05040,1
85ce2c4db1deb259c6c202cd54c7a5eb,43,36,2,150.5,43,0,05030,1
fe712ffd57b25a0a0927ad8539feee33,38,38,1,266,0,38,01027,1
83003d3e3ad3a40d83786e7ac40fad39,357,91,3,833,144,213,01085,4
df9d236fa748f8da4c171e2a233a5ad0,41,41,1,287,41,0,05040,1
2d136ffe02535b685a3cbed501f6d803,25,25,1,175,25,0,01085,1
52eb97f1ace4204cbfb904c391cb95b7,21,21,1,147,21,0,05030,1
35bc70d047b87b3759e462fc9dafd2c6,36,36,1,252,36,0,09130,1
12f1c088cdd923529e38d755b4cc4e0a,371,164,3,865.6666666666667,279,92,01012,4
515a6f19aced5c9a3f1380755e3b50df,17,17,1,119,17,0,01012,1
59980727892940e291b8dad5f477f25f,17,11,2,59.5,17,0,11040,1
d904f99dd41562ba8430a9d4c97bc16e,29,29,1,203,29,0,05030,1
7a6f677e06ae036d6cf1bf296f176384,63,44,2,220.5,63,0,05030,1
a1da713bbc98f03b3808e0686fcd279d,21,21,1,147,21,0,03090,1
ae10ec7e1bdfb5c5e7d0e84700feeb46,233,104,4,407.75,233,0,01026,4
71bdee696db20194b99b61a03eb97aec,113,88,2,395.5,77,36,01028,3
dd4c64c3d8f4770b16d9ab19c1ec9e29,19,19,1,133,19,0,05041,1
3afa0885b06e08e90ade63c5e4974d07,66,57,3,154,66,0,01085,2
2c7d2b2a9d67f9c671ef18e4217fd1f6,53,40,3,123.66666666666667,53,0,05100,1
b9fbd9991f682e9f748a0a7ca9e70122,502,177,4,878.5,444,58,05100,4
fe7496fb7d51c67855ed8ee6b8b985f8,164,86,3,382.6666666666667,164,0,05040,3
da894e15724c985317b59a5b183e8d65,131,67,3,305.6666666666667,131,0,09130,3
c14efd86b8f1bfb330422c53f4a5b2da,56,56,1,392,56,0,01026,2
6e35acbbf54d410e499221dd6b03a7b8,88,68,3,205.33333333333334,88,0,05040,3
eaaaa177ba89a0b64e8a37bda7c65019,23,23,1,161,23,0,05040,1
999a59b8c23cd791f0f8b843bef9ae08,468,115,3,1092,468,0,08052,4
bd372397e8e1fcdde99c7e64512b175a,108,71,3,252,108,0,01085,3
134bd68f3aaa98e66c8091afb197ec39,83,69,2,290.5,83,0,01026,2
7cd345437e9b0481551633edb87ae105,39,39,1,273,39,0,08100,1
bae149481fe54ec5eb098b081a1dff8e,30,28,2,105,30,0,05040,1
5a729e0564419eb5473e6ee95c5d8f18,36,36,1,252,36,0,12591,1
44ea34cc96a28ef6c5a6fa83d8ef280c,93,83,2,325.5,41,52,11100,3
76add15286398b86ef8899dfc6edc930,459,145,5,642.6,356,103,05041,4
2734dace33c85e62ab516735643382a7,71,52,2,248.5,71,0,04060,2
f8da61a4bc395ea93523fe1e076004b7,26,26,1,182,26,0,08100,1
4d7cc74e62a5dfe47e49c14a5030b1f1,14,14,1,98,0,14,05030,1
cae5299af4d5d35eee969698ac451c0c,136,89,3,317.33333333333337,136,0,08452,3
090099bfb9b96f08538d3851f8963f97,43,43,1,301,43,0,10220,1
69ff022b60b904f612eb51e4713f3df8,285,148,3,665,285,0,04201,4
8d919dbf85e5e5abe0e4a20cb80e57df,73,52,2,255.5,73,0,01013,2
9e0bf554ff9afdf18830265094cc54e8,68,67,2,238,68,0,11100,2
acca34e73c8584cc39a779c9c5b37d2c,4,4,1,28,4,0,09010,1
f14828f94274d2ee64a12262be9f5bda,113,51,2,395.5,38,75,05030,3
21d2a7baf1cd9bc8425d81804c7835af,102,74,3,238,102,0,09010,3
8cfa0ab2405821618ec3ad2d80308d97,323,140,3,753.6666666666667,90,233,10200,4
26e129636c06c16225c8586cfda9768c,29,29,1,203,29,0,01012,1
fb484f772347a10b7b5d8168237e13b1,7,7,1,49,7,0,11040,1
d6876d754a79459edddc6c8027cd1ed5,61,60,2,213.5,61,0,01026,2
bce5e2f86b1bb913d3113b604b442b1f,16,16,1,112,16,0,01085,1
a2ab1072bf6ac01833485817ee7cebb6,105,67,2,367.5,105,0,01085,3
f387d56865b366a01b0a8db28ea54eb4,397,116,2,1389.5,299,98,01085,4
32f4a68e7d0c9ed2ee28977cceeb3f97,117,94,2,409.5,117,0,01026,3
7a483ab41ed80a263537ea0640f31c19,27,21,2,94.5,15,12,05040,1
dbe25e287aa43e8f3943faa943555268,69,55,2,241.5,69,0,05040,2
bd59cf52563f6c479772f4a7e7e0f81d,19,19,1,133,19,0,04201,1
f029a601254301e74692d27e21292960,21,21,1,147,21,0,01012,1
1b796876713868f45cf0ec7b80957e8f,356,93,3,830.6666666666667,356,0,08051,4
d68f35ac71e387b9a894d1d034b48227,34,34,1,238,34,0,05040,1
42f2ccefdc9cb0d1194224c4575dc4c9,68,54,1,476,68,0,10200,2
28988d639605271be833e55b1e609572,54,54,1,378,54,0,02620,1
ff133da29771a792806eee66dcbb9a74,21,20,2,73.5,21,0,01012,1
1bf684b746388b9f0cd85643d8880e5e,14,9,2,49,14,0,12691,1
eeef71d39242def45f1282db2338c2ae,78,67,2,273,78,0,05040,2
5be8d7dd19af0ded6f71f94d538cacc3,138,71,3,322,104,34,01027,3
a225b0cdb95a18fa1e8769b41b1e6de4,40,40,1,280,40,0,01026,1
3e9f4a457effdc0613da98ee623f4afb,53,29,2,185.5,53,0,05030,1
b0fc965d762dd0bb4f63c04c23b71ac4,40,40,1,280,0,40,11140,1
567fc7ee673e6f0258a3534c6898584f,62,62,1,434,62,0,01012,2
bc411d5acbc77f189ae5a1256854193e,205,94,4,358.75,126,79,05040,4
db9a99751f09d23f52bcaa2ea3961eb2,37,37,1,259,37,0,03090,1
c27d019f28e88c8220c9fc5bf2567a8a,85,60,2,297.5,85,0,05040,2
d23ad8ffe58f4b2d7542668f4c2d3af7,1,1,1,7,1,0,11040,1
9344340fbe04f8bfcc5502b4f9a4a038,7,7,1,49,0,7,01012,1
6eb354e9e4f227e2c2e30c5ac127d175,108,80,2,378,36,72,05041,3
9244c0b0e199e8ceb30cb3bd6cf35ec7,358,115,5,501.2,312,46,05040,4
048b9eb4400d764dc166df1dc4d81e6f,127,73,4,222.25,78,49,05040,3
00a2a3ba64bf707e4073b5d42accceac,152,108,3,354.6666666666667,152,0,01013,3
c36a669e7740deb32125f329a5dfe678,2,2,1,14,2,0,13877,1
6eb631de2c8b866aa0cc222780b0fdaf,4,3,2,14,4,0,05030,1
3e9b4ebd4e9e9802ed4c40bc5fff506b,139,94,1,973,139,0,05041,3
59c6138abfd98455d41f8ef2ed833e75,36,36,1,252,0,36,01026,1
50fa568e51363e1a100364d9ef3a1c8c,168,97,5,235.2,98,70,05040,4
8201e2f759d9641ef8e85bee0c1f00be,105,87,2,367.5,45,60,07143,3
0df29bf5893f9c1ac5716284e0cfa98d,77,62,2,269.5,33,44,01026,2
b528c35a01aaadf240db313f0b47313d,133,84,2,465.5,133,0,05100,3
b67f9bd3098983f96e27e21943cb1141,5,5,1,35,5,0,03090,1
e8fa34ba0a614b5242502e45ea4d27e1,20,20,1,140,0,20,09030,1
1261490fb99d407a2604e00025e98deb,48,48,1,336,48,0,01013,1
91d127413a71c4d20f78327a762336be,34,34,1,238,34,0,10040,1
601ce0e7e4170cf51c188df68150dda0,107,60,3,249.66666666666669,79,28,05040,3
10789844f0987714996f857e6f2741c9,13,13,1,91,0,13,05030,1
ae5773954453ecb22455979401917e11,18,18,1,126,18,0,01026,1
0f3cab05dbf4b105dde80871ef63de3d,195,99,2,682.5,45,150,04020,4
8d2919847a1a69450e30e469a1accb35,169,75,3,394.33333333333337,137,32,10240,3
a28673ca9783cc442ca1fd6898cf8fcd,143,94,3,333.6666666666667,143,0,05040,3
e932dfade552c7aec2dee92e41386393,137,95,3,319.6666666666667,80,57,01026,3
f97d51ff6936946b3b6c7d90e5246435,74,51,2,259,74,0,11100,2
16150770291a12f78ba4e5507d358d48,41,38,2,143.5,41,0,01026,1
f4abdc5050b44360f1ed6740e9f5781d,61,44,2,213.5,33,28,01012,1
132dddfdcaa127efcedcd0c6dbcb8bf8,164,82,3,382.6666666666667,164,0,01026,3
0582c92fd349c83242177cd00079bc46,30,30,1,210,0,30,01012,1
1bc73cf80857566123740322cea943f0,102,77,1,714,102,0,05040,3
f50d4607672e8aa4e57cc32a62db760c,35,35,1,245,35,0,05100,1
26a1c0d8630af515ca42eea131bbe587,41,34,2,143.5,18,23,05030,1
f3cb4d0e5fd70e5bdb4eed53687c9d61,130,88,2,455,130,0,05040,3
ed6601b278bb0fe76de06562b1818cd6,64,44,3,149.33333333333334,64,0,08052,2
df81c0e760e5e87c94dff224a76c653d,27,27,1,189,27,0,02756,1
7b6af0d07f3c81ce8e3315a3491e3267,24,21,2,84,24,0,05030,1
a548980dfe3b50f79f5e3572baeb9561,65,32,4,113.75,50,15,11100,2
8734a8439687f4e28cb2b0020f8c0fae,50,50,1,350,50,0,05100,1
4f0909ef745ac9a6d90056122d98b5d5,37,35,2,129.5,37,0,01026,1
032fb500b389ed735fe2a3559573d29c,123,90,1,861,0,123,05040,3
38a3d4ea7b0e3395abd9bb7c8339092f,20,20,1,140,20,0,05030,1
dc27dfe613c84a5fbac014a37e258234,51,46,1,357,51,0,05040,1
11a184b72f500a3220f2be0de2fae5a2,156,85,4,273,129,27,10240,3
03a8b4700f28684c8ba4c6db200e47e4,253,97,4,442.75,188,65,05040,4
1566abadb5a27a238fdd6fe3a3943f37,12,10,2,42,12,0,11040,1
6e4ff7d18242cc39065544658d2d6cf4,76,63,2,266,76,0,05040,2
7a0ecf28d9b71899e160b76253a0b75c,48,48,1,336,48,0,02651,1
90e2d6f9e1774d6a99f03e5a75463d28,14,14,1,98,14,0,10200,1
0c8fdf99b0251539b6ae07ae429b2aa7,121,87,3,282.33333333333337,121,0,01027,3
1d03afbf0f4f51f3954ad07b16eea09c,251,103,3,585.6666666666667,156,95,05040,4
48f6c54eebc1f70e4496d7169d18902f,33,33,1,231,33,0,08100,1
9b3e3ddf54b828fc327b56f99df65e36,40,34,2,140,20,20,05030,1
3428070b833cb613497ad7025c44b280,83,68,3,193.66666666666669,83,0,04020,3
2a93b93e1918b74f15bcec419bb286bf,147,70,3,343,147,0,10200,3
1df0df48f8ebc90c26920804c566a00f,16,16,1,112,0,16,01012,1
f67e26cff04be5d78f4123f0921a9032,56,56,1,392,56,0,01013,2
f9af0dc756d43357dafdc68607d7d943,560,214,5,784,398,162,01012,4
f88a1f080351d5cd6b40d2442c90bf00,26,25,2,91,26,0,05040,1
7dc29295b6d4a39e82f3ce6d173b3e1d,37,37,1,259,37,0,05100,1
86ed97b98252391fc09efc50de074ab1,60,48,2,210,60,0,05041,1
f9c59c8862d01ad486fb937541a00079,48,48,1,336,48,0,01026,1
edc2e8c40210d515f526514fab58f7a8,107,76,4,187.25,107,0,12670,3
8dad999216c8d147a617a629cbc98f35,66,52,1,462,0,66,05040,2
111e9de08c65f1f0f085fc0a27134ddc,153,132,2,535.5,68,85,01027,3
78127030ad5d9fbd81bacc118f8bda84,53,53,1,371,53,0,05040,1
bca969662b4e683f0592fb5e893f445a,68,68,1,476,0,68,09130,2
b4fa816894a13484e897b1366988e680,21,21,1,147,21,0,10028,1
11c5cea67c9c43214dd9d8f939550e19,42,29,3,98,42,0,10200,1
bb6eb0180b6066af58935b51c1faeebc,41,35,1,287,0,41,05030,1
2c55aa058daae731e5543de7f8a4dce1,25,25,1,175,0,25,01026,1
bc72fa22748a63014aff15a7f5ce6c5a,14,14,1,98,14,0,09030,1
f008bbe426c6a4055a1f7e2b3617aaf4,35,35,1,245,0,35,08100,1
6a1f605bf7ceeeee44c3d7c74a006da6,654,157,3,1526,597,57,05040,4
6e95e2d086df9d836b72529073fc2a6f,5,5,1,35,0,5,05030,1
72b5aa210e59e081e779155905d719e5,9,9,1,63,0,9,05030,1
51053c1b3010eae59272d0081e78b802,212,105,3,494.6666666666667,212,0,04020,4
97ced4dd0d5481ab0161e96cecb866eb,65,27,2,227.5,65,0,11100,1
91d15cd0be1f3676421c8bd4621141dc,112,44,2,392,112,0,05030,3
69d77eb3c8885fe340f946682b79c397,22,22,1,154,22,0,01016,1
5910178b5f19bdb678757067ae6e8b05,17,17,1,119,0,17,10200,1
c255d49d70ffcf68fcd7e76734d9ecf7,41,41,1,287,41,0,01026,1
91046cbcbc5f54782ca21dd10b2d89cc,31,31,1,217,31,0,05040,1
34a7c7e4a4d460f0a07fa9b61f453cae,14,14,1,98,14,0,01012,1
6a2f82bece1f75d8512def7fd3947a47,475,174,3,1108.3333333333335,412,63,05040,4
d44f4d1a22841765f453fd14f4a5a86d,78,66,1,546,78,0,01027,2
0f05d891678237e0289a04e579df54c2,95,63,3,221.66666666666669,95,0,05030,3
a7955113cd19cc2c8bcd4d53a5fe0545,730,247,5,1022,699,31,01012,4
7fb10cc67b2f667094467a31575e6aec,45,35,2,157.5,45,0,11040,1
cb730e931be1399885a88e67178cf105,54,46,2,189,54,0,09030,1
92112a9631262491a0a05ca0fd99d1b1,110,72,3,256.6666666666667,68,42,05030,3
67ee6d50ab3519e55509c472242ea06c,183,120,2,640.5,183,0,05040,4
5a0448d274aee8fcaff1f5d37a58b77f,23,15,2,80.5,23,0,10200,1
f18db164e529ecab2b5b7b34cef4fef1,193,105,3,450.33333333333337,193,0,09130,4
dfbea8ac7c74ff9c6672aee92092b203,32,32,1,224,32,0,05100,1
e8a53130e9ec9075850fcf38d6b58067,222,114,5,310.8,200,22,04020,4
4afe4a3fdd63e295b8063b5f746f51f4,330,147,3,770,291,39,01026,4
68533caf1fed178df9cf69ab92fc080a,34,32,1,238,34,0,05030,1
7c041fd89c0ecd5f7197be5bec24f8de,15,11,2,52.5,7,8,12590,1
7b977918f29fb3797163479e0ef3f3ff,25,25,1,175,0,25,01013,1
69ec352d8850330087db63cbd4677e47,59,49,3,137.66666666666669,59,0,09130,2
8e7842241b38f040effea483fb25bdc0,28,28,1,196,0,28,09090,1
38b3d5337f51517e8fa7bb3766d0b6b1,229,126,3,534.3333333333334,229,0,10200,4
9d7ea79551c054ce4471581a21d707a9,101,53,5,141.4,81,20,10140,3
1488f4a4cedfdc646e1026b69cb39331,6,6,1,42,6,0,12710,1
bd5c0c2cf83212431af572608a8ee2ad,101,52,2,353.5,51,50,02650,3
697fb921995d5e249c01709a482b9875,328,92,1,2296,0,328,04060,4
a4f5576e50a9b7f632a46f90fa3d076e,154,88,5,215.6,115,39,01085,3
34314de86e124af5a0341213ab7a3cfa,32,32,1,224,32,0,08010,1
211513a03c59b325b53364952bea4547,47,47,1,329,47,0,11100,1
b30f74a3b80ea4c42a9023821521d990,232,138,4,406,196,36,04020,4
cc41dc34a709a3e4c7c9de13086e90fc,171,114,3,399,50,121,01026,4
810af023db99d519d1ab415e0fe654b9,39,39,1,273,0,39,09170,1
a253409fa11c16f565f31adec1cbf7e9,23,23,1,161,23,0,09030,1
e0aff25d6162618b93fedcc0078b20f8,382,172,3,891.3333333333334,230,152,01026,4
c9bfe1a559e7432fa51f88a8e92a08fc,58,50,2,203,41,17,11040,1
e0a0c74e0ee901ce0610a0f074a96bef,92,72,2,322,92,0,01026,3
ad8ae3e2a26a27b0fbfeb57227834cba,32,32,1,224,32,0,01027,1
197ed9afad4dd8377a47e7e5f97ee385,39,39,1,273,39,0,11100,1
fdf40e677dd408d96bb5c5c148166ce8,201,76,5,281.4,167,34,04020,4
5e587bba51e5a190573ba2e89e939975,34,34,1,238,0,34,01012,1
f181019b3560c13ab35c0f7a2a75dfa3,102,81,3,238,55,47,10200,3
9ae0aa500c7869148a58d52f2fcf2d51,88,45,4,154,63,25,05040,3
fcffbd0b166c0659b1eed2f798e1464d,57,55,2,199.5,57,0,01026,2
e5c9e33b8196bca449a9a397f79b5d1b,287,118,5,401.8,225,62,01026,4
e9cb360f25c1f35471beeb7f478c9630,9,9,1,63,9,0,04130,1
bce0075fba00a745cd3df08bbe329899,36,36,1,252,36,0,08051,1
d1b4abdff9e6c30e34be296436018786,59,51,2,206.5,28,31,12570,2
4bb44e27cb584fb7f3cd4be7341a1132,56,23,2,196,56,0,10200,1
6f8baaa55be593bb79f1bfed365615a7,29,29,2,101.5,7,22,05030,1
c87896b11d0753b0ad483fa86c818d84,1,1,1,7,1,0,11040,1
169dd81a352e53655ce41643a233a664,74,62,3,172.66666666666669,74,0,05030,2
5e2f8f8e5dddcb43e66ff86f8d0b5914,39,38,2,136.5,39,0,01012,1
99d7712c4481d519cc1b7c1d8f5287ef,48,37,2,168,48,0,10200,1
7e6079e9410d9ba8d883ee73bb2c3de7,203,123,3,473.6666666666667,203,0,13953,4
0a332f51350d9283c19ef31ee4869d8c,273,169,5,382.2,240,33,01027,4
f5d19fd1209f1050103d17a06e74fe01,29,23,1,203,29,0,01012,1
337e62a7e47ffcbf9829ae1bcd57cd27,25,25,1,175,25,0,01013,1
4fb41dbb034ae82f81a5a915a1781064,38,38,1,266,38,0,01085,1
79160f9b52d6cb687358077e100d7b70,93,66,2,325.5,93,0,01085,3
58a17fa410b50fb091c35fc8e66c1e27,97,81,2,339.5,97,0,01026,3
d31107de6ea14aa642e1d27c877b04a3,144,68,4,252,144,0,01026,3
5260baa246ad4c137abd692d57c361db,117,71,2,409.5,75,42,03050,3
7c8c97f7c7e08b563b0808c8c380efda,26,26,1,182,26,0,05030,1
9db64de04be3cc5105b506d312e9dd27,115,91,3,268.33333333333337,115,0,05041,3
25f184ed4ff6a6120fefbf045f5c104e,204,103,3,476,204,0,11080,4
5fc8ad3b7b7b11020ad2428f4f013f25,133,97,2,465.5,133,0,01013,3
4a3bad3206c9aba80cbd89b29bb5037f,61,53,2,213.5,61,0,05040,2
160db47aa2735b562a5b2db24735048b,143,94,4,250.25,143,0,10200,3
085caee5be0eb4b820b35d18df88ab35,124,94,2,434,124,0,10240,3
a1b7a8ba68c4dacf6e8c61039fb05b1a,146,93,3,340.6666666666667,92,54,04060,3
93e9373e983ceaa03fb5591289124202,61,61,1,427,0,61,04060,2
905b5cd0588e0feeb77a8ec64de50f8c,10,10,1,70,0,10,01012,1
cccba9fea74fea3b6f48c6df9b27d49f,46,34,3,107.33333333333334,46,0,10200,1
c3713083aa77bfb254d5b637fc16e407,38,38,1,266,38,0,10200,1
90662ceaa48c3289eb2f5c3339960957,34,34,1,238,34,0,08010,1
89f33da86e2d18127ab434752e05cf47,34,34,1,238,34,0,05040,1
decee14b6bc7b8dda5313d71580bb1a2,104,64,3,242.66666666666669,56,48,08010,3
621f9f6e659a9efe5267ad0efea68a13,611,162,1,4277,0,611,05040,4
fcb44833021b6417859ee1c0cac5c57c,467,202,2,1634.5,203,264,04020,4
22a6b52296c030fb3aec1ca0d0b23aac,250,114,5,350,205,45,01026,4
9383a1c2c6f026e4b1f027255ec32e5c,145,106,3,338.33333333333337,86,59,05040,3
37a2ca77fcbfadb43f10c2cf159dc5e4,231,120,2,808.5,123,108,10153,4
6647761a56ef312e2bc935c2c685c051,73,62,3,170.33333333333334,73,0,05040,2
796dbf0787fef4bac15c9e5ab7804474,131,108,4,229.25,95,36,05030,3
7592304e46ce66d675d3a8c0fe81e3ae,135,80,3,315,101,34,01012,3
19cdb2613998fa969c14fc4289872260,46,42,1,322,46,0,10200,1
9184665c7a8d76dec6aea0535acd8188,91,77,2,318.5,91,0,05041,3
46f655b92150d4d396fdbab9f5b6ab7c,13,13,1,91,13,0,02620,1
28ebf42845ddd06d279eb5681a1de053,103,76,2,360.5,103,0,02691,3
1da1b59d957811e94b12b114f022ced9,130,65,2,455,115,15,05100,3
3e756c0d74204879804aa22f03f513cd,300,127,6,350,255,45,05030,4
e44750793c2a49d1f38516f17a8bd0a8,89,49,3,207.66666666666669,64,25,08010,3
e293ed3a365f0e254139f5fdef19fa78,202,99,5,282.8,202,0,08314,4
29a22de109b58003978e8b2e1cb0d0bd,39,39,1,273,0,39,01013,1
5f18cac9696db0999fa7ab05e86eea38,264,131,6,308,213,51,01026,4
2837e18c5ff4685263f1f6464c1c9930,90,64,3,210,36,54,01026,3
6b3428dc8ed266c0e25b14c566143a45,82,55,4,143.5,72,10,08010,3
54c191e00bf91b0b2e8ff4c76f965956,447,126,3,1043,178,269,05040,4
832869f580f8872812453993a8ba29ff,94,77,1,658,94,0,10200,3
4be9cae344b61b0bf8c0b3dc1caad011,49,40,2,171.5,49,0,01201,1
c8b0254eef2cb94d7e27dc88216eb628,3,3,1,21,3,0,04201,1
3f8c274f80ae29bb914fa3dfc4f6c512,63,63,1,441,63,0,01251,2
1eea0c1ad3afd08a4903ddc439ae31d6,20,20,1,140,20,0,01027,1
81da8c0f7aa3782c5ccd669c5b24330c,17,17,1,119,0,17,05100,1
913782199eab96de97d8edb9f9165e79,53,53,1,371,53,0,05040,1
d6b5cc05f8562a8c25a21c8625a6e228,148,51,5,207.2,148,0,01012,3
76929fee7a3784fe485d7e2d709d682a,44,35,2,154,44,0,04060,1
4aaac6083d7df10d222b658565d785d3,645,142,2,2257.5,47,598,04020,4
b4c7531d91f085329a349b8232b64546,124,95,5,173.6,107,17,05040,3
d6e78263f3a1fc109b7af7834dadb50f,152,85,3,354.6666666666667,99,53,01026,3
23605c408c96f9908b0eb7d33f1efee0,47,39,2,164.5,47,0,05040,1
17e390b78f0da9e0d4834f1b08ba8921,46,36,2,161,46,0,10153,1
298bf55a9f88305822912997ea252f4a,137,74,3,319.6666666666667,98,39,09351,3
56669bace33086db022c4be3aee833f2,30,30,1,210,30,0,08032,1
3315efc1ea11e1c86f71e3b8bc918e12,46,37,3,107.33333333333334,19,27,01026,1
5e05595718fae9b352de6a52610c234a,82,63,1,574,0,82,02690,3
c510b47ac7a9a091b124384be83b4cf9,321,104,2,1123.5,321,0,01026,4
12db9d8f640299620990d63a4c625afa,30,30,1,210,0,30,01016,1
d5910cacfd0d827aec6852d438f9856b,11,11,1,77,0,11,05040,1
0e42fac52c694ba72285f5e28c173410,202,88,1,1414,0,202,05040,4
83043dfa0b96d506fea7ce8a8e08d5c2,460,142,5,644,400,60,09150,4
31e03f18b81d8408eb1de2bd157c1e52,32,32,1,224,32,0,01027,1
541bd295389baed123f0b7afc57488ad,30,30,1,210,30,0,05040,1
874226f1cefc41dfb0fbc192b6752b1a,58,38,2,203,12,46,09110,1
3bda534fd7cd1a723b73bc66c956625c,66,52,2,231,35,31,05040,2
9d43b265dd3f1158e040c94fcd06c163,49,49,1,343,0,49,01026,1
5c74a88407cf30bdd1f13b44fbd62d7d,84,71,2,294,1,83,05040,3
7a798fd9455e90854d826bf2d8ccc379,28,28,1,196,28,0,01014,1
10ac4871da8e96b9f4345156a587b345,61,46,2,213.5,31,30,01085,1
0208b2566a5760db57b63f74edc32f8b,39,39,2,136.5,6,33,01012,1
8f43d135ef89eb81d269b908f26d70e6,30,30,1,210,30,0,08230,1
709bc19d2b284584dde5ee5dd8a7e069,35,20,2,122.5,35,0,11040,1
daa23eff8ac69266a8dbdfd56793eee9,70,48,1,490,70,0,01026,2
d779817580cc4a98dbe87c751990aea7,204,126,3,476,167,37,01013,4
dddd6731cb7e2aeb5c8587d336714ddb,114,76,2,399,114,0,01026,3
9a7eb7d274ef5ae19289709db4ad30cb,24,24,1,168,24,0,02691,1
adcca79ccf3ffe565366c4c557753020,25,25,1,175,25,0,05030,1
2023e1d8bec58604b22cc589d5e1adce,185,93,3,431.6666666666667,65,120,10200,3
cf6dbe385b9182185c184ad6f9f64588,30,30,1,210,30,0,01012,1
208e3051b37ffdf7dc399b331bdc9c29,25,25,1,175,25,0,01026,1
4276e7abcaaa9035b62a3e590adf8ab6,42,28,2,147,42,0,05041,1
a0c3c9c27c33b4121c9ea124b9dbbb8a,361,142,5,505.4,326,35,03050,4
5b166ca298ee9a11f48d73a79eceb54f,141,104,2,493.5,141,0,10200,3
9eea23ae6c85105cc9cdba2a0770a209,19,19,1,133,19,0,05030,1
c3e8380874c86c8f3657c9e4e51dd9fe,280,130,5,392,267,13,01027,4
f568287525593ef88f7faad2fc06c92e,156,103,3,364,102,54,05030,3
0e0770bd0f685ead30b25faa2fecfb0e,24,24,1,168,24,0,05030,1
716f7eba32d21b4d7561e2e1df62675b,7,4,3,16.333333333333336,7,0,11040,1
c73e07b7440da19b6f6c6cf7516f6d2b,45,45,1,315,45,0,10200,1
7c460eefa24cb7ee76e36f2969260643,87,57,2,304.5,87,0,01026,2
62c541a9144b8742508fb4cfd6b32b8c,174,93,3,406,174,0,08314,3
00339bd0db8a3a3070c85e793ca7dd43,41,41,1,287,0,41,01012,1
93838660891024e9bb8fb577a6c7be1e,20,20,1,140,20,0,05040,1
0ceacef5201793c4ff67ce5f4d8b2def,204,128,4,357,100,104,01013,4
0ce7b3fbacc3f1329202bb48770a950f,51,51,1,357,51,0,11080,1
fd15b70d5eb5866ca33119a5c3f7715d,301,151,4,526.75,217,84,05040,4
0e9c94753369137226693a3aa35c78cf,73,53,3,170.33333333333334,55,18,01027,2
2d91dd436b4a1de5439fabc326772c57,44,44,1,308,44,0,05100,1
7fdd6271b656cc3296bae9113733c851,29,29,1,203,29,0,11040,1
3875b32e1549cf9775f39ec7adaf76b3,49,36,2,171.5,49,0,05030,1
6538ac3f527be9bcfe93a4d5e60014ca,49,45,1,343,49,0,05040,1
32b105b4ffe3ba0eaaebd0f6cb925761,28,28,1,196,28,0,04060,1
a518b3b41a438d493a727bd30f1efa98,21,21,1,147,21,0,11080,1
38820b67cad8e7b048393f8677559f7e,10,10,1,70,10,0,05030,1
bcbbd1ca43a563c7aaec92677761c8f8,47,39,1,329,47,0,05100,1
06dcd57830630fc9a7c5a6809bfab63d,7,7,1,49,7,0,08032,1
4098261cacfec17f5bd42eea791c6a15,134,77,3,312.6666666666667,51,83,08032,3
770e51443d5a99f0aba55357d411e5ff,179,108,2,626.5,179,0,03050,3
1eb5d176c77581e9a0cc923cb6b08ae0,20,20,1,140,20,0,01026,1
f75297f5d9305fe287e10dfd16198096,38,38,1,266,38,0,05040,1
333ef66d678283cdea062964aa5a71b5,12,12,1,84,12,0,05030,1
9f2c2ee9d07c65943227ca0300ae248a,50,42,2,175,50,0,10200,1
b2a13f68f8aead0356b219cb98b6154f,2,2,1,14,2,0,08312,1
f991602eeebfe3c60fdae944d69dd142,54,45,2,189,54,0,04020,1
1a62888a87b45f998d9c86d7ebd0ccba,96,76,2,336,96,0,09130,3
5e476b5109d6e543cbb576fd94fc74fc,36,36,1,252,36,0,02620,1
3b6523a3f0fce5bf5e94d573a1c99fe5,60,47,2,210,26,34,01013,2
11711003eefdd53e8c6937dd3181486d,24,24,1,168,24,0,08010,1
1a1ab763abcf5f26455833a70a7435f2,158,89,2,553,158,0,04020,3
65b4f2f74410c576bc5c9bc71362b55e,17,17,1,119,17,0,05040,1
11776aee24acc361f533e2dc3f11bf80,82,63,3,191.33333333333334,58,24,09130,3
ab41d78785a34749a9c9a7c147740908,146,94,4,255.5,94,52,05040,3
36aff426dbb41424c3b4a5ca20538e0e,41,41,1,287,41,0,02650,1
ba662de47ba22528c1f61abb8bc44ad2,70,40,2,245,70,0,05041,2
148a80b789a67574e478ec8ce5cfe7d9,28,28,1,196,0,28,05030,1
7bd943f3a08c365b049d9df82bba0003,49,30,1,343,0,49,01012,1
3e46292df148b8eef432870abd51fecd,27,27,1,189,27,0,01012,1
413275182e3667b4b0f5dd0b60940c3b,29,29,1,203,29,0,01026,1
a6a1c1833f11d499e6672040f65b1925,40,40,1,280,40,0,10261,1
5815c26f0ec726e6ab76566eb8caefb1,24,24,1,168,24,0,03070,1
83988b012cfa0b40e5b12b7a5cc1a6a1,6,6,1,42,6,0,05030,1
bcc3bb9a20236ede7c622c00ef5522dd,41,25,4,71.75,32,9,11040,1
3020218b8ce8a82ff14f05ee5d58f107,46,35,2,161,46,0,01026,1
d18346c3cab53b04819df3b9356d3e18,53,46,3,123.66666666666667,53,0,05030,2
99b4f7c74c3c5b2e96272256c492379f,12,12,1,84,12,0,01012,1
90c30cb27be61c6a962cfe20ab11390c,115,70,4,201.25,95,20,03050,3
f108ceeabf2718ae56b9b71e36c8f060,38,33,2,133,38,0,05100,1
4f4cf380cf01f9c33fb088346af0acfd,65,50,2,227.5,65,0,08051,2
553cf74236eb8e6e6cd2c2ef9aaa5858,6,6,2,21,5,1,10200,1
9a8e555c3ac7a1c89a93dcedeefdb024,151,83,4,264.25,120,31,05040,3
f7864358f1a9f16ffb73e494e922487d,153,122,2,535.5,41,112,01027,3
8f3c7c8a08de1559384c95e5400d9fab,17,15,2,59.5,6,11,05041,1
bb7726c10fc1272dcd5dd85df846c0b3,27,27,1,189,27,0,01016,1
b35330fc720163a108e8afed5a516c6b,39,39,1,273,0,39,05040,1
1e3ba75a94cb7ab6f3084b2f3e70c0da,111,78,1,777,0,111,05040,3
7ed237cdc6ef1a6c1cb7c64824093fd6,129,76,4,225.75,98,31,02650,3
accf896ab31e47e75788af93fbfffccf,24,24,1,168,24,0,01028,1
a2fdabc6d0caa5f75614bde1df9d8c69,30,26,2,105,30,0,05030,1
b8740d5385cdfaf55d0764424b650cd8,69,49,3,161,69,0,01012,2
0315ea00e04d72abe64a878a3863a3b9,116,76,2,406,40,76,01013,3
6f50b83089ff454d9518008c878783b7,231,122,5,323.4,132,99,05040,4
4aafc17919153441a08a0a9750efa895,33,17,3,77,33,0,09190,1
9743030a1a4bb5c49e9a8762d088e181,57,57,1,399,57,0,08010,2
5603b4cfcb36b3e65826012ea3f60193,88,63,2,308,88,0,05100,2
fbf807961594b3847f504864b04c1988,34,33,1,238,34,0,11080,1
ca0cf0e265915f07b2aec871d5ca62ab,33,28,2,115.5,33,0,05040,1
b7a4ad110a9b9a7ea2a69087385261ab,29,29,1,203,29,0,10153,1
d100a8fe14bbf1d96865cd08ba7231f3,51,40,2,178.5,51,0,05041,1
def9234c96ce67d4112ece1919d1973c,119,79,3,277.6666666666667,71,48,04060,3
658fbcee9cf60320f1afbddcbc0c8442,30,30,1,210,30,0,01012,1
655ebd4e58db9473ebb75e66380f5c5d,15,15,1,105,15,0,01016,1
7e4c9433b4e55968bf29c2e5a7d510d3,368,95,2,1288,328,40,02650,4
ad976216ea97626fb1f4b1e8798d38d8,34,34,1,238,0,34,01026,1
e61474a6b46cfaafe249a27e319fe85b,53,47,2,185.5,18,35,10040,1
96fcb311c3b282d0c80df19d1ea80705,26,26,1,182,26,0,09010,1
5781738b64138ff786be542c75567519,229,129,5,320.59999999999997,229,0,09150,4
15b80900518fd8dbe5955213387ae3f1,98,98,1,686,98,0,10200,3
fed870336348fef2d0ff143aa30da587,54,54,1,378,0,54,08314,2
417416c4f6a59367b6564dbc07a46a80,117,92,2,409.5,117,0,01026,3
bd56faaadd4663c31cfe18314f668a80,7,4,2,24.5,7,0,10080,1
08d1fdc62458d7fbcc5ef6829872107b,41,34,2,143.5,41,0,05030,1
40b9d1182079cb4608087b236bb8fc9f,92,66,2,322,92,0,05040,3
a96aad1cfc9ce13c08ad2bde0175bae5,216,109,4,378,201,15,04020,4
0bf23a8222294a1fad185673cfa60f30,111,61,3,259,77,34,10200,3
4260de43b5e3cd6b4eb1bffefc39960d,33,33,1,231,33,0,01085,1
e68e26db0270235e9c8bec529fe6661a,76,67,2,266,59,17,01027,2
8378eb3418c62cfc1e7863eabe10de56,176,98,4,308,176,0,05040,3
ba93cb1a1714b7f412e171e91bfd9c07,31,29,2,108.5,21,10,01013,1
a10977ad211863c26518fa360298cac9,291,127,5,407.4,249,42,01026,4
c142fbe7add004e627af17c9889dba7d,29,29,1,203,29,0,05040,1
2b80dcdb7bac57d6834471eaea647b54,44,33,1,308,0,44,10200,1
13445ab53978a9913aa5e13fcd691294,89,50,4,155.75,89,0,01026,3
b2d529610579897f012e0d0384b69796,126,70,4,220.5,126,0,05040,3
dfb75eb0397b41aef9dd2b8650295c7c,26,26,1,182,26,0,11080,1
581a13134a657a59ef7c8d3e98c3378a,156,110,2,546,156,0,11140,3
19f217b35426592cabea4782ed220084,21,21,1,147,21,0,01012,1
3c2c9c5c40a47a456d92aaf0a32b6165,10,10,1,70,10,0,11181,1
5d6229ea523ebdec07b0c9bf70c9adb9,10,10,1,70,10,0,08032,1
3cd9fb69e36ea3eefc15c8ee8e6dc4e6,67,28,4,117.25,50,17,01012,2
27198057263fc8c5da5be90b82a053b9,280,132,4,490,152,128,05040,4
be070a8623328614dfc608d91a46cb6d,199,116,2,696.5,199,0,01026,4
b53b627d554ec7cc8aff3274e03dedf5,31,27,2,108.5,31,0,08230,1
8636261c94269d05f4a3d34da6f08ce7,39,39,1,273,39,0,03070,1
5d33fbf1d1ec1714201414277a6dacfa,104,83,4,182,92,12,05100,3
18bec63cd4c6d33286888d9ef4853089,99,67,3,231,68,31,10240,3
c3333ac9d52c97911b096bd5edab55dc,10,7,2,35,10,0,08210,1
fcbababf9374b37aa87130a0cccaf06a,206,94,4,360.5,171,35,05040,4
25db2cbcdfb318af569c1206e2cfea0d,37,30,2,129.5,37,0,05030,1
cbb7592b32b052ab8048591c25f2ee27,27,27,1,189,0,27,01026,1
7b83be58c49eea99b7e4e92b21b69872,55,44,2,192.5,1,54,01012,1
07d663bf4e70414605825434e2256c92,27,27,1,189,27,0,09090,1
26348bab5a889250a7bbc96a340fe408,26,24,2,91,26,0,05030,1
56a613d1aed65cd6b59cd7644b12490d,67,51,2,234.5,34,33,05040,2
90d843b688eac25901728067cbaa1cdf,140,110,3,326.6666666666667,124,16,01012,3
f4d3a807326531ffc384d8bd78cc1128,77,70,3,179.66666666666669,77,0,01026,3
2fe889c0a63ff3fdf87623df706cfa80,3,3,1,21,0,3,05030,1
10dfd66003624bd475c16b0c55bdf688,11,11,1,77,11,0,10200,1
0af3ca89e4aab7d929b944e290a0190b,100,49,1,700,0,100,02650,3
fc64f7d3fb8205923aae909d51df5539,97,73,2,339.5,49,48,03050,3
56f33d00463a7e590021ff1acf00f81f,182,138,1,1274,0,182,05040,4
247afba744ee3e6eac8a570a42040aea,252,126,3,588,188,64,10200,4
a7b863c79a4d75e4147f1d8f01423d2a,337,93,3,786.3333333333334,337,0,05030,4
f5862c1cb9e075f65a4778dbfb081215,85,65,2,297.5,85,0,01027,2
2a506c8044804388c10950a5a39a819a,21,21,1,147,21,0,04020,1
269a6d9bc2089a8ae20868469d1b792e,52,47,2,182,19,33,08230,1
1a4f95ada98cce7859f4d332dfbc78a8,22,22,1,154,22,0,03050,1
857ebb4305746482793121118439ed58,73,51,2,255.5,27,46,05040,2
98578c11a3cb100fdd8d4a10b9553717,100,77,2,350,1,99,01012,3
1f70bd8996dcc0adbc2b17c40af58840,22,22,1,154,0,22,01027,1
e142abac440fc3a6bdb6d5709e99e77c,352,109,5,492.8,314,38,05040,4
e7364972beb0efa9600a1dc72870c776,55,55,1,385,55,0,01012,1
9bb8db103355cbceb73c6abe6d2b36e1,255,133,2,892.5,255,0,08314,4
d66c36d40d74c3f670e6ec96c4d088aa,60,47,2,210,60,0,05040,1
07b93f0f3294649075ee3d8a5cde4a1a,176,89,4,308,176,0,08051,3
2c27f88ad5dfeb3f4debe432c460d581,35,35,1,245,0,35,03050,1
c1029c23fc50f17ebfecfec83baf2aad,22,22,1,154,22,0,05040,1
b3238800ca7ebfe11f3a71ae28db1a4c,281,101,2,983.5,281,0,10080,4
8eb36e022c9c29a8d2e7d65a1fdace79,83,26,3,193.66666666666669,83,0,05040,2
e43d8ceda0a0c309b058ace3dec300b8,80,52,2,280,29,51,04020,2
c25f1a13e603013924163db287b27dc4,334,170,5,467.59999999999997,233,101,10200,4
cff97af1a2c9f44dce252f923fdcb521,24,24,1,168,0,24,01013,1
856fb35a3e0a96d2e8288db795e16d27,9,9,1,63,0,9,12500,1
f36155b32b94bc0cfdec201c9f64cf67,39,29,2,136.5,39,0,05030,1
02400d1e6f992b44be16901375f87ba1,164,104,4,287,113,51,14301,3
fca25b7a01eccef23863ee4a36d870bf,32,24,1,224,32,0,05030,1
37fd6d7df01190c1c93d210019bb18f7,87,76,4,152.25,38,49,08090,3
a72537d5e1f84ffa1b03d65a563dd63f,99,76,2,346.5,1,98,08312,3
99b1b95dcf168872f812fd4806df515e,88,81,3,205.33333333333334,88,0,11080,3
5f923db8dd2f7b8b927cd3d4fd9591ee,147,68,6,171.5,122,25,05040,3
2a5f4a24ee0b30cae71c428a0513c682,141,89,1,987,0,141,01026,3
82858f2bb2684a2f2eaeec588a6868be,178,93,3,415.33333333333337,178,0,01026,3
aaa9c837e06bc907b67a6f87fd634ba1,299,98,1,2093,299,0,01026,4
c7fcae944e78510d587bdc8df29c3b7b,25,25,1,175,25,0,14301,1
3f7c44209ef6c73b82a25246f68de95e,22,22,1,154,22,0,08150,1
ee30b46cd7df912fb57d804f49644cd8,19,19,1,133,19,0,03070,1
b10f936da129bc2576934e550a63299a,20,19,3,46.66666666666667,20,0,12501,1
14d84dfe1a23868e56faf32f11338e34,38,21,3,88.66666666666667,24,14,08010,1
e145302599da21d2944414b7177ad45d,12,9,2,42,12,0,11040,1
8b10321264d6b3c7287c6577cd9fd630,259,148,6,302.1666666666667,244,15,05040,4
22bd79a438b9e6c2227339b74260cbb6,75,51,3,175,54,21,10200,2
6fb1f3c750d907ac85c2a4dd192dc292,15,15,1,105,15,0,01026,1
c67b2f881627d9f965d38a92c94ad752,10,9,2,35,10,0,05030,1
e2df943dada63e43eca3b6f83d5c7647,35,35,1,245,35,0,08230,1
539647a74685fd55a5b9359fb401c920,29,29,1,203,29,0,01012,1
a29239a55065d2b51d70f348fcb36169,17,16,2,59.5,17,0,07143,1
4cf94ee9cdc6fadd5217f4e8a44e26a3,142,100,2,497,142,0,01012,3
8d750bbb5987d3414e4c708b1afdb961,335,131,4,586.25,335,0,01012,4
ff918af2f731c89843c12b1ad8ba3268,396,174,1,2772,396,0,01026,4
a22dc79761aada2534064bda24f95e52,99,84,2,346.5,49,50,10200,3
532277ce40f974ac2c4393ae02d43890,127,84,2,444.5,127,0,08390,3
4f95767879d014eea02d2e6a9f711558,22,22,1,154,22,0,01013,1
0f9bac04261ac3af7f97445b87016e72,74,58,2,259,74,0,05030,2
e793f17862706fa4fd23c8c5c16cdc05,30,30,1,210,30,0,09130,1
34564b89fa3242ae4f834fd7b39bb587,126,73,4,220.5,126,0,11040,3
f5eea28593746058e4796970340be768,98,78,2,343,98,0,05040,3
7de1eb75bc8705f94f2a30c05f7cb62f,109,74,2,381.5,109,0,05040,3
df09d35c85015ac02fac683f5bf03af4,32,26,2,112,32,0,08010,1
c0730f4fce61a4f4b43640efb7433a3f,58,43,3,135.33333333333334,33,25,13953,2
c0838334b587d06caff478613d9ae260,16,16,1,112,16,0,01013,1
1c45e7d6c7bef303bb611ad2e9816f2c,34,34,1,238,34,0,08100,1
e94786faef636994e4e3a8faad0c3e3c,547,131,2,1914.5,46,501,08052,4
94123cf6fc40edc748f15c67c99a8af8,32,32,1,224,32,0,12670,1
b784cf398aea1b11bad7408e3392c579,10,10,1,70,10,0,05030,1
5484f5119dc5dc60823042c6ee0d1b43,136,88,3,317.33333333333337,110,26,05040,3
45a0b8178620c2bf2f49100523400d4d,17,12,2,59.5,17,0,11040,1
d0e769472ab7f129df2ce559a494c285,39,36,2,136.5,39,0,12570,1
24365a8fb26280361d533363bcbd1e9e,13,13,1,91,13,0,05100,1
7cd7a76804da535f87990892a6083347,115,80,3,268.33333333333337,115,0,05040,3
decb8a40b2211336434050b03d5a17a5,196,61,5,274.4,196,0,11040,3
f6c29e78162e343a1949a601b9075d5e,28,28,1,196,28,0,03070,1
332e71063795768a15046169e28fa0bc,122,80,3,284.6666666666667,92,30,01085,3
c60ec866b157eb909f72827760ff924b,632,204,5,884.8,632,0,01013,4
cc7603327763d1b3b05564a93b971b04,20,20,1,140,20,0,01201,1
4f34fd0f72bdc3757937889ba6025489,63,46,2,220.5,63,0,08090,1
3e8fc15735ff4ba10099f5ff56ced189,27,27,1,189,27,0,07131,1
c45bf3e7075120a7d251a04057639bc8,68,68,1,476,68,0,02690,2
320ae9b5eb80cd9032719a22a780dc49,331,108,4,579.25,331,0,05100,4
6d7997ab4801e01f2a0f73238b71db04,17,12,2,59.5,17,0,11100,1
13ac592673e3bc1e6b68bfc4a6a1f809,44,32,2,154,44,0,05030,1
2ac9e20e94e1227c9353085f78fe23e7,65,58,2,227.5,42,23,05040,2
60cbd292b7a6bc5e47d236cf63ad2cc0,67,51,2,234.5,67,0,09130,2
caea5b6a65236109a901ab68b6959fe7,33,33,1,231,33,0,01027,1
848ad83c32a5ab8066e0d77a05a11938,26,26,1,182,26,0,04020,1
5b61503c8d43de8d3e167bf4a2d0e42d,112,80,2,392,112,0,05040,3
f7a740d16dfdf345a85b0f7afb6d8546,49,44,2,171.5,26,23,01026,1
a8860554095df6630810781c45340719,187,114,3,436.33333333333337,187,0,08230,4
58cce871499549b0c38798a0c93190a5,193,75,4,337.75,166,27,04020,3
e925baec7ab8d3d4721312b5dec1b3ad,6,6,1,42,6,0,12710,1
b7f1cf02a48a8f29f5974d0b4693357c,37,37,1,259,0,37,14301,1
8520d9b21fe0d4e27fbf1f8ab7675b5b,130,91,1,910,130,0,09150,3
fe0c43f0865b04529a08e196e21d8f5a,175,44,3,408.33333333333337,175,0,11140,3
4468d72d2cc4e056b18eaf202b7f6d12,21,21,1,147,21,0,01201,1
95535b70ddd00d0527281ebac6871019,28,28,1,196,28,0,03070,1
6eec8b5af86a982afec1d196d580e777,93,71,1,651,93,0,05040,3
d0f002fadffeaac99ba03a02fb7ac419,18,18,1,126,18,0,04060,1
8469f381624beb4f796c47ea1ba2700c,15,15,1,105,0,15,05041,1
0d4605e50f2146ec539435ebfa92f0a9,29,28,2,101.5,10,19,05030,1
3b70122e75604e3ac2ab4e4e16e5c9e6,13,13,1,91,0,13,03070,1
776cb59089386f07dd3cea30220fc458,34,34,1,238,34,0,01027,1
6bac76dbada52f28d9145c0cb07e1f57,98,77,3,228.66666666666669,78,20,09190,3
4edecf902b7582a856bd8faf124ab81d,45,45,1,315,45,0,01027,1
5e2be51337fd699a1ed51c466cd53f31,49,38,1,343,49,0,03050,1
8e0bb7b638c4a0c5d6a5c8eb43bf436f,24,24,1,168,24,0,10200,1
3168184e2f2485f0dfeb5a0c44fea0fe,59,37,3,137.66666666666669,36,23,05030,2
c02a1fa627b0a6d1ff2fab0fd7bc96f9,249,130,3,581,249,0,01026,4
55cb448d799c89150b041453254dba90,112,73,2,392,44,68,01027,3
59f47131f45ed49871ab460426bf7624,75,55,2,262.5,75,0,05030,2
bad962405bc5e2536a6ad8acafe5f3ca,35,35,1,245,35,0,01085,1
87acf61e37fa45841aed110313cba35c,98,63,3,228.66666666666669,60,38,01026,3
c59c02c4902232be03446ae6a89f66de,39,39,1,273,0,39,05040,1
56eabb2cee948164150cffe2d985110a,681,213,2,2383.5,472,209,05040,4
dc308b5a0a2a8f2d61724dbfcd5210c8,21,21,1,147,21,0,01026,1
62886816a54c53ccbe4d74250bc3e127,126,81,3,294,69,57,10200,3
f2f3c45da8f215677364ed0530017bff,38,38,1,266,38,0,01026,1
47d0e77dbda9fcd45da57a461be6f6b7,11,11,1,77,11,0,08314,1
9678e47ced029f525b1ef568cd299f08,30,13,3,70,30,0,05030,1
35c0be86dd61bbde927ab817d4a42f8f,1,1,1,7,1,0,11040,1
7ea3a834806c47a0897897f74530e28d,96,72,3,224,96,0,05040,3
2be9c850f14bf0fb9047d7091bbe805f,264,138,4,462,243,21,05040,4
4f8a699d2d5a8dac47a628c120e19d3f,278,99,4,486.5,255,23,01026,4
52c8f8168613d3951fdaa80f1ccccdbf,226,76,5,316.4,167,59,08313,4
65a43a256ba6f5f9ee88ad602c6c9c09,101,56,2,353.5,101,0,05030,3
c5eeb974b189570c9fb07ba0dfea3c8b,39,39,1,273,39,0,05040,1
097400feb71239a5cdd06157fac14b11,26,26,1,182,26,0,05030,1
cec484c1e991c0c03087635265e56a90,106,79,3,247.33333333333334,74,32,05040,3
5d1909288df3cbcc59155858d8a63499,65,44,3,151.66666666666669,65,0,05041,2
5a0b31c2f48956155fece636184aa62d,18,18,1,126,0,18,10281,1
636e5a2915459faeeab17ebafdb736ef,27,27,1,189,27,0,05030,1
3e7b6cdcc21d59294bf86ebcddb06294,60,60,1,420,60,0,01085,2
0b7d98a91d7379442d6c21654fd565d7,28,28,1,196,28,0,06100,1
28f97cbf7564e20554ae55b45246f547,27,27,1,189,27,0,10028,1
3888958d8637f376a87134be692e2350,1,1,1,7,1,0,08312,1
b4991f0f517bf35593013a7c499e9a33,53,43,3,123.66666666666667,53,0,01027,1
2230d0d0a4a08737b10ce7d002b5be53,44,31,2,154,44,0,09010,1
0484eeddb99c6db95aa64126f919b390,65,52,3,151.66666666666669,65,0,05041,2
62d6b46509d70470ffeb32d92ec1dcc3,184,92,3,429.33333333333337,119,65,03070,3
e82e06fe7d21bfdccb881f7f52e964df,471,188,2,1648.5,320,151,05040,4
5078ff6f16d7cf2e7c5784eaae26698a,56,46,3,130.66666666666669,56,0,01013,2
ba143782a2658ac5fe6f9a45ddc10ee1,72,72,1,504,72,0,01026,2
e1fe202531ddd9156ce03d4e90a018a2,365,182,6,425.83333333333337,279,86,08314,4
bd4a13ed04d21148e348e6ac5777f3a2,139,88,2,486.5,139,0,05040,3
c2584a816d54174ec3ab7d336731cb59,73,64,2,255.5,73,0,02650,2
d031b2363641705b7a8b0611cffffbbc,42,37,2,147,42,0,05030,1
c70f8ccc094c58eb4518aaf7dd1ac7e6,94,59,2,329,48,46,05040,3
ea75a6f05c161dcf79c78c223f6dda21,98,61,1,686,98,0,01012,3
805884aec6167f5ad43d4e7a3b8b8400,12,12,1,84,12,0,05030,1
58953164d535b3da55cee67cbf535436,55,55,1,385,55,0,01013,1
933a4ded1cfe505396db82ea27f2020a,43,43,1,301,43,0,01013,1
b1d5263c8796035d9bda7a43680e2e90,49,39,2,171.5,49,0,05100,1
1f55481831c828028ada929360f6abaa,59,46,2,206.5,59,0,09010,1
78c43a4f3d267aed31bb50cd9b7003f3,49,49,1,343,49,0,02650,1
cad0f3dc4a756b1b1e1dc50a8ce55a9f,22,14,2,77,22,0,09190,1
f743b84400f101a59b6b75a24b704cdf,3,3,1,21,3,0,05030,1
98a96c028ee6441a1c7f09e146d054cd,1,1,1,7,1,0,09091,1
60bee0eb5e92dff7a160b51c55ea09bd,10,9,2,35,3,7,05040,1
82a8ace6919d26600b38ba1bf8f68dc1,28,18,1,196,28,0,11100,1
22dd482d9ef5c29585e0bc5b3f98ed11,29,17,3,67.66666666666667,29,0,11040,1
46f49ba8d13930ccc6bb004fd2e88473,11,11,1,77,11,0,11100,1
36055482996b35b9818352e388792326,9,8,2,31.5,1,8,03050,1
ffb4289b2dd09da1db594d9cd4b15858,467,169,6,544.8333333333334,428,39,01027,4
88ad3fed71814b399490fd0df732ee65,56,45,1,392,56,0,01026,1
9873b0f3f97323b38280c632d3ef0249,96,50,2,336,59,37,11040,3
1f30a8822639054476ca439149ead28e,75,39,2,262.5,75,0,04060,2
b43e263f1d92c9568b13955e84da6e11,148,94,3,345.33333333333337,148,0,05040,3
f1425702213a653e183a7da2f8e03895,120,76,6,140,102,18,10200,3
b52490c55749c165da46ff3fa683620b,36,36,1,252,36,0,07144,1
9e2dabca23abae8b4b78ef8e654303a7,38,38,1,266,38,0,09030,1
22e3aa607f897088b11528c6e37b3e7b,50,45,2,175,50,0,09130,1
b750bcee305884d4a8deb76bfd731e84,22,22,1,154,22,0,01201,1
de03c283df97d1e78e0983196062f7c1,68,54,2,238,42,26,10200,2
ec3f2f7ea5658709c7fe5502db09906e,31,31,1,217,31,0,08052,1
65175dabebad6e5a270d75c0e809acd3,35,32,2,122.5,35,0,05100,1
8eb297ff1b6570a6f71f88ff9184f5a8,61,37,4,106.75,34,27,11040,2
5cd22918b8b9c9b5c76b431da22116ae,30,30,1,210,30,0,09030,1
4ca503e3902d6f2c5242b5ab8a43bfd8,36,36,1,252,36,0,05100,1
cf8972d92f2eb2b1a4ad1b600c6ba214,13,11,2,45.5,13,0,12550,1
3841e6c9d5eef9b83a0a91e8d045b91d,50,42,2,175,50,0,04032,1
5d4ef5dd4eda1eb71b24c446819cb330,15,15,1,105,15,0,01085,1
8de7447f17f2f76ce41b73678bd7fe92,33,33,2,115.5,33,0,01085,1
b8dc01f61fa4004cdba5dce19b1a5f50,225,107,4,393.75,174,51,05040,4
e02b93bf5f95a5210e025e57aa4c6089,19,19,1,133,0,19,05040,1
22ae0e458230efeb8315ae603c005f9d,131,112,2,458.5,52,79,01026,3
77b1b8d22282d97c51c6c41ebca09889,70,57,2,245,70,0,05040,2
2d5c83305910a7b9f3abf53c7d7a5626,79,49,3,184.33333333333334,55,24,05040,2
3a1950ede579c640accb4bda102f9be3,5,5,1,35,5,0,01012,1
41c07f0b458b2e0979d65739ee41566d,123,81,5,172.2,123,0,05040,3
449ccb88dbea7e4ad5c1084246908d78,15,15,1,105,15,0,05030,1
124e92d515bc9a66e9a8c1425aa63038,107,62,3,249.66666666666669,78,29,10200,3
da35080b85e1ec33317aa4da8e7601cc,18,18,2,63,10,8,11181,1
01dfda7bb3b0af2569ac1ce10cb0eb08,18,18,1,126,0,18,11100,1
c13d67e6220c04430968a7c822eeffca,149,81,2,521.5,149,0,05040,3
e280f83ef49d3ff663c35d877f596c97,11,11,1,77,11,0,04060,1
28da68fddc860df15da2a12fd59ac7e9,44,34,2,154,44,0,11040,1
7c12a4ea92c63ac821b4106c4584b064,22,22,1,154,22,0,05030,1
a8cc2302e8ca565d538e7bd6094e9f89,26,26,1,182,26,0,03050,1
8577e18648939e5c3b34d46d0eff94e1,114,52,4,199.5,114,0,09110,3
c4207c81510fc6458dc79fbea528431e,32,32,1,224,32,0,05040,1
1c98b82a001f20671e2726f2c18e580b,268,130,2,938,45,223,05040,4
74188f14f499a4611e3ea5f699d431c8,149,110,3,347.6666666666667,98,51,01012,3
a4b741b9d2c798e3ea2ba98120f73fd4,19,19,1,133,19,0,12590,1
21d17ecf87cdd01673b85a05cc0d7ca0,577,158,2,2019.5,533,44,04060,4
e0ce1009485eae8353f95293e40280d2,72,52,2,252,28,44,12501,2
e59ff1d5a3fd6f1997e507101cbce799,82,71,2,287,82,0,11100,2
0257834acf2245da07506ac019d9aeba,20,20,1,140,20,0,01013,1
96f8300df5320ee6f4357ddee8ed73ce,400,130,4,700,364,36,05040,4
7f8df9033a5f81c4fa80fff1e2361f89,42,30,1,294,42,0,10080,1
bd736516d1c5c3cbf9cd74775c5cf1bc,38,38,1,266,38,0,11100,1
811878dbc8d10397be34e838de500b00,263,134,3,613.6666666666667,145,118,01026,4
cb32ffff7e5f17b20ce2937fed12ebcd,45,38,2,157.5,45,0,01012,1
39a6d2471a4a5ba63a1e5e01767b9624,410,157,1,2870,410,0,01026,4
911a31331a6c77a6e9b9254fe0dfe464,36,36,1,252,36,0,02650,1
47706b061da4beaa94f2de4d4929fd4d,90,63,3,210,63,27,05100,3
bd887be79b49b006b85963b8371cc94e,43,43,1,301,43,0,10141,1
37bad46293a6ca7e6ed46b6aa3fdf6d0,115,87,1,805,0,115,01013,3
a7b42eca45562e28db265ec6273d14d0,26,26,1,182,26,0,09170,1
ec79d26ea5c3513be450eb5a0b6523bd,576,173,3,1344,576,0,05040,4
1b3540a7985bed32f937e7b0e04375f3,319,102,5,446.59999999999997,282,37,08452,4
ace51db13bec22ef487041c0c79552ba,157,105,3,366.33333333333337,157,0,01026,3
9fb4d73a7dc54f81c8cacf12050df557,330,139,5,462,292,38,10281,4
603548542c97e8d911b4a25906438fb6,105,89,1,735,105,0,05040,3
82783d6cb8b58fcb10a681024a0278c1,204,101,4,357,87,117,04020,4
20c7d7317d8df5527807e831a3807361,19,19,1,133,19,0,09130,1
d0031419eaf91c3e974d99fac4c6b08a,77,77,1,539,77,0,05040,3
488e9ef21173468b3dec05e49b4eadd4,31,30,1,217,31,0,05041,1
ea5d410daff090229c2ee03b8252808a,26,20,3,60.66666666666667,13,13,05030,1
36355f876e7c4f99a84be0bbeed4d8e7,259,100,4,453.25,259,0,05040,4
a51c2525507b2f3e9878472907990560,319,138,3,744.3333333333334,144,175,01013,4
6f2cef0e4b2d879bc4a9b5c71488f308,122,79,2,427,122,0,05040,3
ec7f2b8d8263b2dbbb45dc8318508b1f,99,78,2,346.5,56,43,01026,3
61f3889b10a2aac9e926e3b2fe6c59d7,45,45,1,315,45,0,02620,1
cb7a4231dccc71f32ae7dfedcd3ffb8a,62,51,3,144.66666666666669,62,0,01026,2
6fa16652d8a9df2c30d97196722bc7f8,117,65,2,409.5,50,67,01013,3
0848332385f8283686f167484ebb3cdd,31,14,3,72.33333333333334,31,0,11103,1
4df04fd8de33efc5f6a206f38b51ede7,289,119,2,1011.5,289,0,11040,4
e7ff41450eae6052f76b9513d8d8e3ea,27,25,3,63,18,9,08090,1
2ae8abdadc2f840edd9634cb1461a58b,538,191,3,1255.3333333333335,497,41,05041,4
85e81b97eac3e6bacddafa8273148eaf,64,64,1,448,0,64,03050,2
0769ea1cbaa19af211bb89dfb9b82dda,244,137,4,427,179,65,09150,4
6a2228e984dbab537b34eb76ba33982e,25,25,1,175,25,0,05040,1
0a6129e858dbefb384816a1bc3763dd1,143,89,4,250.25,114,29,05030,3
5fa196dd12d367106cbf877bcb3626c7,100,56,3,233.33333333333334,79,21,11080,3
8e6dc44792fa1463607228d4b419f5a8,14,8,2,49,14,0,09010,1
7e19184bbf38f2da3ba7be1abd9cbb73,71,59,2,248.5,16,55,05040,2
d7fae7a8345267f0dbca342f6f79ea49,138,102,4,241.5,55,83,10200,3
58b20ddf33f24f6d96c15de55696ec76,247,113,3,576.3333333333334,247,0,05040,4
fa9cc8dbd9e71b408bf70d136d0f1062,13,13,1,91,13,0,08150,1
24324544b2e6d0469cf0569c5459e763,54,43,1,378,0,54,02650,1
773ec4115c0f5da2b92f646c79995910,44,44,1,308,44,0,02690,1
2222e44e178fe7f050935ab4c03e4f08,126,81,3,294,99,27,05040,3
c7f92a4be090d6934e0705c5399fb789,24,16,2,84,24,0,05030,1
abfd27a3233b5197ba64a2868629093e,7,7,1,49,0,7,01012,1
9a47f8cf72f2588c68b9a0f13ccf9912,70,57,3,163.33333333333334,38,32,12570,2
6c45fc0dcd68769a5680a1cb47f8f39b,41,41,1,287,41,0,01026,1
f70971e66450c96a536807cd24f4857b,37,37,1,259,37,0,09090,1
626b2d4bae0a74254554d225a5aa0464,23,23,1,161,23,0,01027,1
10c53333af845d4888beb0fd2ca543e0,175,95,5,245,124,51,11040,4
d02f4de968c8c78a882767363683e658,19,19,1,133,19,0,05030,1
a80fa6a6e34abcf8ff37d707ec1b94ca,71,42,3,165.66666666666669,45,26,07131,2
87cf0dbaf11144f19e568f1f41d8f5aa,20,20,1,140,20,0,05030,1
115ffc749975147b5800e8cc6e861874,61,49,2,213.5,61,0,11100,1
0603bbd25a569950c10cdb3b0c527d56,138,86,5,193.2,116,22,11040,3
dff8637725bd3cbe1bb24425584c2edd,265,128,3,618.3333333333334,265,0,01012,4
a83b0d2941e844372e1118481822ba60,98,85,2,343,50,48,08100,3
6ccc5e61aad563933c5869b960aeedfb,472,151,2,1652,54,418,05100,4
753fdea14b99c25e440abd8dd7961054,20,20,1,140,20,0,01012,1
e1ebfe17f8da0d5c42951d9fe1dd6b0b,169,75,3,394.33333333333337,86,83,05040,3
f4abc69937c2caf88f155a5b1ba6cd4e,64,45,3,149.33333333333334,64,0,05030,2
52c4bd96626119101b9e5e8dfd05b72b,31,23,2,108.5,31,0,13820,1
3de703c566cf682068e1aadcb2d9ca10,196,113,5,274.4,159,37,01012,4
503fe2e8e76fc16b4f303e8a66d3fca4,70,42,2,245,30,40,03070,2
2bfaa1374ef3de99b546b18974fd405f,58,47,2,203,58,0,05040,1
622676fef31a2b98dafce0bff87102bd,41,41,1,287,41,0,11100,1
290f21fad4e331d75f8153fc6222eec5,139,108,2,486.5,32,107,09010,3
fad11911c4986d8cad0b8e14bb693d04,19,19,1,133,19,0,12742,1
f7332ca0ae406769e1a7c8ef72931911,79,64,2,276.5,79,0,09130,2
d0a969c23f889666402f75a8d927b03e,43,43,1,301,43,0,01012,1
5680c671e5ca803fa948ab8bf47cd2fd,5,2,4,8.75,5,0,05030,1
36aafd813b4874ce6d3040adcbfc6871,68,68,1,476,68,0,01027,2
d06dfc75025a670f17577959dc25657d,22,22,1,154,0,22,04032,1
315c1c50107992fe92f8539ec2fd2a92,9,6,1,63,9,0,01085,1
52a24253ebd7f3fa1980ebfa1a99e8cc,10,8,3,23.333333333333336,6,4,01016,1
f119460b5d7e4771769f390e3802bd7b,30,27,2,105,17,13,04020,1
6a45d7914aac1e16c51ab23c793935e1,143,90,4,250.25,143,0,11100,3
6373ae930c450ea4147367452a03339d,40,34,2,140,40,0,09130,1
7607936761f0285965aa0c62e64c999e,2,2,1,14,2,0,10028,1
79f4c4279b4254194228ad17c765d97e,37,37,1,259,37,0,04060,1
db57c3ffa76d7cf828c4db6b44c98d2f,12,12,1,84,12,0,04060,1
d288e60211213c877cce393b4f79867d,67,56,2,234.5,67,0,01027,2
a7dcd7387099f88e46073cca80129f83,27,27,1,189,27,0,01027,1
88726a307e332b847fe92bfba29f435e,47,42,2,164.5,47,0,01026,1
f157794576002953f199a78445fbc0bd,22,22,1,154,22,0,05040,1
4573e9536d67af56d133bf6afa186ca9,106,85,2,371,60,46,05030,3
e834e5d2d0e257bbadbf7edf75a05949,101,76,1,707,0,101,09130,3
abea7fdb6cbe92ecfb909dce82b0de8f,31,31,1,217,31,0,02690,1
f1dcdd2c97d010a56a83c283c1b7d830,166,85,1,1162,166,0,10200,4
2ee3572e7faf2c79e3626b4f1c72798f,45,39,1,315,45,0,08314,1
7462ddf7a346df598a525bcae0afab23,160,105,3,373.33333333333337,160,0,01013,3
d4103c18a96f1af925d158dcf7fdd8a7,44,44,1,308,44,0,01027,1
3e3b17877e8ddb6ca99b67b036f084ab,54,48,2,189,54,0,08100,1
450f5ffaa8daea975418603ea7302f6c,88,68,3,205.33333333333334,88,0,05041,3
79a55bb6db02eb920c0d661b47a5b0ea,121,76,2,423.5,69,52,05040,3
c51f1def486e1e5f17d67c5e9020b0ab,144,94,2,504,144,0,02755,3
2dff7b167b8ae3f6121d032084b5fb4f,25,25,1,175,25,0,05040,1
8030e2cf208cfe55591a05b22e413921,109,82,3,254.33333333333334,41,68,10200,3
740dccb3335305a1f2f6bbd9eef51f00,481,140,3,1122.3333333333335,481,0,10153,4
46bc6ca0d0183f24f2b078ee68000b64,20,20,1,140,0,20,08110,1
76ad8cbd2b8ba1abd8b88cd072a913dc,31,27,2,108.5,13,18,10101,1
f8ea82ccc0e6e1334c6d662e9a16b82f,36,36,1,252,0,36,05100,1
e04a55d42fde3a6c67992978e5353a3e,292,146,1,2044,292,0,05030,4
29dce43cac6d426f4a14d8e17fe9e32b,57,57,1,399,57,0,11100,2
289b97bf7c0fbcf250f2c07703dedc82,107,48,3,249.66666666666669,107,0,01012,3
4152c5f4fb4a03e7e17981c18fbe6b52,21,16,2,73.5,5,16,01085,1
fb540ed34cdbacf828977741313cf3cd,126,82,2,441,126,0,05040,3
1ab99eb7f9fd4fa21eae83a5550dd53a,75,57,2,262.5,3,72,08230,2
5e3b943b6782fe6a2f781b1704e038a9,5,5,1,35,5,0,01028,1
0df81368be5792305b3f4b304a507177,36,36,1,252,36,0,01012,1
2950b1418d4024ea7141522498b412f0,251,95,4,439.25,251,0,10200,4
66af0840d96f99ba7748aea7010b0aa1,292,181,3,681.3333333333334,292,0,09150,4
538cc2f0f66ef2ec4cd45e183ae04968,194,93,3,452.6666666666667,93,101,10200,4
3c9fb2ec5aebbe204487a6c942cbb110,346,86,5,484.4,329,17,05040,4
3eaa71358c78615e15ec3d57df527d1a,247,104,2,864.5,247,0,05040,4
3ab89f7177c82db2061358314cdd0e77,27,27,1,189,0,27,05040,1
3189f80dd8b28e57e69f480839753e76,45,44,2,157.5,45,0,05040,1
c9382115eb5d776db80b83e5de2d914d,42,29,2,147,42,0,01027,1
72fa0e113ada2f3258824b4b92c8d27e,91,80,3,212.33333333333334,91,0,01085,3
a6dcc9c71ee3f0ccbde2a6308698eb17,27,12,5,37.8,27,0,11040,1
49724867c0ec7dba9007ac47f067b256,196,51,2,686,50,146,05040,3
76a66c170f30677b6a1d7e72f4a61d39,37,37,1,259,37,0,01027,1
f853aca75ece2a515e0595bc53c1a9ff,64,49,2,224,42,22,09030,2
8a246112d7a56b9572a0f8ec1aa40668,67,45,2,234.5,67,0,05040,2
a40b693c7a262f3b59bd358c66e0d70e,23,18,1,161,23,0,12501,1
0efb2ae86cde42cc9159d35e228e4678,109,80,3,254.33333333333334,77,32,01012,3
bba0bc5b4f37f363e67934e1a7352b2e,8,5,1,56,8,0,05030,1
65f9a30fa5f35f81f6af1de673adbe3f,27,27,1,189,27,0,09110,1
9c69c8e16ee20d2dcc0119569c3105d7,64,51,3,149.33333333333334,64,0,05100,2
6c9d06fc4b12adec436565e17177d7c3,153,102,2,535.5,123,30,05040,3
7510009b81bdb75066b301ea115ed45c,23,23,1,161,23,0,05100,1
30a42ce834e1b3a16e483dd13ae883f8,39,36,1,273,39,0,01012,1
5e5b46254c360924433686f1c04bf759,48,48,1,336,48,0,05100,1
327d14d116e45e29b87d1cde9c328fc2,259,119,5,362.59999999999997,199,60,01026,4
da98aee74f1e54e83e1ccde9912acdcc,88,61,3,205.33333333333334,88,0,05041,3
02ebf0f66d9eb0741d1206ba2d40941e,49,43,2,171.5,27,22,03070,1
de6de896efff63662ba1b736a24dfc4a,90,51,4,157.5,90,0,04020,3
82dbdf6b9957a865a331055239db20c5,94,55,3,219.33333333333334,65,29,11140,3
ea1de6452608dab833f164352fad8e8c,8,8,1,56,8,0,10140,1
81bdea1c75d5bfae5c1030b9b4fcad6a,69,69,1,483,69,0,09030,2
b210097eeb4650ec810ea00caaae095e,18,18,1,126,18,0,11060,1
c10299444ceecbe73be908018670d960,127,95,2,444.5,79,48,02620,3
00a6153f68d9cb79514bce57e3dce474,16,16,1,112,16,0,11100,1
f4093a621aec447297c03cd60f18422c,32,32,1,224,32,0,01027,1
79f06b5d57db01abe0639f3e34bf3d57,110,83,4,192.5,110,0,09150,3
17be5acc12b0192cc71eff6351a1ae3a,111,66,2,388.5,79,32,10200,3
75d237454eb8ede0a7a5b368c0227d35,11,11,1,77,11,0,08134,1
3be2418ba6c28513c4f3a7017767838f,11,11,1,77,11,0,12590,1
ecdde2cd0fb2ca9456c1091b8d8b15d5,74,64,2,259,74,0,03070,2
674a33745a4a61c4a914a03e42cae60d,5,5,1,35,5,0,11040,1
a5c5ad739a7f5b661b27f9cfd132d4fe,37,29,1,259,37,0,05041,1
44dbbcd4ce01ef3072cfce9740a9e4b6,34,22,2,119,34,0,05040,1
3661d38bb7c8a4658b469c12ed52a7da,103,56,1,721,103,0,12430,3
16906e99678173376e7608126d84ec0e,91,87,2,318.5,91,0,09130,3
404b64ae5a1a6ba72d911270ac960c78,56,51,1,392,56,0,05040,1
5d414f427e6233091f66146d2ada4bd2,111,56,2,388.5,111,0,02690,3
d26afa02cf47e68ee42a32fb69923a8b,164,130,2,574,164,0,05040,3
0d0413b72e77a3fae0febad16d1d0f73,22,22,1,154,22,0,05040,1
d5449084e64eeabc3d2462374760d0f3,26,26,1,182,0,26,05100,1
94db8c6e4bd1d460b4c5c7061a208f3e,32,32,1,224,32,0,01026,1
7c22ab9f520a751938b228e786253cac,83,65,2,290.5,30,53,13830,3
bad2cae2dcf75dfc909b9b0851d0bcc5,57,47,3,133,26,31,05100,2
32980f513e486c0c7417328709f56751,2,2,1,14,2,0,09252,1
b4b80691f1aae251b06574682fa71fd5,125,83,3,291.6666666666667,125,0,03090,3
dd4bc3f99bb89c1283200b31bd199705,63,56,2,220.5,20,43,03050,2
e91f9bd4780c33b15d19df982933376d,172,109,2,602,117,55,05040,3
9796cd4b56e7ec7f2cd2fe9eec319b59,55,55,1,385,0,55,01026,2
8de45edbdcaaf6fabff6efa841c2163d,41,41,1,287,41,0,09130,1
944f2654aeb28a9fe8c4eb0d6c503f05,187,101,3,436.33333333333337,187,0,01027,3
dbd6296c7e10476af0f6ad38fd48cd99,125,84,1,875,0,125,01026,3
716b03837ab875380e60ef180a1af9d7,334,141,3,779.3333333333334,334,0,01026,4
d125bb6abf73b81ca0b0681d00c59c24,60,47,2,210,60,0,05100,1
cb7d32e0f3cecae22dd784551e5bfdda,81,65,2,283.5,81,0,08010,2
f99683d50523cc2797d9887976c81981,127,83,2,444.5,42,85,05040,3
848760645374b823546b4e51ace8d91b,35,31,2,122.5,35,0,05030,1
cc7b11c2d9c4262a8dfcb3a6d1c46e0a,18,18,1,126,18,0,03090,1
b5ad61e5b2c3558a8da4f9386561d189,55,55,1,385,0,55,06120,2
17d6282a31499f46c98746d447dcd59c,466,107,3,1087.3333333333335,466,0,05030,4
5cc35d82015a9d27f573eaacd3b62dd7,172,119,3,401.33333333333337,79,93,10200,4
4d8a0f4741c340307df9f2f6d5197415,117,88,3,273,85,32,05040,3
08b8c9450a2a336b25e0199d75de4870,22,22,1,154,22,0,05100,1
c362c3ba46ffdeff82cda3df9246235e,58,58,1,406,58,0,05040,2
6c7caadde3b02ebe2c8cfc7075af1085,54,48,2,189,54,0,01027,1
b4b7a55848c109192acbf18a73601352,231,69,5,323.4,210,21,03033,4
b31b6ed181777529de1a5ebfa0013b08,89,67,2,311.5,89,0,05040,3
56df1558924cf8b505c1522fd3bc3b5b,49,43,2,171.5,49,0,05040,1
f73e39b8acd5a1dd941f93eee0bda47e,48,48,1,336,48,0,12500,1
c6ddff839afebbc44e8d4ff81befdb99,53,50,3,123.66666666666667,53,0,01016,2
045fa4cf4f580b89321de79c70c58644,96,63,2,336,96,0,04060,3
31e6493a0528a9e46b49810230fa94bc,172,68,4,301,139,33,05040,3
95266abb7f0f87900f1d4f999462f0a4,47,47,1,329,47,0,01027,1
0f3cec6187a4fe9c5c08fd62f298c078,75,65,2,262.5,75,0,14301,2
adbbcf56e0621e3b5a07e93d84da948e,28,28,1,196,28,0,03050,1
486b0b431562a6b1f8b5286cd02b8a55,35,35,1,245,35,0,05100,1
e4f8257072073584d6cd7c7381ea35e9,168,126,3,392,101,67,05040,4
8078f8ad635d772a269c33d866d0d377,34,34,1,238,0,34,01027,1
01e201c147ba4a58df19468036e2048f,62,48,4,108.5,62,0,01085,2
afd1bc8443cb3d351bfc10b101a6ad2c,22,22,1,154,22,0,11100,1
3b47a380ecb05e3584020d9248577bb6,74,57,3,172.66666666666669,46,28,05040,2
180995b58d8983e0a4f7249882634360,185,72,3,431.6666666666667,185,0,05040,3
5d49c85085fa0b61ee5beaf38533e17f,238,106,4,416.5,238,0,02650,4
e491359a11b146681c65ee70c9566522,25,25,1,175,0,25,04020,1
eaf85bb21023b4e895438f4fa7e34695,30,30,1,210,30,0,01012,1
430505442ed411c7ca06d9164a0d77fc,32,23,1,224,32,0,11080,1
e9d7ba59d618b89a61c52c2994c3b02c,112,86,3,261.33333333333337,65,47,10200,3
4f9b15dea1739dcc554b793dddea4f68,149,92,4,260.75,149,0,05040,3
194c6230f41375c9c74214fd7fae844e,330,187,6,385,294,36,05040,4
5110007cfd5238fbf50c1c09e2602ae2,18,18,1,126,0,18,01085,1
113742310d54dc96e0d0b138790ad8de,192,92,4,336,192,0,10200,3
8e9210490403230bdfb90f165f710acd,51,41,3,119,28,23,01012,1
e5b23e40f176e142d7be885f21b358ec,80,80,1,560,80,0,09130,3
83551e44dfd8dec4f9ebb929afb614f0,115,60,4,201.25,89,26,05040,3
1b09b4fc9dd42d5a40d2b43cb77fbde9,216,117,4,378,106,110,05040,4
0651c4d6c461456e69f0499710390488,94,76,2,329,42,52,01026,3
b97be59b2726dfc5295c9841c8e820cd,14,14,1,98,14,0,01085,1
acefc068174a0c8d5aad4909738b60df,80,58,2,280,80,0,01027,2
2daabaa668de64d09844b2a0488b7db6,244,113,4,427,199,45,04201,4
ecf92a776d53b06a94c266c8e987369f,135,107,3,315,135,0,05040,3
221383b253a7b59971d5e7777f8d2289,10,10,1,70,10,0,08010,1
10a10c957c447003b27095f86edd3075,107,81,1,749,107,0,05100,3
f15d103dc6d8d604285a032c1a2dfab3,26,26,1,182,26,0,01085,1
0f6050fb886066b80c79d9e548d9ebd9,123,75,3,287,123,0,05100,3
450fd9103319de935f299649128831f3,84,43,2,294,84,0,05041,2
15c62aac0e64eab4a73b975f5a6481d9,38,38,1,266,38,0,04201,1
b4466c982d2d08a2ac724bd92749d9b7,196,124,3,457.33333333333337,83,113,10200,4
e284343fac0436d4ed4a064eb7949864,86,62,3,200.66666666666669,86,0,01026,3
4d428e857e75ceb4bda7e9b6ce32b9fd,21,21,1,147,21,0,01013,1
596b167db2865bd2ea3974afd492c80e,150,86,3,350,150,0,01085,3
2c74e3509a7fd463ca086b48488fd065,9,9,1,63,9,0,12590,1
d98181216d70a9c92b89457707139005,35,35,1,245,0,35,11080,1
9df835705546df054f3ee05eb20e916e,137,97,4,239.75,102,35,05040,3
c714f8df0dfcaf4501ad1f56c781f0e6,44,35,2,154,44,0,01012,1
793eba89b8769a17426920fc321c5d15,20,20,1,140,20,0,04130,1
c45e0869f3bdbda2b1c26ba5cb78507a,36,36,1,252,36,0,01026,1
cc77f16197554a01c8a2a23b1fc34d6c,34,34,1,238,34,0,01013,1
929bc40a65f5783a08bb61f8f4b03e88,47,38,1,329,0,47,04020,1
f28dcc0f4fb4404c7fa0fd39cf6d6cfb,78,54,3,182,78,0,12650,2
5e43dd7498f9eb643641d522da2ce829,35,35,1,245,35,0,05100,1
576854458a128482813bede19303a196,64,49,2,224,64,0,10040,2
2b1b1644da8ec7b7f86f80a4e35d4a94,5,5,1,35,5,0,11040,1
7d4912ebd8f78a091aeaaa3fb1ef8db1,40,36,2,140,40,0,05040,1
de5cde37da3234e174ed2c5a938b8828,116,77,2,406,116,0,05040,3
47fe4894bab840391a1fca9c143dfda6,11,11,1,77,0,11,12590,1
221fb813bd197648d0b0a1a15bd9d9ca,25,25,1,175,0,25,12570,1
85c435d4e2fe7e960f26a5b473784f25,55,43,2,192.5,34,21,01026,1
66cea9917f558e0d7a4c72ab5cac4f3f,31,26,2,108.5,31,0,05100,1
4656246df7aec3b1e5240e4b4a84eb64,24,24,1,168,24,0,05040,1
ebe237907d2a8902c0baa287eb81546a,21,21,1,147,0,21,10200,1
27a0461b1f17792c165adef3771aff30,39,39,1,273,39,0,01026,1
00481cf3e91879592a2b8c57eee4f7db,113,84,2,395.5,113,0,01027,3
1c83f10488e2ee8161ce233adf0d7624,46,46,1,322,46,0,10240,1
553ed5285fe52b7ef5276e1ad261938f,14,14,1,98,14,0,09010,1
be568e18cf1cdc54775f9731a9146da8,37,32,1,259,0,37,08314,1
5e402566498b8f276faee25f3de62daa,55,50,1,385,55,0,01201,1
7606aafa0dd3f521e348961a6cfb8cfd,67,51,2,234.5,67,0,14301,2
5891919cc13f2bfb6fb5bf70452ac338,235,98,4,411.25,235,0,05040,4
3d46527b0559419c454a2d9481aec595,166,112,2,581,166,0,10200,3
d1adaf48dd7a113afbe8107fb3bc75a8,83,63,2,290.5,83,0,05100,2
3234a035c06ea234ec91315c40aa2a26,170,89,2,595,116,54,05040,3
7b12fb3b40bd15a8081ab878f8fe5a4b,71,54,3,165.66666666666669,43,28,05100,2
be54501c3656fe1111d61ddaa4cb6ba3,92,58,4,161,37,55,01013,3
b8e8934f807c1148493e24cb4a10af1d,62,50,2,217,30,32,05041,2
93d2656efb5d477c0a337fa4d890543c,93,77,3,217,56,37,13490,3
6df3d21ba1025f61c8f7b23e6a784363,33,28,2,115.5,16,17,05040,1
fc0f08f2009fa25d804a69a3c60e4480,132,60,4,231,121,11,08010,3
559fd07048fc12f47c498098d4030547,9,9,1,63,0,9,05040,1
5a58b8ea4e7d21ff718e884b4a95e55c,59,52,3,137.66666666666669,59,0,01012,2
91c928c029af295bb2482e0ce3233469,29,29,1,203,0,29,08230,1
0a9896023748b4fbdf58a84d9709f275,193,141,1,1351,0,193,01026,4
7278bf7798b1710fd360de270708fbb5,54,54,1,378,54,0,05040,1
79ad96732796d9dc3fb39581816ac7d7,57,57,1,399,57,0,01026,2
1824cd55d719fee57155806269dfecf0,91,35,5,127.39999999999999,81,10,05030,3
05ec68b311334d5a49586130664f1227,37,37,1,259,37,0,01026,1
7fc26109ec5c1013187d4c39e674d20e,28,16,3,65.33333333333334,28,0,11140,1
56c340421b986f3191015ffd1f65d5ad,4,4,1,28,4,0,11180,1
59ef87f5e5b6bb23a1653ec7e016b6b0,5,3,2,17.5,5,0,11040,1
0fe25cf7296e47fd2a2c8b3bb8c9b3cc,332,135,4,581,332,0,05040,4
4c981b471b11095c4d3ef4b7519136b0,18,18,1,126,18,0,01012,1
7dc2f24c93b51c40c037aa78dd9116e3,304,122,3,709.3333333333334,304,0,01012,4
13e3a34171113d841e766728e13a83c6,53,30,3,123.66666666666667,53,0,05030,1
ce0349d444e813e6a2fc604469a790a5,123,87,2,430.5,123,0,09130,3
0c6a3ab9fa5e52981b2959a7258b2cad,60,47,2,210,60,0,05030,1
0250f4735c38f879d1cf30ecb1fb853a,248,116,2,868,248,0,10220,4
843ca321031e6426ee500d4ebf9d4f10,11,7,2,38.5,11,0,05030,1
87a1382fdc2f5e9bf45226c72103ee99,81,78,2,283.5,81,0,05040,3
366941e290b64c98fe48ab4a97620b0b,148,85,4,259,148,0,08032,3
bbddcbdec0b89534a9eaa36197e120a1,281,108,5,393.4,227,54,01026,4
89d5c134abc836b57caa5652127a51af,139,99,2,486.5,139,0,10200,3
b4500758f8cae1ea0dd4a780f0633bb5,388,150,4,679,325,63,05100,4
55ef66624174101d2eae1079a58838c3,34,34,1,238,34,0,03090,1
5f2b13ac631bf2eb0849bfe6d869ec11,104,80,2,364,104,0,01012,3
01f2bc4014030805aab677e5a05b43d2,99,72,1,693,99,0,01026,3
b4e01633fba09caeb536cd01fb219f37,427,177,6,498.1666666666667,374,53,01013,4
112b9fdaf4f78d8afb26434eeb93baa8,65,53,1,455,65,0,12570,2
17cec0dbc026f097b8fa3ad412d81857,36,33,2,126,36,0,05040,1
a20dd40275d33fdc866a0942dd74e83d,49,48,2,171.5,16,33,08032,1
f008a7db55d9ca75f768ad2d363ed31f,68,53,2,238,68,0,01027,2
643da281ffe0eee176c642f0a44058f0,198,125,2,693,198,0,01026,4
707675e76a04b2fe5990483aea798233,54,54,1,378,54,0,09130,1
fde877ba6b4ec5ebb99a55f4a1929da2,151,73,2,528.5,151,0,10200,3
be81eb94f4a9cdd2785fc1a6472aeee5,25,18,2,87.5,15,10,11060,1
b4db34b2eef6e48af038f23e8eb54ad9,129,80,3,301,129,0,01085,3
dcda7c8015976b7b698b8d34e54af6d7,62,48,3,144.66666666666669,38,24,04080,2
1653fe3804d942d05b8f6768d1d0dd1b,307,116,1,2149,307,0,01012,4
dfe07d2434785f90b7d8ec7194863828,18,18,1,126,18,0,05030,1
a49a8854aac8692061860db353954415,56,42,1,392,56,0,05040,1
6ac2d2b5f3006c4dd379b15ccdaf3aa5,30,30,1,210,0,30,05040,1
b89e26fe6f2759288e949efb220a4207,37,29,2,129.5,37,0,05030,1
cfe57a2b51b4b0e659dbfb1cee92e3af,41,34,1,287,0,41,10200,1
1ccd58235be23ab12fd408d31dd6bfde,128,92,3,298.6666666666667,128,0,05030,3
ef33bfe23c3595357e25b6162414dc17,7,7,1,49,7,0,10200,1
0f6423bf59975f17d45c2c3c879881a3,42,38,1,294,42,0,09150,1
86a4b056005c0a5edbf8b3dfa7521974,229,120,4,400.75,145,84,05040,4
7948815436db78040bcbee79a0ebd28f,37,34,2,129.5,37,0,05040,1
2f73417395a9dc9dbd4a4c7342089161,391,184,3,912.3333333333334,391,0,01013,4
dc343c02f90293416825fcbccfa6031f,144,72,2,504,144,0,05040,3
7270c5c0bba2dc534fe8e67f7c0a3b5a,167,107,3,389.6666666666667,135,32,01026,3
c01bc3778d0672c78c3abe53b50bda40,116,78,4,203,116,0,01026,3
d0eb73d77c3a30d0145d6a628d1fb9fb,85,69,2,297.5,85,0,08010,3
7b1d01e72a49b65b7167a809c51168cc,18,17,2,63,18,0,10080,1
df537758b3a520d9e21bd6130f7d56e7,16,16,1,112,16,0,01012,1
52dd50f738fafe5c239bfe3ad4854162,30,30,1,210,30,0,05040,1
289bd440bcbc857b9564d97703de6825,128,70,2,448,128,0,02751,3
382d575f274e74eb693bd423abd01b49,79,61,2,276.5,79,0,10153,2
971afffefd8e8e235fde049b80a05a61,80,53,3,186.66666666666669,80,0,01026,2
ea165114968b0dec7103ee0044d931e5,95,67,2,332.5,95,0,11080,3
a071d72bbeb303ecaeffe838a1450532,25,25,1,175,0,25,01027,1
ab94962b78fc4f9775b91eeae68e77dc,87,73,3,203,87,0,02690,3
a2d3c869d5edb3f1ce8fd2448a4f7761,37,20,3,86.33333333333334,37,0,10200,1
c8013766326b4a34d7637cc92d0c8d54,21,21,1,147,21,0,09130,1
0edf80f75a60dbfac8124642a346bc4f,203,95,3,473.6666666666667,203,0,05041,4
02ea81b5494822b25cf29aeff142026a,21,21,1,147,21,0,13830,1
462439eda486f5eb2b0eaef01eeaf194,124,93,2,434,124,0,09130,3
283ac5b7eb283d3d8abb4ee35fa9b982,195,88,5,273,163,32,01026,4
f8d093f4cd17f9724f9e71da27c4d2a7,37,34,2,129.5,37,0,05030,1
c0779bb4dc5f23eb1a66f45f8b113436,27,27,1,189,27,0,05100,1
c5d584f786c216c2afef8b09b7462ca9,198,94,4,346.5,198,0,05100,4
686ec1fe35dd78712d4ff4038a05a904,169,95,3,394.33333333333337,55,114,11100,3
7aa2d5b29a20948be2ccdc7d6e3e7c8b,41,41,1,287,41,0,04020,1
11861e72c514a87e82b8e3265e536b44,68,48,2,238,68,0,05030,2
371bb937e9b840f154df0bc33dc7478f,61,61,1,427,0,61,05030,2
d7b5513d5a4f2588a7e3ad4faccf45e8,39,39,1,273,39,0,08133,1
43e6d19e9c0432c81caeec0adb9015d1,95,63,3,221.66666666666669,58,37,01026,3
de3c83adcb20875505e847bfa2783e6c,95,60,3,221.66666666666669,59,36,09090,3
0a3a291ba972877da39421323930c0cc,7,4,3,16.333333333333336,5,2,11181,1
51acce1c3d11c516a3a079db31feee44,67,59,2,234.5,30,37,03050,2
5061f20087ab9aebb8d64d781b154662,76,67,2,266,27,49,09010,2
002f3f0359dbd99e883f347f1fe13e85,58,57,2,203,58,0,01027,2
ab705081cf672991b08c42a5cdc27522,2,2,1,14,2,0,09010,1
2bd61708f9b943bf390ac08638b15cc9,9,9,1,63,9,0,01012,1
7cb875d5bba49966d3812f1789773894,61,40,3,142.33333333333334,61,0,05030,2
f69de164b2346ba8d295dbfd67638cf5,188,111,5,263.2,130,58,05040,4
124752e617e46865ab16eb99b3f4ecda,70,49,2,245,70,0,05040,2
a98dc2c93f3f9616aaf5165a70954ef0,18,18,1,126,18,0,08390,1
317fb43b3a6660f05d47feaf275f51c7,19,19,1,133,19,0,03090,1
28203ed2466f46f1c5fa336ea5fb7fbe,70,48,2,245,34,36,01012,2
f4d27df7715f7c3e4b11411e954f753d,238,103,2,833,238,0,05040,4
cdf976e79714faa014f147eeb3a7c08d,6,3,2,21,6,0,11040,1
e5a695383c25886769d0fd5f78315fd4,63,32,3,147,63,0,05040,1
5df3816ee88954424ef9437dba74c21d,40,33,2,140,40,0,08231,1
e795da49628650b3a85fa8d6da0d7818,106,78,2,371,106,0,01026,3
ab648a08c60e828cc2f2c0175e9b75b7,12,12,1,84,12,0,05040,1
649ebd84081b1e52ce1e1a4f17eefca8,56,34,2,196,56,0,05100,1
c8704a8fab795837869651e0239fb97f,18,18,1,126,18,0,05030,1
7ff5d6bc5df6755d4519f3477fbd0cc8,209,104,2,731.5,175,34,01085,4
05b97eca9aaf7c81f03b971dc801f2e3,152,97,2,532,152,0,09130,3
d1688660f64e501e19779eb8e7e93a3e,47,40,2,164.5,47,0,01012,1
908e40d04ffde8ede2714daa0c00bb98,213,123,2,745.5,153,60,04020,4
d2624bb8c57830fabc1a008312d2aaf7,220,115,5,308,220,0,05100,4
4d97989111a16fdf5a526fcc2cce6ab7,47,47,1,329,47,0,01013,1
361550ba357877271578ee95efd29b0f,19,19,1,133,0,19,01200,1
2c3265382de15bf40d320b73bead3c12,42,40,2,147,42,0,01085,1
f886d61f501ff8f3db1781d5e4f697a1,42,35,2,147,17,25,01012,1
b610b44fb4629221527fc03194d3615f,13,13,1,91,13,0,05040,1
22b52e31650f72f64a430dfe2fd4b4f0,422,191,5,590.8,189,233,01012,4
d8b08653333d0f141604aef36d80c3b3,24,14,2,84,24,0,11040,1
3ec5bf8427fe4bae6f845f2c387d64da,248,87,6,289.33333333333337,234,14,01012,4
9bd2a8b46826221390fce63f5a66ef48,64,42,2,224,64,0,03033,1
54c79c302c8184de966ee8ad1be39f22,22,22,1,154,22,0,01013,1
b62bc6e473c609177ab041a13055cda3,15,15,1,105,15,0,08010,1
277b4890429a3e0f16de5abb5e559966,195,121,2,682.5,195,0,05100,4
037f565c2017196f99162c09abb88822,139,108,2,486.5,139,0,08031,3
f7eda7a46ac023fe22b8133f871da228,30,30,1,210,30,0,01012,1
498145137e2ab913de1f7318d9b3b432,10,4,3,23.333333333333336,10,0,05030,1
b849f288c40e1a89edb8906dced317cf,44,38,2,154,44,0,08314,1
c0a546c6135f2f05ba2442b3f6d401ca,10,10,1,70,10,0,02754,1
1617c8a8c9d845dbfc8ddff855efd2e3,450,126,5,630,352,98,01012,4
a897aee0b6332ff8f911c08c53a92033,133,54,4,232.75,89,44,05030,3
e590962eb2ca927f1d1a04d63b39908f,47,47,1,329,47,0,11181,1
3010e3dac6a028f8a089d1ef7fcb78f3,21,21,1,147,21,0,01013,1
29e579ad69f8ae224ac2f4938af0a206,12,12,1,84,12,0,02650,1
2cecbeb0fc5c0af0ca447e2dc774a0f2,23,23,1,161,23,0,08452,1
0ce853ea35e55161b49d8c25213eeb9f,33,33,1,231,33,0,01012,1
c6e75d64b3f1a6ee8fc390ccff2501d0,281,111,4,491.75,205,76,05040,4
758664d92fe26d71ed15385b00bd5458,30,30,1,210,30,0,11100,1
4f6ca107f6a36a018dd1074a6f6b3c67,18,18,1,126,18,0,09150,1
41e985ec79abf19aa0ad27e9bb46ff44,346,127,4,605.5,86,260,04020,4
113bf629f3a7d2d2582ab98f8ee87e40,28,28,1,196,28,0,01085,1
c5b07b675a27938a8b93b094dcecd555,35,35,1,245,35,0,01012,1
6faf9d77bd21b1bab9756ae8adb2bc0b,39,39,1,273,0,39,01012,1
2428bdc4d370eb5e0f40e596f6105b4f,39,39,1,273,39,0,09021,1
8d326da8319257f7a82a901d38136d71,23,23,1,161,23,0,05100,1
b130d092fe1c05d1918c43373281c987,24,24,1,168,24,0,05030,1
e635dd1bbb0fb6119e8a52f3381d0b2e,97,69,2,339.5,97,0,01012,3
ffa7bbd9f036dd10bc023f0477c8a80b,37,27,2,129.5,37,0,11040,1
39a36118d44ba285c2ad55d84d9d13b5,116,73,3,270.6666666666667,116,0,09130,3
c54b82d0ff84bc615d63b3e5ab82d651,70,47,1,490,70,0,03070,2
700697f25bd9ee4fa7db858179531be0,34,33,2,119,1,33,01026,1
4c91d5f0183bcb0251ba1bcd3b9b6294,41,41,1,287,41,0,03070,1
4e103afac3cfb94f802b059d6e595d99,132,65,4,231,92,40,05041,3
e0f515d79c06313c656020dbe96106bd,47,32,2,164.5,47,0,05040,1
bfb79ffc553f4fa0f6e6eccae4095f73,77,66,2,269.5,36,41,01026,2
5adede88a70a0460d9361b295f77938e,34,34,1,238,34,0,05040,1
a0dad92acbe57aa6e282c1c9930aece1,75,75,1,525,75,0,10240,3
52d8f785dbaef1305a6fd7e786c61ef2,97,77,1,679,97,0,12500,3
57ace0dfa5bb1ff6e6b8b9996fac40e9,31,31,1,217,0,31,01012,1
b73ce4b193172675acc5eaa6d0fc4adf,69,47,2,241.5,69,0,10200,2
d1d50123bad70e727c33cca90bec4536,34,32,2,119,34,0,02691,1
257a3707bc23b2a94318172d9eebf35d,15,15,1,105,15,0,04020,1
8c634d62776a621c2d33cb13c9ce38f9,48,48,1,336,48,0,05040,1
f8b9206847db9f1ab3c84401d95363b7,35,35,1,245,0,35,06100,1
f8528a25b5ce816e50890dcf679726cc,39,28,1,273,39,0,08090,1
fa81198d45f976210520262da035784d,15,9,2,52.5,15,0,11040,1
b21e9a60659e8e8d3bbc433acf205899,31,31,1,217,31,0,03090,1
ae7830c0f7393b4f04ad9514828e47ca,31,31,1,217,31,0,10200,1
71ff4bbf4f4627315cfa0da51585c51d,91,39,4,159.25,91,0,05030,3
59ddc4e778db5808d7192daec830b602,67,55,2,234.5,67,0,01026,2
920bf8e2074065e22b8835670852f934,274,111,2,959,274,0,01012,4
b58d62d17c9b8717554502e46f7e2881,69,61,2,241.5,69,0,01027,2
5a2ea9cd78f933ee899750b046e63704,137,90,4,239.75,137,0,01026,3
fe2ca727109fb85d6ff322496f41372c,53,36,2,185.5,53,0,03050,1
2ded20059c8fae5f0e511a7f7ef2f7f5,50,41,3,116.66666666666667,31,19,01013,1
eeae95cf38373217e241179f8e4f39c5,387,109,2,1354.5,148,239,01027,4
0c54125a6bec6e79f526e5b8574286a1,25,25,1,175,25,0,01026,1
a1290d46059e29c5c22fe8e989b80a54,35,35,1,245,35,0,02751,1
ed479a0327b1b34b513ac0500e8700be,102,60,2,357,102,0,10153,3
b429952e19dd0c7c5f4dd7bfbd3a6919,29,29,1,203,29,0,09130,1
d71d12a00fdcf3bd055ba5eb6ee944ee,22,22,1,154,22,0,09130,1
038753ff139f4c79545745f213f0422b,21,21,1,147,0,21,01027,1
ffdd73c54876e1abb98150e94d45c00c,84,56,3,196,63,21,05040,3
5573a951c4b752dda155ab72bb1cacd0,63,48,2,220.5,63,0,10200,2
e0a2c8a0ce3eb0e615bb14f253ba6048,10,10,1,70,10,0,11140,1
3950de5202607c12f2baf569f793264f,117,83,2,409.5,117,0,01026,3
162486a6ad1e1ca3df345fb5b9f50c78,187,125,4,327.25,118,69,10200,4
7019114053b66836a6ee80e951c13b20,22,22,1,154,22,0,01201,1
012326d08825a9239ee48016a7fd5d2a,113,89,3,263.6666666666667,113,0,01026,3
c26d699fc68519276dd89d32679ff69d,193,105,3,450.33333333333337,193,0,05030,4
5e8ecb6403609662020220ee2964bc81,277,126,2,969.5,277,0,01013,4
503fedf6534a946441f525c8c817943e,35,32,1,245,35,0,09150,1
1db9850699ff733a5902aa8efd3f9b7b,58,47,2,203,58,0,05030,1
b1ee1789def955c56f9b2894df4299ab,22,21,2,77,22,0,01201,1
336e0e66ce49adce41c2e6c2f181af22,65,41,2,227.5,65,0,11080,1
7e9d8e5a5fe51caef95ca6a1b81e4df6,215,118,5,301,137,78,01027,4
8f5af3ba3e8f438fa1b87e294619bf62,121,74,2,423.5,40,81,13600,3
de6bb96e9b2888b97147073423853015,22,22,1,154,22,0,01201,1
6a982c274cc0f845cac95df5087037af,27,15,2,94.5,27,0,10200,1
ee3dd279d7493b30f966fffa780c9221,47,45,2,164.5,20,27,08230,1
72a237b00b9f3474130fb5d25b3bbaa0,25,25,1,175,25,0,01085,1
1ca509aa151c28dfcca2e83033fda1dc,25,25,1,175,25,0,08230,1
3cf322be1c1aa0af7be3a2faa0415c5e,103,90,1,721,103,0,05040,3
94aadf8415f9134671c182f7cffecb87,15,15,1,105,15,0,02650,1
32c93b60245453e1308f9c972093aeba,355,141,3,828.3333333333334,281,74,05040,4
3d0cd3e44bf60b24eb085090c56cd97f,76,55,2,266,76,0,01027,2
f5a8ebb87e4140854ccb10c92799082a,364,134,2,1274,364,0,01012,4
dbe33710a956f08374f4cf9f6813860a,32,32,1,224,32,0,01012,1
adac7bf6a5c44c0389237218bb7515f9,183,100,3,427,183,0,05040,3
c2e30a0c61be2b118cc59f0338d3fcac,18,18,1,126,18,0,12500,1
0fb5dfbf376b3a5b936f02380af2ff03,104,70,5,145.6,68,36,01026,3
011b2769b1fb71e46ec895d59f4ea7df,50,50,1,350,50,0,02650,1
89a384785b693ad95ee7aa041598b950,19,15,3,44.333333333333336,19,0,10181,1
56bb744989560446238971a01218854c,3,3,1,21,3,0,01017,1
03ea64dd39fac59d256f493e0533cfa4,182,110,3,424.6666666666667,182,0,10200,3
ce60f019dd71aa8d6e11378453689bb8,71,58,1,497,71,0,01012,2
c16d6d64c5a02a175998d00c7ff1c2aa,56,44,2,196,56,0,01085,1
a8344dba2775bdf963fe9010dfa28757,59,45,2,206.5,59,0,05040,1
0df9face69551e11cdff51c118813bdf,22,19,1,154,22,0,12430,1
8f9567a2452c36da991e88c07b69a078,69,55,2,241.5,30,39,01201,2
80422dbc582b7f3ec4b08b129f9315d5,119,70,2,416.5,119,0,05040,3
4b6937382ddfa38de1543759d5fde1f8,226,146,3,527.3333333333334,139,87,05040,4
160c8e8803cf32cae79858fb141dda3e,60,46,2,210,60,0,05030,1
9e34e1d32e6d2ecfaec70f13bc1001ab,17,17,1,119,17,0,10153,1
bb5be2cf476aaa1bb8addff8fd46b925,25,25,1,175,25,0,03070,1
9f49ff1719189865e529080309db9809,23,23,1,161,23,0,09030,1
2b7868d1abf1acb9eecb4a1581a5fd57,3,3,1,21,3,0,11080,1
4bbfdc58eba52d4f3faa90890e8fee94,124,65,4,217,124,0,05100,3
6972928f574c61184117cce3b90a2999,238,127,2,833,238,0,05040,4
243f70a8bc70090761b6fbbc96cb54f2,20,20,1,140,20,0,01014,1
b13afc8d6e8723ba9a4a152a82a6a1af,125,100,2,437.5,125,0,08032,3
67ec3d725baba3f7c7728dea3b41e07b,91,74,2,318.5,51,40,11100,3
13be1a2891281b726882bb871a6cf662,40,40,1,280,40,0,08100,1
8953d0df3d514f51b17e6ee16698167c,42,42,1,294,42,0,10220,1
92ffda5e74db38fc5a14f053f17c47fb,97,67,2,339.5,97,0,08150,3
034a64bf3bc49ecadb41730e2303c0e1,379,155,4,663.25,319,60,11040,4
cd73bdef09167abbdfa56def3063ad0b,37,37,1,259,37,0,10200,1
21b044344a49780e53125ee4d13e87e3,17,17,1,119,17,0,10080,1
af274d808ed839a3419785d082add541,78,78,1,546,78,0,01026,3
bd7e9cda169ecb7c04a6873a9c1a8ca4,36,36,1,252,36,0,04020,1
bb3aa53404adfb39405b47e0a3f081a9,47,39,1,329,47,0,05100,1
742123e8d2e2295b50509223d495a0fd,405,110,2,1417.5,2,403,03050,4
66aeb415206a777d0eb2b5215b729e55,25,25,1,175,0,25,04130,1
3d6961167705336e49aca6efe139e96d,275,105,4,481.25,213,62,01027,4
627dd2cc501fa44b35382721efb1f873,129,65,2,451.5,96,33,08052,3
9d0d7aaf8020ad3c8d66faccd25fb522,10,10,1,70,10,0,01013,1
b603e7a4fd0578ad8e85412b01485ee7,1,1,1,7,1,0,12670,1
da1801f043daeee41b460ca7b3f3d6e1,1,1,1,7,1,0,10080,1
26e1935a33cd13981da539f5447e9dea,324,154,3,756,324,0,11100,4
2d1761dba3a70d2fc7c990e0b1762cf0,36,36,1,252,36,0,08230,1
d3031528399248f92357a37d90ffa31a,308,116,1,2156,0,308,05030,4
26deb0b895708eeb2c3c6c22906ce8f2,65,56,1,455,65,0,01085,2
4e13c4aeeef4bb47c5306bb9be8ac03a,101,42,4,176.75,75,26,05030,3
af7acde905b775cb99173c53f6820a56,30,30,1,210,30,0,03070,1
4f240cd90bba9b72e9b15c307bb16e0b,4,4,1,28,4,0,01013,1
342d55be766c61ca9876962ea71405df,37,37,1,259,37,0,05100,1
9254d5f0fd0905deff9507888cbaed58,48,48,1,336,0,48,01026,1
c6ce014c3a58875c6a6904b226fe3200,132,83,3,308,65,67,01026,3
00f169451bea188e1b5fc2c06734a542,82,50,2,287,82,0,11080,2
e4cf62740c2259992cac9846299d40a5,35,35,1,245,0,35,01012,1
f2455ae72b6f966e3d2eef0116483781,41,40,2,143.5,41,0,01012,1
6b91011c07b699cffdc02c5253bd6ec9,5,5,1,35,5,0,05030,1
ed4d7785b6edad5ecd0c189eca4b35ac,84,63,2,294,39,45,10200,2
1266d7fbb60001e1655a705fe90d9e00,206,98,3,480.6666666666667,206,0,05040,4
b8ef2391062fe7b53036be7e591341e5,19,19,1,133,19,0,01012,1
3cc492110e32594d4f522df8224d18dc,82,70,1,574,82,0,04020,3
322eb75d1cd7c66f50236cbb1563876c,37,37,1,259,0,37,08010,1
2e9b2b25de8ce81a6071eb4cc21220c5,47,17,4,82.25,47,0,05030,1
6959d2c6331d7a92101f6815cf78acca,82,53,3,191.33333333333334,47,35,05030,2
d7bf92f4c8e77a871494ad7ddbfe42f8,43,43,1,301,43,0,10200,1
16a7c5a49c8e1116b10699edf2b6051d,38,37,2,133,1,37,11100,1
133dfbd71f0531529cd5cef0a7625567,104,70,2,364,40,64,03050,3
cff4a575a9c64ea1ea03ec6518a8a3ef,64,55,2,224,64,0,05040,2
609d60c334c21edc9fe5d19c75ca9a5b,17,17,1,119,17,0,01012,1
4456f91208f6a8d36ab08f331d409820,41,41,1,287,41,0,02620,1
e1959478dfb7938a2063a2bb432ccfb4,33,33,1,231,0,33,10200,1
9c2d7d5eecdff7aa51f7b25038f97e6e,190,109,4,332.5,190,0,01012,4
10f662dab57d28de894483016e476e06,11,11,1,77,11,0,03070,1
f6d99098c32ff633a589cb4cf21f066a,79,43,3,184.33333333333334,79,0,05040,2
22d426278ca4672c2a07b28cf83a244d,335,93,4,586.25,335,0,04020,4
bb716b916eb2a260a809157b32147f78,60,41,2,210,9,51,11040,1
2740755219cc4dc0f30017737dd775c2,22,22,1,154,22,0,01026,1
a0929991b6989e0c5d5c8a86cd472eca,111,51,3,259,111,0,01026,3
6436151a83f9c2d56cea3b5345a69e74,58,37,3,135.33333333333334,33,25,05100,2
a926fe728d993d6e6a3c7b049762d6bb,35,31,1,245,35,0,09010,1
d01176d3d2dd84000b110c9eb95acbfb,15,15,1,105,15,0,09010,1
4df5899c21e305b5843c7cb7c524abda,105,81,4,183.75,92,13,02650,3
700d3730fd11ba73a5c935b784ff1e7e,467,168,3,1089.6666666666667,313,154,05040,4
d9dd06b6e555729fbfdef8b8bfec7cfd,50,50,1,350,0,50,01013,1
65655ce9d19d9079196fc8532e1a7143,192,100,2,672,192,0,03070,4
7d08f0e2a42426f014ed1741a91b87be,34,19,2,119,34,0,01013,1
7306da803e53aa0016eda2db7f34debf,79,72,2,276.5,79,0,05040,2
65a585749559b81869eb021ad27000c6,229,135,5,320.59999999999997,185,44,05040,4
ee8958a188244836479994328b779596,84,71,2,294,84,0,10200,3
2e76baeae1f84354a6634c8c0a3bae93,165,119,2,577.5,109,56,03050,3
b02b5df7254dd3e21e71a013a90f3dcb,16,16,1,112,0,16,08313,1
ffd9915d58cf5a464405df0c6a5a82df,85,57,3,198.33333333333334,85,0,11080,3
67d70ee53cdeb9f3d366f75de48e67f6,65,65,1,455,65,0,05040,2
a49a9b29cf53a15679b86e869fe6f339,40,31,3,93.33333333333334,40,0,11080,1
f73504f112d2d31b874595f066a47514,140,99,4,245,108,32,05040,3
9892aecf6047c34ddb624c3f6bc0c76f,39,39,1,273,39,0,05040,1
710ec92d9ddd73954993d64f4333ee4e,24,24,1,168,0,24,05040,1
0430c4f4605f71e8578cc9b1e34a209a,113,31,1,791,113,0,11040,3
456ac9ecb033af009e5d36ad3bad7b93,16,16,1,112,16,0,07131,1
2b17ef6eb80d9c81b4f1e2cecfdae983,60,47,2,210,37,23,08032,1
26455754f1d1a00838cc3443699f4b5a,35,35,1,245,35,0,11140,1
37983ee3dcff7f7db0b4fa4113c03d63,110,65,4,192.5,110,0,11100,3
81f8599656fc580c835f6192f43036d7,145,84,2,507.5,145,0,05040,3
c8fb4abe18a5df8f2c67f15dd01a8177,186,120,5,260.4,145,41,04060,4
9cc59c0b83badc2b033fdb86e8ba7005,55,42,2,192.5,28,27,01012,1
a262c12b5df1053829f7898f5554fee6,230,112,5,322,203,27,04020,4
b522a473cdce452d3ff8b7250d846f01,12,10,2,42,6,6,05030,1
aa1d040382b4e952adeb32039088f853,23,23,1,161,23,0,01012,1
3b4f55cfb052d00ab068b2f5da96d8b8,54,41,3,126,54,0,11100,1
f793273e3d9b0f619c9e6d25b254b79e,272,94,2,952,109,163,05040,4
80042df954144614356ecbc8928eeb78,365,173,4,638.75,365,0,05040,4
dcdca816b4761e78113529bc101f2886,15,15,1,105,15,0,05120,1
2cff2be7d9555514e6bdaba1726580b7,214,132,5,299.59999999999997,131,83,05040,4
45677d695e40a20b54dd4285681815fc,68,37,2,238,68,0,05040,1
a488a91ab08dd3e3927f76496108b6ad,45,45,1,315,45,0,01013,1
04bf0779cbc15cf3a30ce67958f6ae8d,89,49,6,103.83333333333334,75,14,11100,3
3491e3601b85f3308c1f6ed1e4134cd4,36,35,2,126,36,0,08230,1
bd23bccb63cb4b4e949174da646656c1,26,26,1,182,26,0,05040,1
b1d946641d800b9e1ac2186e826d5d6e,85,53,4,148.75,85,0,05040,3
d6304080db41aca07ea1f9ac487bfc34,64,46,2,224,64,0,10200,2
3e01222b12201c6bfab11b7929409f91,35,20,2,122.5,35,0,08452,1
143e56079dcd778789e131890b836231,377,154,6,439.83333333333337,322,55,05030,4
e8ee4fc70518e89e6aff57a09582809a,146,77,5,204.4,146,0,01026,3
e1b19466cef0f802a7c2b4ba0628d3a5,422,136,2,1477,422,0,01085,4
b84c60bd9c7f14afd3871924097097e7,7,7,1,49,7,0,09010,1
59418209428ceab134d3769c20ce23ca,87,68,2,304.5,87,0,04060,3
686e0d4081f37841d5d34f1c17585b62,98,68,3,228.66666666666669,56,42,10028,3
5dcdd290ef5b70987cf78860b89fc35c,150,83,3,350,150,0,05040,3
b71910641f2ac33248ff56ea4c867020,212,120,4,371,181,31,02756,4
7e80f6b8990281b5603936f5d2d11039,116,81,3,270.6666666666667,46,70,08313,3
e3f8e988f8cf32295fee31dff93adde1,323,166,1,2261,323,0,05040,4
4e00399f482c8f20e230aa2ce4af8b8e,106,72,1,742,106,0,01026,3
4dcdbefac94cb7da8f43ed993a46f84a,372,167,6,434,280,92,02751,4
87225a78309db998dd169bd17bbfb7ab,43,21,1,301,43,0,01201,1
ef582baab90e77e27bb07a1ec2ff4bdc,14,10,2,49,14,0,11040,1
c1730181ba85bd40287a603895a4ad0f,138,68,4,241.5,138,0,01085,3
40f1411bd485cd08e859bcab1e76e3ec,127,83,2,444.5,47,80,05041,3
eb489b1a0afc295a7207e9fc77b8e3c5,89,56,3,207.66666666666669,89,0,05030,3
d604669f0ca25a529312731984425c6d,211,99,4,369.25,211,0,01026,4
c05b3dbb24f06da39e34f5b1efbb60db,44,44,1,308,44,0,10200,1
e43e4b4789434ad015d50b60805c9d91,28,23,1,196,28,0,01012,1
4257093a269b60ceea1c4a3c05c4a369,18,18,1,126,0,18,05041,1
3c530fe2c3a5d1866acba501e2edd80a,36,36,1,252,36,0,09130,1
45fe444ad4e746c9b4fe4407e07414d9,106,71,1,742,0,106,10200,3
6413f9a384118b1ad2d6bf1de337ecd2,187,123,2,654.5,187,0,01026,4
175ccbc8d583e30efa9f9b8adff800e6,103,65,2,360.5,82,21,01012,3
a495c1d57bedb5e7aca8a45f67e418e5,70,25,3,163.33333333333334,70,0,01012,2
8ad0caeede024a34dea3e0a99f0052f7,57,44,1,399,0,57,08100,1
4c3c06716eaba34700a8eeedc6e81944,39,39,1,273,0,39,10200,1
efbec21ace0e40adf7726ea276eb36c4,19,19,1,133,19,0,13490,1
8dcee01cec5757b1d4dc3a1fc4b8cd77,31,31,1,217,0,31,01027,1
a20541632e0cc1961743eb7efd0da09d,14,14,1,98,0,14,04032,1
0b132ebfffa0c58c719e0f98d61283d1,366,179,6,427,229,137,04020,4
0c2207b2e8caade3f8e95f3d4965f655,39,36,1,273,39,0,13830,1
ab8a755a1e672a0c2424d538825e15e7,148,87,3,345.33333333333337,148,0,05040,3
ee6f8c4494467bf47e4e9612332329b6,66,54,1,462,66,0,01026,2
a8719df1f5881f0904cd22d26b8f6c4d,15,15,1,105,15,0,05041,1
fa92533b15949d7000d660d437a36f82,42,29,2,147,42,0,11140,1
18cbb45fe92df174044100f44f1e1042,21,21,1,147,21,0,01012,1
f620b70c5f62b35f761c905ccaf49b75,366,97,2,1281,366,0,01013,4
3409af624a966856d10d0171a63a9306,14,14,1,98,14,0,01012,1
2af7e5deb9a595c0479ba88722dd5f52,56,48,3,130.66666666666669,56,0,04201,2
10162cae1d36f605d2cca903b3fe22ec,49,42,2,171.5,49,0,05040,1
328bfa7b4081dd38d4817da00e53ce9b,5,5,1,35,5,0,05030,1
e05cd05ba44d45c036d185356c1e510f,483,142,3,1127,483,0,05040,4
5995c0abf214f54ff9f0240d9068fb26,583,154,5,816.1999999999999,530,53,05100,4
e79ecbd4e55e7b6e739d59b95e693c65,121,84,2,423.5,64,57,05040,3
2dafe4fc0bf2213b0c06adeedd4d854c,51,38,2,178.5,51,0,05030,1
b68998d9260f458d6e5322a2ef6009f2,29,25,2,101.5,20,9,09150,1
115084fb4d92569ba86dde5caeef4cca,15,8,3,35,10,5,12410,1
f084404d4c5b441575bf4253955d5c32,148,76,4,259,119,29,04201,3
12d176d122c68e48fe69e07d6211dc85,401,134,4,701.75,401,0,05100,4
79ff9581bdf39f302f00798b07298716,422,154,5,590.8,422,0,05040,4
5cae0145d86a1b6a4e325f1cb381e9b4,42,42,1,294,42,0,12500,1
adac617bc05d2c163204cf24958d3ccd,25,25,1,175,25,0,12501,1
2cf3a137abf9748b34c0abef99f48261,34,28,2,119,34,0,11040,1
014d40a2f3f2a69dcb4b6e1710f2a1b6,95,38,4,166.25,72,23,11040,3
93da87c8efb5cb330790e83ac1360265,108,50,3,252,66,42,10200,3
0f68852906f82ee9a4938bf7b562f2ea,22,22,1,154,22,0,11100,1
90c57e0e9c662d06eaa49c23d33f7137,69,48,4,120.75,43,26,05030,2
e61ee4bdf5215fa88f8e48a1b5f1b51b,183,110,4,320.25,131,52,04060,4
54aca8f4d0056fa3917871a96a58719c,103,71,2,360.5,103,0,09010,3
69dd8c801e25551f05e0240a0ffeb387,110,73,3,256.6666666666667,110,0,01026,3
ca153d0f22d2cd646848ed8b4da3ac09,13,13,1,91,13,0,02620,1
fa0e4eaca01ad6f897fa2b5f68feec9c,342,123,3,798,342,0,01012,4
e5b7cabff14dd7f3294914a47f74dc49,42,42,1,294,42,0,01012,1
c2ec882ae535bf92d2345b278d70d228,23,18,2,80.5,23,0,01012,1
2e485ad2269c0ca6a0fea463ab6e42fb,176,103,3,410.6666666666667,104,72,05040,3
072d1a013f70b4ef132eef183bc34cc1,169,73,2,591.5,169,0,05040,3
8a409e803c52eacdcab2979a2d714b91,114,60,3,266,114,0,05040,3
214a60dd499275b26e9a638deca6a33d,18,18,1,126,18,0,07144,1
4be4f8b1485e8f4c5cf0365f3246bfba,128,74,3,298.6666666666667,99,29,10200,3
914c888bc3e9bbcf45ae1f38131402a1,106,105,2,371,106,0,05040,3
fe61cb187b275057ea97338482cbc5a2,4,4,1,28,0,4,02721,1
6c22378e3809926f4f36a9477c9fa26e,1,1,1,7,1,0,11040,1
0a470a4c3e28f2b78853f882ec89ff90,271,149,4,474.25,244,27,05040,4
c8cc79abe531e1f805a2980c6da95b90,89,48,4,155.75,89,0,05040,3
c4c0381f6f4b58c2a14b4cdf8fdd4a11,46,24,2,161,46,0,10200,1
eb7e24e60a25b1ff27a37ddea2fe5430,23,12,2,80.5,23,0,11040,1
2a3742fd8caa00a229a89b72da9efed7,263,135,2,920.5,231,32,08314,4
ccbdba074c972328c3a320549d99f1e0,38,35,2,133,38,0,10152,1
85086f15d08ea72c5ebf15a6912d4de6,211,100,6,246.16666666666669,138,73,11100,4
a1c71a844d671c351868c7af919f66c4,35,35,1,245,35,0,08313,1
efdd93d73ba0f5793fc3cf747db01214,169,77,4,295.75,169,0,05040,3
1e093b95b3fd0e195fa44a67f66c3168,60,60,1,420,60,0,01016,2
b2b79883c1adbfefab66e27988b8a2b8,23,23,1,161,23,0,01012,1
92c91e2719402af3849e31574851a4bb,85,52,2,297.5,28,57,01085,2
d41bf24e726c64ccbf605ffcfa44bb1c,49,48,2,171.5,45,4,01026,1
2b50ce32b6383e206ba51e2c4877801e,96,73,3,224,52,44,05030,3
86bc9ff59d2f542cd142f5accead23cb,63,58,3,147,63,0,10240,2
fff9471d42e08fa9d30f1460526cd892,1,1,1,7,1,0,12410,1
bb382ea37784e9d51f4cd7a8e20cc317,215,79,2,752.5,72,143,01012,4
b8f06f7e7f2f74ccd8886d9f58ec5359,66,40,1,462,66,0,03070,2
f3fa946d2cfb510cd704e6362bfd3dec,17,17,1,119,17,0,01013,1
a47badeb3580df21b594c30711ac9439,378,159,3,882,378,0,05040,4
2cb094cd6be22ba204615b94e60d4ca9,34,34,1,238,0,34,02691,1
e0178fb6acf1c6f10d3becbdcbdd22ab,70,60,2,245,39,31,08452,2
3779ae4282e77fe46e49d50f7555515f,84,81,2,294,84,0,04060,3
6d106073a82c4f8ce3ab5fc38ff8ffbb,51,47,2,178.5,18,33,04200,1
df2bcecbdeb8c491aafb41fd58d4628e,103,74,3,240.33333333333334,103,0,01085,3
c6176c2021b2d1fdd0ceb569c968a87e,216,109,3,504,194,22,05030,4
5684b08c79c4c34800faf2419665b402,6,6,1,42,6,0,05030,1
6569f31ac0fe20ca0449c9a44867d1ad,108,74,2,378,52,56,01026,3
ad2de96f12e5a0546bf224cf4528e80e,72,52,2,252,72,0,09130,2
9e23769e45e6e7a3442030c846767ae6,31,19,4,54.25,31,0,10240,1
8dbd258c60cd9c6d34f428825ad42865,51,39,2,178.5,51,0,05041,1
55cc8e1934b01e08d4ecfbf3e8f2edd3,1,1,1,7,1,0,03090,1
83908cfed12244a404d30bb86ca0194d,22,22,1,154,22,0,04020,1
95cc564b19f3c1a16ba866934ced6296,131,100,2,458.5,131,0,05040,3
750b5e4c878e4adf8eea9a0ec55af680,285,125,5,399,240,45,01027,4
5a6f9d8fe8222381af379a1eb83d53c6,182,105,5,254.79999999999998,139,43,05040,4
496dee3460d7f2f10cee603ecb859651,350,113,5,490,306,44,01012,4
214cc7bb29e2fd3e5f66e7d758fee771,20,20,1,140,20,0,01026,1
4c81e25defba55faf96c591aeb49cd9c,54,38,3,126,54,0,01012,1
e254a2289410e5a8731493690d1078a4,10,10,1,70,10,0,12430,1
ca16267ef33808e4eeb7917fdd2d7394,237,94,2,829.5,237,0,10200,4
787d2ca7be2db4f660729e9161c16abe,30,30,1,210,30,0,09010,1
64fbbdd219197d8e18aa15613357c03f,101,84,1,707,101,0,05100,3
d0175fb3ce599ea9f5a6790ba21a20db,65,35,2,227.5,65,0,05040,1
7bcca6dc036701b3eed6b128cd597d72,68,44,3,158.66666666666669,23,45,05030,2
086bde9a531b727a088d71cb32cd61c8,145,99,4,253.75,145,0,11080,3
d6d276cb1d2ef991655b1e30c94d2701,42,39,2,147,42,0,08100,1
d5e770443d450dbe0bae559fd7d30ca4,34,34,1,238,34,0,05100,1
d229c240dc24a719995a0c2995ef2546,115,55,3,268.33333333333337,115,0,05041,3
71376498a7bacf3baef8e4026c9f242a,103,78,1,721,103,0,02620,3
5b6205006166e5bed16af0c88b578ee1,162,84,5,226.79999999999998,142,20,01201,3
7a3bbe31382c017ab9cfb48f1cc23049,39,29,3,91,23,16,12670,1
380fa8bbb9d75c554ab06249d0d528cb,869,229,6,1013.8333333333334,802,67,11140,4
4a54bde8c297a280b2198d6ca97b84c5,69,58,2,241.5,69,0,01027,2
969bbe5fc12387d78d10473e5aa795aa,141,82,2,493.5,141,0,11040,3
c66bf34931c4c34d830b20b03de00d46,37,37,1,259,37,0,01014,1
ae6bb41dce2fe1de17701f8c45d4f130,124,81,2,434,37,87,08052,3
662330c40158c0ca54072d527a29921c,49,39,4,85.75,49,0,10200,2
8fcae0bf9de80e7ce03e31133554b2c6,5,5,1,35,5,0,12500,1
d09be0de0dc8fc87414fd54688c71585,158,105,4,276.5,158,0,08052,3
4ca8446dec0ea4d46987ac3fee9e232f,197,97,5,275.8,173,24,01012,4
6c74db0370988901c6bcbd3c6fb24263,50,40,2,175,50,0,09170,1
a6c71ce95eccaee02883e1f2161a182a,341,120,4,596.75,306,35,05040,4
20f82470da1cc9c12ea04c6e70e47082,81,63,3,189,53,28,14301,3
5633d7aa8eeffa1b0883e56bbf4e7009,7,7,1,49,7,0,05200,1
81c1a7b5b97af743169353cc638d7de1,202,97,1,1414,0,202,13820,4
987f47aa3f02fe766c22aab3a56f1d6e,23,23,2,80.5,6,17,11100,1
feeddedc060ef9e3aa8dadbd684af605,24,24,1,168,24,0,09030,1
76607479c42e4d9651173a7dbff47c13,21,21,1,147,0,21,11100,1
5f40dcbe710f90e6996ff567ae9cbc6f,264,136,3,616,175,89,05040,4
416b134e3d4028210a9ef5e30c8a0abd,28,28,1,196,28,0,09030,1
8318c28fc94f6e79afcfc311eb85435b,231,116,2,808.5,151,80,10240,4
493e6561b5eb04bf4840aba66464b01e,72,63,2,252,72,0,01012,2
209859a23e4cdc54c0cb5d980d51eadf,151,102,2,528.5,151,0,05040,3
992e21d0ef1b68f6f32db1f24eb7a783,274,129,3,639.3333333333334,274,0,01026,4
b02ab7c8425a7c09f3b53cf604a77dc2,305,178,3,711.6666666666667,193,112,05040,4
dcc4f046079415e82bd5a81044da11f4,22,22,1,154,22,0,01012,1
8988ce04ba406fb592d6874816b00787,71,56,2,248.5,39,32,02650,2
4f909f65dbb979398a2df7c5e4622c94,68,68,1,476,68,0,08052,2
8c834f5b8c6f822e1a068569d7633fa9,331,126,2,1158.5,309,22,05040,4
e563f57b82aa2e93b98843889d88d349,262,95,3,611.3333333333334,262,0,01026,4
c9cfb760c90e5c177e3cff9662871866,70,70,1,490,70,0,05100,2
7df1525572ebb9c39de3c9e0ab32afc3,152,101,3,354.6666666666667,91,61,01026,3
4f14483d20a9681dd2f6a16a6761df30,36,36,1,252,36,0,10200,1
bac81b5ef8ec9db4b657f29bc59c80c9,20,20,1,140,20,0,01013,1
de102e636e7f11a94075e1b97b2dba1d,487,176,6,568.1666666666667,456,31,06120,4
21832ce9a4bc3354b1630a2f71cdf64d,239,130,3,557.6666666666667,239,0,10200,4
1e7b8baa35ad9b2a12cdfcf89ada6bc9,50,50,1,350,50,0,10200,1
8456a252bd7d093f0257646d032af482,284,106,2,994,284,0,01012,4
88f49ccfdeca67c2928642583ae0b92b,60,56,2,210,60,0,01201,2
587a762e2da86f5d516f98ed8459059f,27,27,2,94.5,27,0,01012,1
1c00449cb6615ed1df4f15376bd35370,80,59,2,280,80,0,01026,2
364003157a730a45dd00b9b3386b5929,18,18,1,126,18,0,01026,1
6c4fe2a604a040c00099341083cd88f3,105,84,3,245,105,0,01026,3
be48547056e1a918a8b1acb5e33e70a9,214,96,3,499.33333333333337,112,102,01027,4
633cab6d17e5e924ced0328e4d7d9554,30,30,1,210,30,0,01026,1
5f526cc57b8be0607d2526f8454d520e,24,24,1,168,24,0,05030,1
3924666d8f045233d99bd3f9e4c746e8,451,205,3,1052.3333333333335,451,0,05040,4
beca1945132c8dbe4c9cfea7ed821531,41,36,2,143.5,41,0,09090,1
34fdeeb6cdee2341e79f9245c81a180d,101,66,4,176.75,73,28,05030,3
30cb56f672dd6fcba2c77f3e1484441e,67,67,1,469,67,0,01026,2
cc539473d4b81a1612a95ac51242f8f9,146,80,3,340.6666666666667,146,0,04060,3
53873659da160f61569b45d92f64cd7f,70,55,1,490,70,0,05030,2
bdc9444f309c03851aa3963d4bbeaa47,13,13,1,91,13,0,11080,1
1016c4eae2164bae75b4f9a4243d70b0,212,139,6,247.33333333333334,196,16,05040,4
277302345181db464750f009ebc3e8a2,17,17,1,119,17,0,08313,1
d0ee59fb5cd286e397004bbdb0ef7bdf,23,23,1,161,23,0,01085,1
809306430c30afa732b4af652a966c3b,50,36,2,175,50,0,10200,1
9bb57e69c6c9392bf8dcd42a0c567fde,147,113,3,343,90,57,01027,3
bf7b8ac37beea41239ebde480d15ad97,32,25,3,74.66666666666667,32,0,10028,1
38fa6ba7cdeea32fc54a14ea788ef135,112,68,2,392,85,27,10200,3
8a5318a794bfdae7891a1aba9f1a31d9,24,24,1,168,24,0,01012,1
4c1cea166c84ca532d82601bee97fff0,79,56,3,184.33333333333334,79,0,01027,2
897e80e4ec4f1498dbb9991e9f62866e,14,14,1,98,14,0,01013,1
5224bbaaee02d8fcd95b786c01056428,106,53,3,247.33333333333334,106,0,01027,3
60e5c478e6099b631e0b6d518485c6f9,108,89,2,378,108,0,05040,3
019af1f0b2c89f89ea51a41feb45972d,17,17,1,119,17,0,01026,1
2a6edaddfda297ce37a2c86c38f3c4e9,26,26,1,182,26,0,01026,1
8c9ae9074b7371e60a5dee141afe3aa6,7,7,1,49,0,7,01027,1
c503ffae8de6e7d4a569bac95c973740,49,41,1,343,49,0,05030,1
12b0c1a1d830c8fcec31f6310cf29ff6,144,89,3,336,87,57,05040,3
ee096b3ea9b2aa3d2a5e6642dacb7fcd,105,82,1,735,105,0,01026,3
e8ead9305fcc15a6b92783202b2907b9,39,34,2,136.5,39,0,01026,1
d50ea80c5022b8f2dc248f4571de9f87,92,68,2,322,56,36,05040,3
76fdc1b4fb01aaf74ca61763f2081d79,155,120,4,271.25,112,43,01012,3
21afecd72f2e2f4ac47e046ce1a05b34,73,73,1,511,73,0,10200,2
52541132115c11590eae900be59b963d,102,75,1,714,102,0,10240,3
63886c0a7b6fdf977309812e767ca9c5,2,2,1,14,2,0,10200,1
6ff09beb83df0473d0d58f9f1187c32f,6,6,1,42,6,0,02691,1
1539e84049114ff8198cff82878a8293,248,156,5,347.2,248,0,07144,4
062afda7c67286babca953793e0bb377,16,16,1,112,16,0,02690,1
ab5f6f1478e0880ba15d6d2d210aaae4,60,50,2,210,60,0,05040,1
fae68174f8ef86f7f1967dd714f21f05,22,19,2,77,22,0,01026,1
726f7d93086cd9b11af70790e2e31d35,18,18,1,126,18,0,09091,1
6ed820461b78496959cb6bed56c53107,16,16,1,112,16,0,09170,1
1cc12d26120d8b46514bb6b23bc0ff3d,52,44,2,182,27,25,05040,1
8f30f3103e1f913c7750d7297de6a766,37,33,2,129.5,19,18,08052,1
efc7a17e77aa88c63069675f5b6bb054,62,45,3,144.66666666666669,62,0,03070,2
851cb39347ba0753cd251e6f3ebb013d,11,11,1,77,0,11,10240,1
4d715b86b3f77a1b40b5ab709046e994,74,74,1,518,74,0,01013,3
fca152088ea1623bbe53ec3734044e11,17,17,1,119,17,0,04060,1
c08baf542a037129db9cb60c9e42b433,62,43,3,144.66666666666669,62,0,11100,2
41b68762d2f1110f90eb018012ae7b1a,13,13,1,91,13,0,11100,1
366975abb03b8e24b20ea8bd5d481d17,14,14,1,98,14,0,01027,1
d8e3dc58cf6a0e3486a5e66e55e6098e,27,27,1,189,27,0,01026,1
62c95e42ed9b1160349205d7bfd30e01,41,41,1,287,41,0,09090,1
7278066f564371048c2f6967fd244ed0,23,23,1,161,23,0,05030,1
64948ee49ad1a1ff8bd6eb9197fb6144,260,109,2,910,260,0,05040,4
c0dfa9d193dddc9555c79234b863a6ba,120,72,2,420,120,0,05030,3
573ad75d03e3822fb10b7ce863dfef27,160,124,1,1120,160,0,10200,4
1a59671ab3a4fd3dd91e2ee075fd4d17,246,91,5,344.4,190,56,05040,4
ecf99f5a3cb1c0ab27946a64172a5634,10,10,2,35,10,0,12590,1
7540242f9a39728015e14fa74be6bef6,41,41,1,287,41,0,03050,1
9d3760eebc565215c7473b763a30a752,48,37,2,168,48,0,04020,1
49a030d3725e5341e764a878612d0331,17,13,1,119,17,0,11100,1
4ae989c3dafd8eb7d2b3d6dce342da84,86,53,3,200.66666666666669,86,0,02650,2
819cebbe522a1123260786dbc2813585,65,65,1,455,65,0,11100,2
5c794e17adcbb8277d856d530cfff462,12,12,1,84,12,0,13490,1
a95bdb5ea2e1cd1fbe98d91429abea73,282,136,6,329,195,87,05040,4
e32d08a2816e3438fc580e709fd08f71,52,47,2,182,26,26,08100,1
7ba0ae296a03e160e43888df246f1cab,247,114,4,432.25,247,0,05040,4
d6436135a5acb47db15e9c263c7390f8,317,129,4,554.75,252,65,01027,4
88bec99c93d7ee26514611d9cd20ab9b,27,27,1,189,27,0,01026,1
f72406af36cb5a706c59cf7a0e17fe31,45,45,1,315,0,45,01012,1
33a8c8238643fc9ff98ab14d4146ba90,14,14,1,98,14,0,01013,1
b68b565fe1338e696affb4cc8dbe40ed,41,41,1,287,41,0,10220,1
5fa09b50c82316c8cc0bc0f494b3d075,145,71,4,253.75,117,28,08314,3
14ddb2cb011e8002ea78128586a9ed8c,54,49,2,189,54,0,02750,1
9b3d02fd548f2ace2282304243443a5e,28,28,1,196,28,0,03070,1
397a425c8f9ee06d433f5e68c31e6847,340,175,6,396.6666666666667,252,88,01026,4
93bf2c0ca352ef69b78db38573d4b92e,58,55,2,203,58,0,10200,2
d82086c71ac591405b9b40f13cd3a3d6,43,43,1,301,43,0,09130,1
d47b1d8dc7930c2317dd9bbfd48bb71e,33,33,1,231,0,33,05040,1
0a1ca867f6e935284fb2c04d7e7c3b68,33,33,1,231,33,0,01012,1
19a7013f9240bd5dedc8730c61c004bf,41,29,1,287,0,41,11080,1
4202092db9fc76b49935b97499167893,54,54,1,378,54,0,05040,1
ff390e8d17944e0a324bd0885af7c87d,16,16,1,112,16,0,05030,1
ef9a2295e03d82ecacef93c100294ab0,94,53,3,219.33333333333334,64,30,05040,3
809936d97606624475f7cda808592d37,16,16,1,112,16,0,11080,1
41aa3fb3a74d6f3be59d1a58166b7289,19,19,1,133,19,0,01027,1
18af83ac11cafec7575cc8405a68684d,107,79,1,749,0,107,01027,3
c8d80dcb5a301eb2f692d630b955216e,14,14,1,98,14,0,09010,1
26deea9f942669cfc0bf65a62c0da301,309,167,5,432.59999999999997,252,57,08314,4
602b7eb5d5aec4d6d7f4694465f0c220,16,16,1,112,0,16,09130,1
1de080168ad1678e2083d06755940dcc,140,67,3,326.6666666666667,140,0,04200,3
a9d88eae4a5bc7f1444f40480582dee3,43,26,2,150.5,43,0,04060,1
3cfb65a8979705481ba926af81dab046,16,16,1,112,0,16,12610,1
fe6e18aa50936d34e467ef11633a07bc,52,34,3,121.33333333333334,31,21,11080,1
3a87b0477e6dd4d3920c80d342aab045,56,56,1,392,56,0,01012,2
8f5870cfd65b800650074828934b9186,135,75,4,236.25,135,0,04060,3
840acb899990dd086e747c0c5dc40d4f,61,54,1,427,61,0,05200,2
93408bbf94f805b2f8f971e6e0d70541,35,35,1,245,35,0,01026,1
755dbd1eed76fa181f9de23190fc0d44,117,77,2,409.5,117,0,01026,3
4bb540c3143365caaec40c9a4a4c73a2,344,120,4,602,74,270,03050,4
3f95276b49379d3c904dabc82ea2ac0a,100,85,3,233.33333333333334,100,0,09130,3
1d6ff8579b78e8da615169e651dc2235,184,92,4,322,184,0,08314,3
03e8a412feac35d552db990dac737fcd,35,35,1,245,35,0,05100,1
dece0c98fb6bfb285b878113e07ccf69,230,122,2,805,156,74,05040,4
be76dd565f2984b04f564dc2d6e3f26d,31,20,1,217,31,0,05030,1
72ab447e95879083aac253fd506eb812,41,22,4,71.75,27,14,10140,1
2185e4ca26764b7b13654b533e613338,539,170,3,1257.6666666666667,233,306,05040,4
1fd5f6e9f3bf069889681c0b2e831778,34,34,1,238,34,0,03070,1
d6a4fbd0e75c159e13694fa7f4a4eda3,51,27,3,119,36,15,08150,1
9d9510c833b5f0dd9f905d68db860660,367,156,6,428.1666666666667,275,92,04020,4
04f608ebcbf0f997654ea5983fb3713e,46,32,3,107.33333333333334,46,0,12410,1
36faff4ce55a041d866c74bcad72fef0,444,135,4,777,406,38,01012,4
1b22f8a7e02dd0e926862e8898451310,185,96,4,323.75,185,0,10240,3
177909b49e08bbc8885dfd776b4b121e,13,13,1,91,13,0,04020,1
c7f136d147745c3f5f0eb44e71cdd903,120,84,1,840,120,0,01012,3
9c8f757f0ca07a99aceff6c0fed07926,32,32,1,224,0,32,01026,1
974e429b39357a86d95479553b35e5bf,69,48,3,161,69,0,01027,2
a3067de52e479fdab286ab78dc12c87b,37,27,2,129.5,21,16,02751,1
209423644027066fa04d2d2b17d8ea84,483,235,6,563.5,450,33,05100,4
bf645cf35b84d014f96c3aa5e3b20386,29,29,1,203,29,0,08032,1
130d78e4d68e8e6522940893140df30f,59,53,3,137.66666666666669,59,0,01012,2
0ea708d3829661b47336b606b3d6fcab,10,10,1,70,10,0,05030,1
3cb424b9b44315c7fcd4918e0d99e1e7,71,64,1,497,0,71,01027,2
0d491ea1453c9623464e21437b9095c0,16,9,2,56,8,8,06100,1
61c2d75aa4139c8eb8d91544f7afe4c3,74,57,2,259,74,0,04020,2
bc17b0f3031b0b5a439e56b8fed08f52,27,27,1,189,0,27,09010,1
9ec19bf5d3c64b931da054502f46999f,37,37,1,259,37,0,01013,1
6f8d7bc76f47e796699561293013413b,103,98,2,360.5,103,0,05100,3
3a22009e7b211f1a128945bcad62add5,20,20,1,140,20,0,01013,1
89ad2cb718d854cd112aef1efe550921,94,80,1,658,94,0,11080,3
877ba41e8cbcde32e9adf77b0339b90a,106,70,2,371,106,0,05040,3
4c393e59e21c34312cc2fbb41ee13317,10,9,1,70,10,0,12590,1
e3ad11c4b9624b636faee304127f4659,3,3,1,21,3,0,01016,1
4ff0e46dd0e0f67d3cadd63ac2cb1025,106,63,2,371,44,62,03050,3
a9717f7aee2935bb008316fa97e4f73c,26,26,1,182,26,0,02690,1
cfb053d60120e9943054faea5a50e6cd,14,14,1,98,14,0,05030,1
4a6bfe69e1d97fa78cfca058bfba593d,15,15,1,105,0,15,01013,1
248a692792fc40bdab94cadb052342ec,243,113,3,567,175,68,05040,4
fc6371b9f14e3962bef18e48d89b958d,40,29,2,140,40,0,01012,1
7564d1c4798218815f3c8389ff57089f,65,64,1,455,0,65,01026,2
e37d215df04a09a650e6c79fced2b2f4,158,85,3,368.6666666666667,158,0,01012,3
6dadf45d0c449fa7f66e4607ee8742f3,94,75,4,164.5,94,0,10028,3
b6d5ca7fd85710358d347f5b733e3e5c,4,4,1,28,4,0,11040,1
40801c5bb9f39f407627d2cbb6b904c0,333,84,3,777,333,0,08090,4
2775a9a6cd3354268b15883874f81b03,84,57,2,294,84,0,05040,2
718f583f91a10bbef98d409ebd77fd58,37,29,1,259,37,0,01012,1
e841b8470ad2e6db6c71b4fde10f06df,31,30,2,108.5,31,0,08031,1
011e3017b3bbd2e84f12b75b53312f8b,32,32,1,224,32,0,09130,1
eabbf0bd2e0733622b765595784bb733,158,65,3,368.6666666666667,79,79,11140,3
41e487bcc1331f209674a26ba2940eb1,75,75,1,525,75,0,01026,3
d16c20faebaf8cd88e6696a7b09c00cb,56,48,2,196,29,27,05040,1
80aaff100896869073240e072df7cd37,16,15,3,37.333333333333336,16,0,10200,1
8125b7b07fd1f9c7ca3e134d24e1cfab,58,49,2,203,58,0,10200,1
f238aeb4266ea19409c115287d4c4622,78,54,2,273,36,42,05030,2
68d1bde3bf242c8990278fada0b7a66a,59,48,2,206.5,59,0,10240,1
b71a9e050d38f9e77c76e347583fa90a,65,36,3,151.66666666666669,43,22,10200,2
8a1f9785b162395b545e5d9313e03e08,43,33,2,150.5,43,0,05040,1
b3d32c39643401aba6432b64daf75013,49,49,1,343,0,49,05100,1
adaf9a29531b87e013f0c425df046ef5,210,99,3,490,108,102,01012,4
604c090768ac94f99955b5a0bd1598ec,108,58,3,252,75,33,05040,3
f6d674092c34610bb0ab15769b7767a6,219,121,3,511,117,102,05040,4
d81c480245e389baf7a08539c945db14,13,13,1,91,13,0,09130,1
f596b3b889d86418f10e53e762946a88,85,44,2,297.5,85,0,01026,2
1ad2359ea51d072a084f4b1c11c0684b,35,28,2,122.5,35,0,01201,1
38b2a7c9898f5a8ea0a1f0230d66071b,82,67,2,287,82,0,09130,2
b2b952c01a118278c614954c388566f6,41,41,1,287,41,0,05040,1
4ed3e17215b242fb50bcf70c712345b8,70,54,1,490,70,0,05040,2
1aa821d1d091d9beadb997ce13ec6f50,89,68,2,311.5,89,0,11080,3
c75c0db5b680f8a01d7b86c9b7c59e18,5,3,1,35,5,0,08100,1
ab91913b20e2e22dd647787cc1b46500,31,31,1,217,31,0,09130,1
52bfa918e65d806dd3fb58e345ff32fc,52,52,1,364,52,0,01026,1
2156a24c814857e555a7d08d263fe588,176,106,3,410.6666666666667,176,0,04060,3
ab20fd7b3431aecc99ebb0d295dadc04,37,37,1,259,37,0,01012,1
35ac18ab7549a19b1626f2f89e15a637,51,48,2,178.5,33,18,12590,1
5a484156482b6250d3311296724a8db8,76,55,4,133,57,19,11100,3
aaec396265b6717667f17ef1b5035463,33,33,1,231,33,0,09130,1
41b07f6eb9f7e795a70bdc3510cc19fe,157,70,2,549.5,157,0,10028,3
53edd0404c56c3c07ec861c3fa64acb6,32,32,1,224,32,0,05030,1
5580493da3cbdb330735af38321608c5,148,94,1,1036,148,0,05040,3
179c11163e03237ebd7395ae4b3e24e8,282,128,3,658,216,66,01026,4
21e9be643b77a6597ab12bf88b1e6af2,108,85,1,756,108,0,01085,3
72ae6e1a56e7e010a2438c5653a02720,758,139,4,1326.5,758,0,01013,4
afbf047ea16dc9c54fd74eda8ad307cb,31,31,1,217,0,31,05040,1
6ddd82a1b8902386d65ac1f2eb2bb844,8,8,1,56,8,0,11040,1
18186daaa2faf4a2aed9110a9a9923ef,32,32,1,224,32,0,01012,1
34a0df8c127d08341357051d0159f1ca,28,19,4,49,28,0,05030,1
abd02639aa9d58a7e6c4377ee38c863c,20,20,1,140,20,0,09130,1
be813433df0c1a5303ccb6b5e0d21b11,52,52,1,364,52,0,03090,1
948485950f36c86747d4b25ffa9b6cd6,6,6,1,42,6,0,12570,1
fb65ca555abd15d75a5f854236637fa6,27,27,1,189,27,0,05030,1
5286c73da08bc30453a493d1cbca1038,27,27,1,189,27,0,01013,1
64048749cf6f8bb1370766359ab5d851,82,54,3,191.33333333333334,82,0,05040,2
8a3cd8a6baa3af66b6ae10dbfdcc8834,43,33,2,150.5,43,0,05030,1
d43131b7857a849a5f2a53c9df06a65e,33,33,1,231,33,0,02650,1
eaeb1449d9f77af29cfdc283f7873a59,28,28,1,196,0,28,08230,1
ffe1ca1c66b079ce01e2ea9b26702c29,19,19,1,133,19,0,01027,1
9c9062e4ea2d0541d4a7cf5420805a0a,14,14,1,98,14,0,12610,1
2d33b60e267816a22495cb5cf81d416a,59,52,2,206.5,59,0,09170,1
230bf36499736d114bfbf130d67ba6a5,251,72,4,439.25,251,0,04020,4
88f6f76ff45d0c125f8bf5b4938af19f,39,31,1,273,39,0,05040,1
95e5263ce32c3de5dc5a47c37a58df85,318,69,2,1113,46,272,05040,4
cab6c94246be705683e9b4c58f3633e5,654,206,6,763,568,86,05041,4
72d42bde08445358d74ab61901e85505,23,23,1,161,23,0,01013,1
42650ff29438dc6909ea54c3f05326a0,114,83,2,399,114,0,10200,3
6bf609e330180346d65c1025f4435dd0,257,187,5,359.8,202,55,01026,4
ada831414e128c4ca12ff4ccadda4688,62,43,2,217,62,0,05030,1
f95f04d662bf6cfe19e4edd8bea3245e,59,59,1,413,59,0,05040,2
0e871d2a10f9fa04794d991ee81cc16f,58,58,1,406,58,0,01027,2
777b4985ed9c1c1034a6e736aa65d4f6,80,65,2,280,80,0,11040,2
bfed4ee0143e56321e75f6366d1b0810,15,15,1,105,15,0,04200,1
625624e534d11fdd465b1f35362232f6,25,25,1,175,25,0,01012,1
ee2caf02518959ad8a6f16998e83ab75,22,22,1,154,22,0,01026,1
a760a79dab4f1497b714114e1ed8cfc6,67,54,1,469,67,0,11140,2
91d231f782f1234f89c478275ec1d7d3,199,131,4,348.25,91,108,01026,4
d5e4264693378be934325ecfb7d83bf8,46,46,1,322,46,0,08010,1
ae1b225c31bca1ada68b24561f8b9995,44,44,1,308,44,0,13953,1
ca500fe8fd980e2b7e3b433d2d39eac5,141,81,3,329,141,0,05030,3
026c9f825a08d954a6226734417344e6,83,50,3,193.66666666666669,83,0,11080,2
11ece1777ce2d2031f10fb8d832d9538,28,28,1,196,28,0,12501,1
aae13cc21e239f6026420fd67b1cb3cd,115,80,2,402.5,115,0,01013,3
42aa566e0dad230809d9526e4bb1a97f,80,66,3,186.66666666666669,80,0,01085,3
845efced50e36b739a3092e20d3ca4a7,131,89,3,305.6666666666667,102,29,01027,3
f5585332bf86dd9088c2a433b65d2abe,34,34,1,238,34,0,01012,1
5673e2613a7468df39d3eb29a1d37e76,122,96,3,284.6666666666667,81,41,08032,3
d9988e8686cbb1efd2d9565dba237e4b,52,42,3,121.33333333333334,52,0,05040,1
bf3a745388a2a3d5f1aeb10843cf3aac,103,63,2,360.5,103,0,05100,3
ebb0607322254b3a4b463dfee433f2d4,32,32,1,224,32,0,04020,1
4edc57bc8b9d0eb1ecb60e9071b62b53,19,19,1,133,0,19,08090,1
6040da121909f9a4a16e9bf3fdf08145,229,133,4,400.75,123,106,01026,4
f7b93e44f75318ac2f1df451a511a7d4,44,44,1,308,44,0,01026,1
851f79139fd154e7123b15fcdd4fb271,51,47,2,178.5,51,0,05040,1
93aa3dfbbe5be2df490434c492cc8344,10,10,1,70,10,0,05030,1
3bd118ae018c88a1f2e0321dd14ef755,230,142,4,402.5,189,41,02650,4
99712079e0ddae548f476ddd416023a3,16,15,2,56,16,0,05030,1
9ab02cb2edcb093a33117cbc9948a47e,22,22,1,154,22,0,08052,1
c8e25c3b0e7839d430743e1e21310b2d,62,53,1,434,62,0,03090,2
7349e65135b95870e907870de3c40719,536,197,3,1250.6666666666667,450,86,01026,4
ff1eef1cc5ab119af4b449d144c84a1b,349,106,4,610.75,260,89,05100,4
759f91642f7f386d881ad8833bbc6aeb,12,6,3,28,12,0,01027,1
0d327953a6f11e8433988dbd16a7d7ef,31,31,1,217,31,0,01012,1
b6b19038068d06c5d51ec64285f7a7c7,77,49,3,179.66666666666669,77,0,11080,2
d2d9bf0d47bd0e370b0b47c73ccac8b9,17,17,1,119,0,17,08052,1
bae9433b990db9d61c4e3f48624a63aa,88,54,2,308,26,62,05100,2
eb2c8e7cc5d29a7ef75b0496a78b1211,54,54,1,378,54,0,08010,1
fd87bb084e5340a31e7f65092fa27748,52,46,1,364,0,52,02650,1
1eea3664edb1d4e22b23081e0dcd4563,33,29,2,115.5,15,18,10220,1
2509b6d242da208db8c84f2d3adb5772,39,35,2,136.5,39,0,12670,1
96fd216db0eda9920594e99cc2e7de4c,175,113,2,612.5,72,103,11081,4
d732b0a0d6a244c5d711689610cbe3d1,40,40,1,280,40,0,01016,1
8ab5998b680637bf1a3d1a903c715298,1,1,1,7,1,0,02650,1
75292841474e467ba8e85a720d5dac7b,34,34,1,238,34,0,01027,1
87807d439da50897ecffc0185b838bd1,1,1,1,7,1,0,13820,1
ece5eb4d0355a70aabaccb7e1fb1751d,18,18,1,126,0,18,04020,1
ec90a6e127f1e45b1ce81fd62a654bf8,252,118,3,588,252,0,05040,4
74e76b90d246f7c5bf23fd603630353e,15,15,1,105,15,0,05040,1
4408a8646ac3558c505d84301c149f59,340,139,5,476,340,0,05030,4
a379abda7def9350a9e5b5be66680ef9,145,98,2,507.5,145,0,04060,3
d57063a57988fd0f6c00e1fef44783ab,90,78,2,315,49,41,05030,3
ab428a1525c0f4f3d450380e4e675bea,23,23,1,161,23,0,05040,1
bc4ed0e8f03eb96f28eca129b4fe0705,164,105,2,574,164,0,04201,3
688ff8ce428b670f2374584d938cbda3,141,94,1,987,141,0,01085,3
c5f9b71d3ad388112f954222b84805c1,37,27,2,129.5,37,0,05030,1
bc1e5e0461f577a9ef693915cd9c6321,35,35,1,245,0,35,02691,1
ed0b42a892c04015f66218f6dc575ada,64,64,1,448,64,0,12500,2
cdcb5300a6b85f94b298b8a473840c1d,13,13,1,91,13,0,10200,1
5cfbf7966fcec5a92f342fed12bf021b,50,29,3,116.66666666666667,33,17,02691,1
bcf00203ef273aaecac1e8b381b3c1b9,48,44,3,112,48,0,09010,1
167cc02e7bf795dcb06793dff896f12a,16,16,1,112,16,0,09130,1
842fc5e441609d7ce864a079839ce5e2,63,56,2,220.5,30,33,12501,2
9bfaceb81daa322e0624dce8a1a56d73,51,43,2,178.5,24,27,09130,1
2dbac034c92aac30fce488b2ff2b0b29,182,80,3,424.6666666666667,182,0,05040,3
3264cb3aef899fc4e00167954b2f2589,183,75,1,1281,0,183,05040,4
290a188e532b6cf11dc95ee0df2d1485,179,101,4,313.25,179,0,11100,3
e450685bf4ed901c56c3f1f5167ea67f,69,50,2,241.5,69,0,10200,2
0676c045b5ff20798380ac568a037710,7,3,3,16.333333333333336,5,2,11040,1
9862205822cf96aa57d3c005a71b7f4b,60,47,2,210,60,0,01026,1
3cc372af748f01fe04e243a55a8f8c3d,136,88,2,476,101,35,01085,3
e9df50b414a68c6004f05a030060031c,125,88,3,291.6666666666667,90,35,05040,3
864e61930a56ab1046fb3a8ad8ccc3ec,12,12,1,84,12,0,01012,1
6b5b94cb320eb678a7af6fd7398ce707,45,38,2,157.5,20,25,01012,1
fe38e469095a1c740782d10da18c9d8b,38,38,1,266,38,0,02690,1
1368c2c99d1769c9d1c9183f45ec74e6,172,78,4,301,135,37,09010,3
e3bd10f6151a5705b55a3b3979cc4407,111,76,2,388.5,111,0,01026,3
ce4156a8cf0ad621195a387221f4b0b4,8,8,1,56,0,8,05030,1
507d396881dcbbb9c3dbe5593bf74f02,92,59,3,214.66666666666669,92,0,01012,3
f139d9aea0dae45b8498201a735cc48c,76,61,2,266,76,0,01026,2
e9fdd2bda4cd5aaa967bec8c94f97a02,299,148,5,418.59999999999997,299,0,05040,4
f595910cabcc97baeeb20f768a5f2fb2,130,67,5,182,130,0,01026,3
9b1a4f80c7099d10389694a9dab18898,26,26,1,182,0,26,02650,1
28ea9f8c9fb69f841ee5a5727c16f303,257,118,3,599.6666666666667,143,114,04060,4
a8d7517c7db5027a2a908b3e46f35d00,115,92,3,268.33333333333337,115,0,09150,3
e17c923a1d858ae77d84ffec53f0e77f,8,8,1,56,0,8,09111,1
94e50b8a8fc2a7cb35b12adb85b5425a,68,68,1,476,68,0,01026,2
f20b4b1c4bb068a3929f35fd56eea49a,49,42,2,171.5,49,0,01013,1
e6dba7bcd3586a9f195ac0e47d068c66,21,21,1,147,21,0,04080,1
317682e2b9dc93d483a887cbd83282eb,26,26,1,182,26,0,01026,1
180d688a39d80a4980c95b438a5fa921,18,18,1,126,0,18,11040,1
9b4c28e292c2e3af786e0737224bf717,30,30,1,210,30,0,02756,1
b54ad955acb9576efdc92874713c9e41,20,20,1,140,20,0,01012,1
368653c81cfdf1a1091f60c75dda0e4e,44,38,2,154,44,0,11080,1
21da7c277e3143250897f708462e9e5f,163,93,3,380.33333333333337,163,0,10028,3
cde9c2b0a5d7cd8dc998a75f9c03c767,305,94,4,533.75,305,0,01026,4
6d43f4ab1c5988124f2e05379ac3eda4,196,119,3,457.33333333333337,196,0,01027,4
8350854946b5f0ae2fdf35b5d87c732b,86,73,2,301,86,0,01085,3
a2ffa6509dde5da8889638e45850034f,68,47,2,238,68,0,05040,2
0cae50d1411d972201618bc486d1296b,67,57,2,234.5,67,0,01027,2
4f45c9eb03dc957e51cd24dbdfffa9ec,250,81,3,583.3333333333334,96,154,10240,4
ed9a7d09c240d991dbfd3a978c513fa2,22,22,1,154,22,0,04080,1
73eed64197c932cea1b1f08909547195,57,53,1,399,57,0,05040,1
d4272115d2c7e9926db762f895fec0e7,122,67,4,213.5,104,18,01027,3
9627e02c3059963698d80207672355fa,23,23,1,161,23,0,05030,1
d3d7180f31b7f687d0ce37e6858b1e45,31,31,1,217,0,31,08314,1
a702547a1154244ec7ec707a3ff392de,28,28,1,196,28,0,09090,1
cf210f13477b560549ca4d96d414eabe,37,37,1,259,37,0,03070,1
9a35326b632cf322e80e2d6d6fdfeaab,6,6,1,42,6,0,05030,1
f17bc44f4afab88e48e768fd10544480,76,59,2,266,59,17,11040,2
ffbd7b851aa01e7169b669ca2fafb69a,82,38,3,191.33333333333334,82,0,05040,2
077887358935a8aaf607f4d0865215cd,45,45,1,315,45,0,01012,1
93a916161c9e5ef1ebba6a9482f0eeec,114,95,2,399,114,0,05040,3
87e18fd4e8696dafe838419dac8d0d2c,237,128,4,414.75,171,66,04201,4
3cf39a982754e4af31b90731d049baae,45,38,2,157.5,45,0,05030,1
f8b119f3f330b5643b780a3a2793e95a,13,13,1,91,13,0,01026,1
c9ea4a24bd933fa8af79245461f39b52,63,63,1,441,0,63,03050,2
025aba266fd3acfc735482c5ea8bb560,52,52,1,364,52,0,01026,1
e1911460d99945933722532163de4a8a,168,87,4,294,168,0,04201,3
9b71075d34db8e4139acc31fd42c0e85,23,23,1,161,23,0,05040,1
39b8bbaea75bc201c453f150fd6a74fd,21,21,1,147,21,0,08390,1
2f986011edc801465d629e0ce9bd68d6,95,58,2,332.5,95,0,08150,3
08a7f220766355e9cec35d0482c0e821,408,158,2,1428,374,34,05030,4
f60ead1d68a242891efe932cfc87d79e,28,28,1,196,28,0,01012,1
77f7c863444d684171b6668cb1980ce5,6,6,1,42,6,0,05030,1
44f14ad797ee54de1730bdcc8108ce62,94,61,1,658,94,0,01027,3
39dc5ccaaee4558a3d3b802dfdaf3c42,25,25,1,175,25,0,05030,1
9a70a13c382a8d2ea1c14f12131478f2,33,33,1,231,0,33,05040,1
ca743b9de5973808338ae738d846c5f2,22,20,1,154,22,0,05120,1
b790a950a81d21879c1223a0d9b1c61e,286,191,6,333.6666666666667,275,11,01026,4
c15ccf444822ba3169e68b6638840388,119,78,2,416.5,1,118,05040,3
ae08a2e22c74f1e9ba54aa58ef31a34e,35,35,1,245,35,0,11040,1
9a7975723cb45e744e5e828936bc012f,9,9,1,63,9,0,01027,1
36d357fb1b439c84c52de87834624f43,332,124,5,464.8,259,73,01026,4
ed02a814e1f793a9f268aaa177e1507b,23,23,1,161,0,23,12501,1
21a2afbe3e0a03b7704ddb5c6018699d,340,137,3,793.3333333333334,303,37,01012,4
c8ea61219422ec87b3f8e6eb9fe76251,38,38,1,266,0,38,10140,1
f37cef9cdf963b394aeedab892fbbb8b,38,30,2,133,38,0,09090,1
856ffd8824c7eda8d0c78c938730726c,121,55,3,282.33333333333337,74,47,03070,3
f73bf78aecac1bf3c4cd6aa5f2523574,59,42,2,206.5,59,0,05040,1
ea15ac5fc5709967dba050210cb93d45,15,15,1,105,0,15,12670,1
390456dedecee1077da278b6f1f169df,28,28,1,196,0,28,04032,1
c1c0a789f55b639f06c24fba32dd152f,26,26,1,182,26,0,05040,1
ba560a200259692b987746d7cc0f45c1,13,13,1,91,13,0,01027,1
2c38a222910c827edd162dedd887ff33,14,14,1,98,14,0,10200,1
4e8d21dda1027e5e71a637e172dd2e30,50,35,3,116.66666666666667,35,15,09351,1
99860a280aae2fb949d45b38510303d7,282,104,2,987,172,110,05040,4
6dadcb5bbae07af3e6787ffe319ac6bd,35,34,2,122.5,25,10,05030,1
c516de92950c1a705d851d5d85848179,79,63,2,276.5,79,0,05040,2
a5b28b072ff451509065a348616d24ed,110,84,1,770,110,0,05030,3
4855776d2cd3379295282ce637ef1788,100,61,2,350,100,0,05040,3
afabfa27b314d606152d5da621cfac06,48,48,1,336,48,0,10200,1
990805171fcad38a7fabb9a58e0c0ce1,47,38,2,164.5,47,0,01085,1
db8369da64f34e9f7acc77b7a8fb111d,74,62,3,172.66666666666669,29,45,14301,2
3000bc65caeae5e7b9a0bd9ecf4b4641,155,91,3,361.6666666666667,155,0,10200,3
3d6154d342ef6e2d44ab73871d5153c1,52,52,1,364,52,0,05040,1
c9d12228d6966df577d36dd73bb9801d,146,69,4,255.5,146,0,04020,3
a0c05dff29b31edf7a56cf61aa2cc4e4,107,76,3,249.66666666666669,71,36,01013,3
b007e78a5160ef3db510aa0c5ad2ec05,54,47,3,126,33,21,01085,2
50da90f5fd090d238207b210b437535c,102,56,4,178.5,77,25,10200,3
c06e8acef77ae71fa7d9f402354f5529,34,34,1,238,34,0,01026,1
765297f1f2a7aeb7c243a7151129be7d,38,36,2,133,20,18,05041,1
80a170bfae196c66134acedaae5fce38,1,1,1,7,0,1,11182,1
a5573fda439a62c0d005f7f076fda5c2,6,6,1,42,6,0,05030,1
8af511964711d2cc16ca632831ea8f20,149,90,1,1043,0,149,01026,3
db32079945ed03eba8ca70732efd50bb,79,65,2,276.5,79,0,01012,2
5971385c603245bcf1e1384ffa0a22f9,20,20,1,140,20,0,05100,1
dfe52eb8cfd701aba659b219e47301c7,7,7,1,49,7,0,05030,1
f0ff52d076cafce16879a545fdaf4202,14,14,1,98,14,0,01026,1
81c3c79f7d1305d044f962508793bca0,381,152,5,533.4,381,0,05040,4
279ccc9213124157343a00611348c043,159,117,3,371,132,27,01026,3
4eb16d3a388910e9f306a80efacc11c3,82,54,3,191.33333333333334,82,0,05030,2
e44b90dadd992d026e1eea0233adc42c,53,53,1,371,53,0,01013,1
2485ee2e0aef0d51ac5f3380a6f3bf80,29,29,1,203,29,0,05030,1
1980acbafd412a9f35ba2da43588391a,25,25,1,175,25,0,10040,1
a71898a2131b5dc60e0ca69251c87d6c,53,53,1,371,53,0,09130,1
08aa3cb1de33a7cdfdebb0360d9227d3,102,56,2,357,2,100,01012,3
5b587bc2ccd4342f17f94d65e819fa48,59,52,2,206.5,17,42,05040,2
a06e972737db31c29ddb248c173102c6,35,20,5,49,30,5,02651,2
e50251587781f08391d037247f111d2c,251,117,5,351.4,228,23,10200,4
4e0f3dbe06dc79b99e9b4213ca405561,31,31,1,217,31,0,05030,1
27c4887646225fbe96c48492593ebc5c,79,47,2,276.5,79,0,11040,2
67c9ec0b4a33a61d845aae6d74d11aa5,47,47,1,329,47,0,05040,1
3a62ad8142c50a5c1f81f6ad4d069375,106,87,4,185.5,106,0,04201,3
c711f29bec2dc9e1ba0b882355ac3690,211,116,2,738.5,45,166,01013,4
171b48c14e660362f2d63534752216b5,246,94,2,861,246,0,05040,4
cf66efee96eb883ae418cca05266a97f,314,145,4,549.5,314,0,11100,4
d51533a99c5cd948d2747d8c32db6372,190,107,4,332.5,119,71,05041,4
c463a3de8609b74a10b652fd41c881e3,151,105,4,264.25,151,0,10200,3
513720136a4ea83d4e9e1a4fe43587ed,47,44,2,164.5,32,15,01013,1
82f67a21e55cd13b4f61e4d8f1792e96,89,69,3,207.66666666666669,54,35,03050,3
faa9a63eb3b9a96e9c72746c370732f0,153,51,4,267.75,153,0,08313,3
24452b86aba81e2dcf3b323335b96b8c,275,109,5,385,233,42,10200,4
3c55a2b029fdbe8c2fb11836cc45b0f7,133,70,4,232.75,101,32,08313,3
7ec3fffb4b11ca5c52b0d1207c7ccd2d,153,52,4,267.75,109,44,10200,3
311967be5b3c8ea21a1b397f935a28a5,20,20,1,140,20,0,01012,1
f3e843ae158f07e868cd91daf5440a60,225,92,2,787.5,56,169,05040,4
f4e61fc1b08e1366045331cd519c8afe,54,50,2,189,19,35,05040,1
f32c7b8f5cd9bc01670f07ed6ee90926,19,12,2,66.5,19,0,05030,1
2f402e79137936aa14f8f898e21978b9,29,29,1,203,29,0,05040,1
d6b3bd5c5eaeeeb4311423e8444c0e52,79,68,3,184.33333333333334,79,0,05030,3
9a35277742bfd2c5c5dc8ad0a8d9b941,96,78,3,224,96,0,01085,3
6e9d6e7010579e1aa7a6982c4215b700,54,54,1,378,54,0,05040,1
bd048a17f41d75d94358e8a9a9763076,7,5,2,24.5,7,0,05030,1
38d0fcce1bbc9beb5641111060dd7fc0,9,9,1,63,9,0,02751,1
a93455596d37501d8aa75c0ca14f6e46,76,51,2,266,76,0,09170,2
ac9771a1bdbbae881abdc1d0ca6efc6d,30,30,1,210,30,0,01012,1
d1cb2972aed8c34caee650a0deca8790,41,41,1,287,41,0,11100,1
6f765b90f55ceaad73e7c9503a7cfec6,43,39,2,150.5,23,20,05040,1
7480f012664421c11a19c504dc025dde,275,123,4,481.25,275,0,13953,4
1be17e622e2b6031bfaef940daf03afe,80,70,2,280,80,0,09170,2
5d610a1625c744c701dcd5bb7c88f692,85,63,2,297.5,85,0,10240,2
3ec4b35cb63d6871575c8d0aa052a6fd,95,83,2,332.5,47,48,10240,3
a3174a4c58301bd46dbb533f2040cccf,70,70,1,490,70,0,10200,2
f2abf3109fc7af79670599fafe4b3a8e,31,31,1,217,31,0,10200,1
7fbef81cd879a6dee56a0a6be43bde45,350,127,5,490,289,61,04060,4
48c6085cf5fe16e3b715dcf80726ab94,36,36,1,252,36,0,01012,1
d9231e26175951e643d1209d6d6fc40a,406,143,5,568.4,228,178,01026,4
1ff60b8197f4d777a001fd7182409963,9,9,1,63,9,0,12590,1
c8384c83d324d0e12353b202df0e62dc,52,47,2,182,24,28,01026,1
76f690b63a519da4b1e7e78dd8faea03,37,37,1,259,37,0,05030,1
1a12d160a1966f348753c99b94511823,27,27,1,189,27,0,01027,1
23f0da67c35d1f7e9756dfc0af392947,21,21,1,147,21,0,12500,1
c6cbadb417dbd00dab75bd2b2de792ea,98,48,5,137.2,72,26,05040,3
93d87bdb332b04399e9e2ae97829cfde,402,87,5,562.8,379,23,01026,4
e44a7707b0c72f5c0aa420a65bef4340,34,34,1,238,34,0,01013,1
82f408950f78eb491b78666bf3b0d836,100,72,2,350,100,0,05040,3
0ec83e47bd75c821b9c88299581f0c44,282,129,4,493.5,145,137,10200,4
7d129bfcd8a67b8e5fe3cc24789be679,189,128,3,441,113,76,01013,4
202a06469359213199af2cfd7ccb2ef9,161,91,3,375.6666666666667,161,0,05040,3
f6c92df57b2ceacbd33021975cd53007,79,67,3,184.33333333333334,43,36,01026,3
606a8b9901f94500259691b8934fb3eb,1,1,1,7,1,0,10420,1
a83618dce0f53f0167e66850d02eef28,18,18,1,126,18,0,11080,1
ab4700dc082d60ee02f96b16537281d8,6,6,1,42,6,0,05100,1
5db5ef94a4b22150fd009fa358438484,26,26,1,182,26,0,13875,1
b410a94cb2b78965f3ac6630ee5c34a0,96,56,2,336,96,0,05100,3
fccf15429ea200af5e3ccfda40bb4c60,81,63,2,283.5,63,18,08100,2
047c98bd94342ef927d26621ed84f0a4,139,99,4,243.25,139,0,05040,3
3634f17ed19582bb3e312e24cf34a7dd,33,33,2,115.5,33,0,02751,1
877a21866d4a3789338c56004beb8a22,9,9,1,63,9,0,11040,1
6159e262feb526e70ff37a11b01be4a0,31,24,2,108.5,15,16,09130,1
25af1efacfcde8ca896c50007422d4da,21,21,1,147,0,21,01026,1
1fec041112766ca00ba25d1d5eec4794,13,13,1,91,13,0,01026,1
4084788c80676c7c16b404254e2a1c11,6,5,2,21,6,0,05030,1
162fd53231da89518e8692ad85519508,33,33,1,231,0,33,05100,1
d2fe34fa29b9c347560c560afd8740e7,151,91,4,264.25,120,31,01026,3
acf6b1014d01c93af98a9694a6b0400c,133,86,3,310.33333333333337,80,53,01013,3
b0291f53b941632e44578c5544441407,28,28,1,196,28,0,03070,1
cae0fe1436c6bf479208d6718081a212,33,33,1,231,0,33,05040,1
5bba211d57f7912637bbc67c826e4fa0,104,87,3,242.66666666666669,104,0,01026,3
3588032e50000762c61c5d475f572b8f,50,31,2,175,50,0,09090,1
453c6eca240181efc43a28bdbf223993,19,19,1,133,19,0,01201,1
e3040121ac6d84d925cf23aa58c93493,427,143,3,996.3333333333334,200,227,04060,4
9f076bad30a66dc7e68245dfc9f111e6,236,114,2,826,198,38,05100,4
79a9b4c5619bc0bcdff4f90e54f7b4f1,112,90,3,261.33333333333337,112,0,05040,3
1951ab810520dfefeabf505a4d8cc648,140,98,3,326.6666666666667,88,52,10200,3
73fb93b6b765cf8c032e694b096710c0,58,52,3,135.33333333333334,58,0,04080,2
01e886a01b075fe1a5970e442c4e7817,88,80,2,308,88,0,03070,3
caea3ae8c90b382a1cfc4d3a18ecd533,72,36,4,126,72,0,03050,2
62f577bb5256c43372f1babb817d99e2,16,15,3,37.333333333333336,13,3,10200,1
1f73ec4d27e7214ea395893572db54dd,38,38,1,266,38,0,10200,1
aaf08c14e44a4c9278bda7f6ee64257e,41,41,1,287,41,0,05040,1
4127cf24beabe3a82cf855f8a723b4b7,186,98,3,434,186,0,05040,3
0aa208c02c06899db6ea90551ce940b8,55,43,3,128.33333333333334,37,18,09130,2
c17cf59aed289fca3878cd9013c18cd6,49,48,2,171.5,49,0,03070,1
d082781f044560d0c5fa28df296374f4,108,78,3,252,80,28,05040,3
0e1dfb5177f3b17ae334ed6957c3f0f2,72,66,2,252,72,0,05040,2
e5e9bbfdddd22131ad78a39a17547202,12,12,1,84,12,0,04032,1
c334ef961cd69ac026f3b43b94eaf33f,210,142,2,735,210,0,09130,4
1c986c561048a2a870696c36ce1a97bf,12,12,1,84,12,0,11100,1
577a8f63b8d1158bedebb67b17766d66,31,31,1,217,31,0,01085,1
d386125ac3df9642c4b4c783beb0f595,77,70,2,269.5,77,0,01201,2
2217f2fd8e12eb82ae11d4042b0d0d88,14,14,1,98,14,0,05040,1
e38b01abafba2bd1fb730f6e4cef8ca8,41,41,1,287,41,0,10200,1
d32a44aef4937709577220282e3554b6,41,41,1,287,41,0,01026,1
5e477b64c03de7b4a9d1d255a4d46dd1,104,76,2,364,104,0,04032,3
5b14e60b2b4864dca26e4ed669837e96,67,41,2,234.5,67,0,05030,1
707d7d667561310b03945a2b02b580e6,50,50,1,350,50,0,05040,1
72b0e313dfa1dfb682fded98ea3159f2,24,24,1,168,0,24,01026,1
6483d3ec4c3d47be3ae92054371f90e7,86,48,4,150.5,72,14,01026,3
60a4fce8cf30132d0079022c34adfee3,68,41,2,238,68,0,05040,2
a6be9b61e19a6efb2a9a1b14f2e85af7,1,1,1,7,1,0,10040,1
2863fe077e4504e491fb4b325ad17cb1,200,112,4,350,200,0,01026,4
dde782e0bf8db10a8e602675b6e3a639,129,66,2,451.5,129,0,01013,3
94ed33dcfcd284703f7aab89fc25ba35,309,149,5,432.59999999999997,309,0,11040,4
87ecda236600d07caf97a5236d3d8f99,28,18,2,98,28,0,10080,1
5924067678c74b9c8cca1e391ca9d0e8,63,47,2,220.5,37,26,05040,2
abba3d101bfc502b7f279069e202304f,32,31,2,112,1,31,05030,1
0533dacbadf7b4b2379e76628bcbae66,285,105,6,332.5,248,37,01013,4
fd5a90f7b6cdab4bbc91eb3d0a0285c6,423,146,3,987,385,38,01012,4
ff22a726f073731281f69d76370c0abc,123,77,3,287,93,30,05040,3
c667c71afe537b813e9035debf13af40,38,37,2,133,38,0,09090,1
1d742e45d6216aeef8f667eb13927977,199,112,5,278.59999999999997,199,0,05040,4
bf337a8bb45cacdb4ca839d13eefd995,190,89,2,665,158,32,10200,3
8d2806f30673b54fad5c46b732cd4d9b,47,39,1,329,47,0,05041,1
bd50ee2c0e76850d08e40b4a7405f70a,30,30,1,210,30,0,01012,1
dbe41c10a8e4611daca1c8a8cbb09060,36,36,1,252,36,0,09130,1
5d4de7e590bd2cb0593388612c463c69,198,81,4,346.5,77,121,05041,4
52c9254c85604ca2799679470bfc7a3f,71,52,2,248.5,71,0,04060,2
1c149879c3f68434c25803c5e76fa533,251,119,4,439.25,194,57,05040,4
b490cb9177a0803f5c43c3f29784a764,10,10,1,70,10,0,11060,1
b4aaefde0b700c0ac991e1c174a7af14,27,22,2,94.5,27,0,11040,1
f56bebcf077db1130ad8073f8e0a59d1,22,22,1,154,22,0,10200,1
c9c521e5fadba91e1b974b0636457e03,101,64,2,353.5,101,0,01012,3
47ff518a10e91fb1db4094b76c2c34ce,38,20,2,133,38,0,13830,1
d543f825020b4ce143d2fd75c8a814ca,96,55,4,168,78,18,05040,3
3e9eb71230a2c3ca5a87b312dd9f0026,21,21,1,147,21,0,02651,1
9bbf281c0dbc0221b2887b554e3e038b,30,30,1,210,30,0,13490,1
595ca181536c808774724a591bd7010a,27,27,1,189,27,0,08312,1
8212fef7b2a41e1ad7d22d7e0eb4d7fc,106,91,2,371,106,0,01201,3
ed6193e8864689b3db4252acc1590aa8,433,106,3,1010.3333333333334,433,0,01027,4
84821bb814e55f37334a9bbd5a06290e,28,28,1,196,28,0,01026,1
802fcf894fbcbace19702e9b128a8096,42,42,1,294,42,0,02650,1
c1ddb5fe1bf0de81646e7493396297a0,45,25,2,157.5,45,0,11103,1
4e4249a35551a83ffb5db890601a7b80,42,42,1,294,42,0,10240,1
5706e33640bbda8193eaae7877594881,112,78,2,392,50,62,08051,3
c787c25183417fd11961885d8e723c21,37,37,1,259,37,0,03050,1
73fb812152b54439077b726d5a66f648,189,118,3,441,133,56,03070,4
1290c9ecf5f65b0d2adf3fd783d46ead,140,105,3,326.6666666666667,98,42,01085,3
6927a022f9c9cc8bf286d59049b6ee11,9,9,1,63,9,0,12670,1
6c8b4d221846987bdadb7f759272f40e,217,125,4,379.75,153,64,05040,4
3acdf90458465de57eac1615d47de5f4,9,9,1,63,9,0,04020,1
5435e7c559c1611a6c24f619de1d2acd,18,18,1,126,18,0,03050,1
ed356eaa8dc1667af1db105a82db35f0,35,33,2,122.5,35,0,09090,1
7a1da8ed2caabd450438fa3508fd57e1,18,18,1,126,18,0,10200,1
99fe40d453a967b78993370d511afd84,37,37,1,259,37,0,09030,1
f9113b15bc27ce5e2a8e1e7c7fb5ce7c,158,76,6,184.33333333333334,136,22,05041,3
8be3e76a8e03c7edbe93120fba2ed882,80,65,1,560,80,0,01012,3
c97a1688e3c576c7c456fbe72add1856,33,29,2,115.5,33,0,05040,1
66bd40a6c9078026387e729aee8785bc,5,5,1,35,5,0,05030,1
6d14e27676f85220db6c089ccc99c533,22,22,1,154,0,22,09130,1
d3929b66f4f2d299b5c50690106f0be8,177,127,4,309.75,161,16,02650,4
c694a02efdf1f547f44c07f3c201fe7e,19,19,1,133,19,0,09071,1
7b87a3bef39e2e21bcbc7949cdd80e01,200,100,2,700,113,87,01026,4
f0f70b128effef7617e9fdad8a6e90c3,533,110,3,1243.6666666666667,533,0,01012,4
1fe6de7deb0d5295e32f6b814ca6f79f,171,89,4,299.25,153,18,01013,3
e6fab94cbb46827b02a2d1e2f3f90ab6,45,36,3,105,45,0,05030,1
d10721282193644863a791c48e9702a6,241,138,5,337.4,241,0,01012,4
4c56febd29a8c0127f5e40d54ac58bbd,144,106,3,336,106,38,01012,3
8357da95cebe8eaeb93f7f9159bb6fa8,57,46,2,199.5,23,34,05040,1
ad3d0cc5308ccf9c5f322d6c516097dc,14,14,1,98,14,0,01016,1
75fd1c2c6b9271a583662236d048b4d9,73,56,2,255.5,33,40,01201,2
61b835eb6c70c88ab1e46dba3f95ed92,588,191,3,1372,548,40,01012,4
5caa12abad1184844ac45392972e8a7b,152,107,3,354.6666666666667,152,0,01026,3
ad963b4ba603df3a5cc6fbc1be108f62,125,63,4,218.75,125,0,05040,3
6c3ec2b4a06ed6916166c14395951042,104,83,1,728,104,0,09110,3
19ccbd5279689128be89979247466c39,10,10,1,70,10,0,01026,1
ac811be2c0f0fa55a626ba9604eaf3f5,143,90,4,250.25,125,18,05040,3
69103ff25701af685119ffa083e21ca5,124,82,4,217,101,23,01012,3
ab57133c8abf0dae413b8a5d505ab527,19,19,1,133,19,0,05100,1
77f63bbdb514bd951f437eac6c25d565,282,153,4,493.5,282,0,08314,4
8496e2bf58821942ab0296ac0f00330b,390,149,3,910,390,0,01012,4
178da0d12c2c0da60f7bcef863bf6fb7,12,12,1,84,12,0,08100,1
8e0c9605e9e7e476791a7acacaff3043,122,82,4,213.5,122,0,10200,3
a013c984b0046a1f8bb36852fe1c1e96,120,79,3,280,82,38,01027,3
c25aaa5db99a39e64aee6c7926598468,50,32,4,87.5,42,8,05030,2
a28f00fac82424ccfd4595d3d1c04a8f,17,17,1,119,17,0,10200,1
ee282918eba6f79c5cc706e12fda7c88,31,31,1,217,31,0,01026,1
4213719a7e34b732ba3d5d961fa60d12,106,60,1,742,106,0,05040,3
c55da05d8fd00eecda379a213afca445,18,18,1,126,18,0,05040,1
0853d14a183916c04d87e04028ca529a,37,37,1,259,37,0,05040,1
7e30a48e4962c16cd4e2ce6a81cbedf8,13,13,1,91,13,0,08032,1
8f1da177b2013b83c3d04d889bd7a576,22,22,1,154,0,22,01012,1
cbb47599e4753ba3fab9ace4fb84442b,81,46,2,283.5,45,36,10153,2
055a89b4b97ef6040cdf815d611b7799,34,34,1,238,34,0,05030,1
11ca95ff8a5403efc08dd347fe509696,49,28,3,114.33333333333334,49,0,05030,1
36eaf2b64ea2042e9a2478820d16d3b0,148,106,2,518,148,0,01027,3
9669701b1381936534e36ed5d14062a1,21,21,1,147,21,0,08390,1
a130c48a3da546cd0541b830846f91d3,16,16,1,112,16,0,12501,1
167c569d22c704ea528239c6e5200cd0,106,73,3,247.33333333333334,106,0,10200,3
810b0e40d5a3c1105ae791043963075c,331,152,5,463.4,331,0,01026,4
337eeec06751e70529d8d19f1943e6a6,177,85,4,309.75,177,0,01027,3
739893e9071206c85ce48891f281fb61,56,56,1,392,0,56,05100,2
cf7f173be5cf89a027cda696af920301,33,33,1,231,0,33,05040,1
99cb6dde9751280b29573255debf34dd,125,67,4,218.75,106,19,03070,3
81fafaf88be7e5210bedfcf80cfd2cc6,55,55,1,385,55,0,08314,1
844b5efaea28c40a972b058073bd03bc,47,41,2,164.5,47,0,11100,1
c91b26f1bdb99047d3915d203dd152de,45,45,1,315,45,0,03090,1
9bcb966488668e7b428e482a76ac957a,47,47,1,329,47,0,10240,1
f9c7bb29f9d1842bea7c8d6c16a17791,70,60,2,245,36,34,10200,2
a06780df4f8007e76ec39907adb0ea33,61,49,2,213.5,61,0,01012,1
5e30b7a540c4fa0e7320b1dedecc7959,69,25,3,161,69,0,09071,1
26fd51513d44be1adca3f1358aa0098d,63,63,1,441,63,0,09130,2
980af513cf37c7e02fc2b11da7d0f1bb,13,12,1,91,13,0,09150,1
500a2ecf07b2df7178d171245916e8f0,7,7,1,49,7,0,11040,1
da0a7ec7ccde425f82fe5ce4ad3ffc04,174,131,3,406,100,74,04032,4
e6e4517f509c130639fd654d2d670c56,2,2,1,14,2,0,11160,1
8b4c879548ecb83fa87aa65b32719d61,241,80,4,421.75,193,48,01012,4
f682e4f3eff2546ca9344b05f2bcae11,78,68,2,273,35,43,04020,2
90c0a5d3fca1ad29bc49de40e94a346b,29,29,1,203,29,0,10200,1
89910575c43faf51304bfb2a764d9064,31,27,2,108.5,31,0,08032,1
a0d035dd066da1157e04db0965c6b54e,9,9,1,63,9,0,05041,1
5e8bfe607a440b7c48f8ef965af7a193,42,36,3,98,2,40,11080,1
cf1feebced2e92380c0933452b563920,22,14,1,154,22,0,05030,1
22cdf7e1531ee0f1ee292484755c6cbe,28,26,2,98,28,0,01026,1
91ce1364a6fde2454ed8924ec7829aa8,335,109,6,390.83333333333337,295,40,04020,4
cb65dd2e9736b676f630c5a424d4b6bc,35,35,1,245,35,0,01012,1
72275c108bff1d33d169274b357d3b36,22,22,1,154,22,0,01013,1
9b4255767b1ac49a0e45958c36cfa0cb,172,122,6,200.66666666666669,117,55,05200,4
92accae169eea4da51dd34b77a688008,49,49,1,343,49,0,01026,1
6e35fdd2050adab126498c76532d3b84,32,27,2,112,32,0,05030,1
4368931659973bcc01129eb8129159c5,21,21,1,147,21,0,09130,1
c28f45fa75ae3d944772ea1ca21be227,95,76,2,332.5,95,0,01012,3
70fab0c971edff3754077f5521c429a7,314,150,4,549.5,279,35,01013,4
fe7ed7e487312dcab5eef5bdd73d353d,59,59,1,413,59,0,08100,2
4753f5ad2531526ea96104fb8b165cff,50,50,1,350,50,0,05040,1
6c0deb4514a6f1a0875af95d3e86f2d9,5,3,2,17.5,5,0,05030,1
aa88184fc4765b189c4fec7ee9db8ea4,91,68,3,212.33333333333334,91,0,09170,3
a24e4e46d2d0984b912a0049b77f8056,66,61,2,231,66,0,05040,2
7d7185330f6fabbcb621fd8dfcf48cde,364,132,5,509.59999999999997,337,27,08313,4
2278bf68d9f372c81677646601ee2f03,130,93,3,303.33333333333337,93,37,05100,3
8bf69067c1b7224653b7e068fb775442,30,30,1,210,30,0,05030,1
654a20ed540b54cbe802ee60051ab162,44,44,1,308,44,0,04060,1
8bea9f3938330780bc7596255bd9b3a0,5,4,2,17.5,5,0,10180,1
fddeea7b3614c9f989b475340f39d69d,1,1,1,7,1,0,05200,1
db60c407099abfd6ae58119ee4fe654a,58,34,3,135.33333333333334,58,0,05041,1
ba5dbc15dd2f0cea9ee7d1cd6f967587,83,57,1,581,83,0,01026,2
db81541beb578b33de334d4510c6fbe3,62,62,1,434,0,62,05040,2
01d218aadad730fa56a7ce1d483ea8a1,92,46,2,322,92,0,05040,2
16e21ca05f18777beb8e643f415844c1,81,67,2,283.5,43,38,02620,2
afff10ee30a0ae678f4464a64f6be920,40,40,1,280,40,0,01085,1
10bc9febbed09713ff63dfe606b04ce6,452,141,5,632.8,378,74,01027,4
0a9945a3ef751034f1eef69637efa293,34,34,1,238,34,0,10153,1
05fd6b404b07daa045f37e8e58e1f051,63,39,2,220.5,63,0,01085,1
067abe0ef683b5a531ec7f91a2cd0af8,36,36,1,252,36,0,05030,1
23af7589fa30170d5a507ced200a4933,166,101,2,581,166,0,11100,3
390cddf1ecc458807d86d168cba17128,4,4,1,28,4,0,11080,1
a832f0b6c38b49784871b3ce0094360f,26,26,1,182,26,0,03050,1
dcd174539e18a5e91bc8ef53c334758d,38,32,2,133,38,0,05030,1
af5d79ca3337f107694e9b7fd397f457,16,16,1,112,16,0,11140,1
771c17dedae7f1aa93e4d23806ec7a41,98,76,3,228.66666666666669,65,33,01026,3
288f924adb3087c2c63f361c28df691a,33,33,1,231,33,0,01026,1
d2d453303b549e2ca3ce39d8a16f852b,212,122,3,494.6666666666667,127,85,04060,4
d4fcae8521721ea763fa486ab6c5d365,532,207,6,620.6666666666667,382,150,01013,4
07801da90d98d751bd9049ecef90235c,72,34,4,126,72,0,05030,2
5822dc81387492cf0ccaeb8e9fff1f78,21,21,1,147,21,0,05040,1
c157995f9e1ab60a935c52529532f84a,350,154,1,2450,350,0,02650,4
a13da9ac9d21b73c9ddbf830809950c2,20,20,1,140,20,0,01026,1
4e6fc1514378f886739e848a78b7a808,287,118,2,1004.5,233,54,01013,4
6a18c39522a75045b9879a57f243ab0f,110,67,2,385,72,38,04080,3
25574a376c67be517e54e56ae57b8358,53,53,1,371,53,0,09130,1
b72969dffb4d4435cb4e079e5ade1558,36,36,1,252,36,0,04201,1
b8cd5ba10a0acab16df6f52e46d4630d,261,110,4,456.75,243,18,01013,4
93d561fbbf7c631949c1f8f5b69e4246,18,15,2,63,6,12,11040,1
c85bdb2807537073d5ed70ab2f93306d,335,131,5,469,281,54,01201,4
d81f7ab39c87be15325a0a38f439de3f,389,120,5,544.6,307,82,11080,4
5fbb7ce834e132c9da0682e8ce2de280,68,50,3,158.66666666666669,43,25,05100,2
224249b894607f5d5eaa46dfb535000d,276,141,4,483,276,0,01026,4
bac165b317bc3cb770274175b3749379,23,23,1,161,23,0,08010,1
92784948325c30aa386b6206fcd7e941,21,21,1,147,21,0,02651,1
c5a9abc07a9479b1efbee5fbefb16275,214,127,2,749,54,160,09111,4
e335e831f77df1d4208cb1eef14519c1,75,60,1,525,0,75,11100,2
cc489fab599837fc7e407af54dfc6bdb,155,103,4,271.25,155,0,01026,3
29284b496a081e3a2f4c55bc8d05a7f6,158,119,2,553,76,82,09150,3
73beb6eb15f79a67fbe626626da19936,14,9,2,49,14,0,05030,1
f4efd3749778bc3fe16ac63b4321f959,79,61,3,184.33333333333334,39,40,05030,3
1c5ea3774b29c9b602c065a34dfd06de,11,11,1,77,11,0,11040,1
29d4d307ae0271400b313eae5341f35d,15,15,1,105,15,0,08010,1
6131aab2b91e5c890bff8a7c964380e2,33,31,1,231,33,0,01201,1
756d054eda566e53f90f44ff64f01a8c,39,39,1,273,39,0,05040,1
b4c898c8e428f98c4112f1f64d457a15,193,89,3,450.33333333333337,102,91,05040,3
5b7bc72780bfbf85a042c303ca2a3842,116,75,1,812,116,0,01085,3
df76da6cbc5e640b8de30bcafdcaf1a7,8,4,2,28,8,0,05030,1
fa56c73f98f1d743a1d3de86dac9ad91,84,66,2,294,84,0,02650,2
44a0372834718ed7851d2d06ec5eaa52,13,13,1,91,13,0,05040,1
58f709a8e5b474375c10575115638a08,44,39,3,102.66666666666667,32,12,05100,1
c1a282618c534c669d033269682283c1,63,51,2,220.5,63,0,05030,2
ffaf8689d788e65d2e2b0e78a0f369e2,106,88,1,742,106,0,01026,3
bae51b1a5eb1c4f7324d37c0cb3a5039,13,13,1,91,0,13,09150,1
381b76c25612b0a1d59114bef8ee238c,88,70,2,308,20,68,05040,3
bf744993a429771cc5454e26f64d235d,12,12,1,84,12,0,12590,1
ddcf330d2e95bf376d9b793eae837dc5,99,88,2,346.5,99,0,05040,3
3f8141cbb6c52231b030d23463a80a70,27,27,1,189,27,0,05030,1
3771ad32645026c73450abd9b34b5664,99,70,4,173.25,99,0,05040,3
f57c19256b94a79b9273781c6ba6c7d0,44,29,2,154,44,0,04200,1
bd82880dedda4009b4932a8c4e108a1c,101,65,3,235.66666666666669,62,39,01012,3
68854abc16430a88726d7daedf0fd475,43,38,2,150.5,43,0,08100,1
58a610824bf01e9524f8ea2603bc938a,29,29,1,203,0,29,01026,1
20ba5a4f55cca1b4d37c1d6baf4e4726,64,48,2,224,64,0,11100,2
28b43ecfb70e045dfb31ee43f27ad897,58,58,1,406,58,0,05040,2
60bced5a0fa0b0618806cc52d52051ee,1,1,1,7,1,0,13930,1
6e875678a396b5df7b97536f1c3cc27b,1,1,1,7,1,0,09170,1
756193738997a8fb3d5f8741a2ab0888,199,82,3,464.33333333333337,167,32,05100,3
2f043689b0492adf6bfe2d882e20ea80,244,116,4,427,244,0,11040,4
daf1c1ce83cb96e27ed2ecd1aa222cfc,30,30,1,210,30,0,08100,1
2361d26a5375783609f33733c051bedc,894,215,2,3129,894,0,01013,4
8c0bc529d9d67c7db9b1e60275fd5871,22,22,1,154,22,0,01012,1
1d9f26a9215ef3da42198d2371d0de98,194,85,3,452.6666666666667,194,0,05040,3
b640396903fef601b83e1e1cbecc1bcb,32,32,1,224,32,0,05040,1
b2336770b73583fb25432617abaf8f59,7,7,1,49,7,0,05030,1
56c3918f82f7cab1131d8a11667fa1ed,122,74,2,427,90,32,05160,3
5a3db0669282dfa43bc797de15c13fd9,28,28,1,196,28,0,01026,1
c2d7fe36a8eac3a5af16b95fec2fcf6f,130,76,2,455,130,0,08052,3
fca393262d60a987e1711827d3c61006,16,11,2,56,16,0,11040,1
1fe16dada92f61a2d4560ef0f53ba4f4,11,11,1,77,11,0,12610,1
3f8612c763dd3f3e5d4af0c48fcd3948,228,104,5,319.2,190,38,01012,4
e160a36e173f4ce711feaafa5903a957,42,42,1,294,42,0,03050,1
09d9a6c9dc4f5515294749d4afa1ee1f,38,29,3,88.66666666666667,26,12,05040,1
199410d64063a0f5e1335c7b7a49695c,45,45,1,315,45,0,13830,1
fd71b77653d63b1e124f1ecf60f37e4f,137,89,3,319.6666666666667,93,44,05030,3
2041195a17f2857f754e2791c5508860,60,43,2,210,60,0,11100,1
4ffcf3a0c3ef72d55b81701bdf36405e,66,57,2,231,66,0,08313,2
9588a8d0d35e006d8b7fe86c06affaaa,91,79,3,212.33333333333334,52,39,10220,3
613cd6c014e51ab284c621578db05d8b,10,10,1,70,10,0,05200,1
3e71a9bc352b5298e1639a5502d887b6,619,229,6,722.1666666666667,436,183,10200,4
318763821da55546958ff9f6f2c82ec4,149,106,4,260.75,149,0,01012,3
68070ac77db8e5ce658498d3b8b26cea,72,44,2,252,72,0,01026,2
04b78cb35e7543fea63c8ba60009cdde,26,26,1,182,26,0,09130,1
feada3425bf74df46bc622170c9694d2,33,28,3,77,33,0,03050,1
c7676054eace88a1887ffcf40b74a2c3,37,37,1,259,37,0,09090,1
f53a1d689689eb1baa45557dc71078d9,7,7,1,49,7,0,08010,1
e7db816a23cf3a6a38104a2f2cce9fd8,300,128,6,350,225,75,05030,4
6618a47bf14dc5f72f8f87ad1d5246a9,84,59,3,196,58,26,01013,3
c4027404bd5ab672e66b0ff6dc730f81,59,46,3,137.66666666666669,59,0,08052,2
5f248f845b5b236c2432d5448281b3eb,29,29,1,203,29,0,01013,1
5b8f37ab8e74a7866e6cc8dd9694b6e5,271,118,3,632.3333333333334,237,34,10200,4
38c0d036731061d73a5996e5a4ea9152,105,72,2,367.5,105,0,01026,3
cd16fc991e521b307f1b5b7ec6d5fe46,607,160,3,1416.3333333333335,154,453,05040,4
b37849ab950d96f9efbbeacb04a053b1,23,23,1,161,23,0,03050,1
313b77160398a02d453d0ef22f10aabe,102,68,2,357,16,86,01027,3
2b0a7d7ac5c1adc3a2764278c4e96e0a,106,84,2,371,50,56,01085,3
058e175d70283defd075c629174d72eb,17,17,1,119,17,0,01013,1
5cab5702f816c98a3e39b905313516de,107,62,3,249.66666666666669,26,81,05040,3
df31812ca322fc901123766c5b361a2d,167,69,3,389.6666666666667,118,49,10200,3
1e1f1833680c23656c9c294201ba597b,111,85,2,388.5,111,0,01013,3
011d9b8ea48c6e103aabed4a86b4598d,83,55,2,290.5,83,0,10153,2
726a46b9f501a23a37d79d95a24ca721,87,56,3,203,87,0,05040,3
92eea334889b87fb30f7aec2e9457499,25,25,1,175,0,25,03050,1
3e6de8847bdb63d5a9173220de20ad78,149,103,4,260.75,149,0,01027,3
a5941e2fb1ea658d4e694f436a40a070,46,38,2,161,46,0,11100,1
12cd6f9dcb60cdd6d5cc9c54e2b67a8f,26,26,1,182,26,0,10200,1
5030e3e09c9435be5a382826afa6ec04,34,34,1,238,34,0,05100,1
d476d2c7dc91c6525bf0753bc30aadd8,29,29,1,203,29,0,01085,1
0d7f113b992ac52401513dbccad0ab4a,190,117,2,665,1,189,01026,4
137ffaeee2f4dfa3fa4f156e98fb0fd4,202,127,3,471.33333333333337,158,44,05100,4
4c179e7048a2e576a6a9e7926d193ae7,91,74,2,318.5,91,0,04031,3
b81f8381929ec837ebca59ede41b5f69,81,61,2,283.5,81,0,09010,2
008c694c2477e1a38083c6253f573756,114,78,1,798,114,0,05030,3
73afa6c82af504da57effb614d63525b,30,30,1,210,0,30,14301,1
88f3fdca64afbc8a56d484818340d11a,39,39,1,273,39,0,09130,1
12ef520a3f078f5d770cd1cbe2145a91,16,16,1,112,16,0,13930,1
eeedb046f1c284f34148dd1733102b61,22,22,1,154,22,0,01026,1
ab1275b3c8977c27b4a6f979b8b4182f,27,27,1,189,27,0,09130,1
60f8c9f28d21f435e74a3ca9f0434db6,19,13,2,66.5,19,0,10080,1
49cf570a6b386f0e90f75c555db1f271,23,23,1,161,23,0,12590,1
4f3c7c28e3fd8abd3a2a9fbd28403b4d,68,60,2,238,68,0,10040,2
e7b3fb0c28e40fd01a661445a9870be7,62,62,1,434,62,0,11100,2
75606dbf99c38f67eaff4a3e07ab02f4,122,77,2,427,27,95,05040,3
4d4c7f692b2a854fe1cc3a837844b957,8,8,1,56,0,8,11100,1
d84fe5e44ac987118a0713c00c7c36bd,158,104,2,553,158,0,01012,3
647bd11f7364a403cfc11e58d33b8074,15,15,1,105,15,0,01027,1
a11019c8be78ac672b2c8eff7ae175b4,65,58,1,455,65,0,11140,2
616cd537b23e82ebcc4b023010dd8c08,48,48,1,336,48,0,01026,1
11e93838fd13bf269e4aee4a90ae1dd3,79,40,2,276.5,79,0,05030,2
f2603ec6df697ef2d6cc78a4c9a003c2,24,24,1,168,24,0,03050,1
27adf1316d30f75f95733b7e00910293,10,10,1,70,0,10,08230,1
94d3957f6772f8a1bd6f5f255963453e,305,117,3,711.6666666666667,305,0,01201,4
5ac805cb6f484949f70eef5e2e5fbb90,19,19,1,133,0,19,05030,1
3201f06a0032b05332bd2eb7b3ac9724,6,6,1,42,6,0,05030,1
f6e2617ccae11c83ac11c67078d52442,291,119,6,339.5,260,31,01026,4
4d0e2de1c77c5a8dc2bde9b2b7081462,329,157,4,575.75,329,0,05040,4
a8653c3891d130a5df537ccead1b140b,287,141,3,669.6666666666667,287,0,01026,4
360d55415c2b3ddad67e2d88ba08b355,424,159,6,494.6666666666667,367,57,01026,4
dcd23fc00a6a1ded5fcc92c5a8a499fc,60,60,1,420,60,0,10200,2
acc907802574c534df834b8d477aa817,33,33,1,231,33,0,01012,1
77a32c4f3488e0328d8ee1917e9a889b,91,68,2,318.5,24,67,01026,3
8491ce752c0160c82e292d8daf654eba,16,16,1,112,16,0,05030,1
dc05524d79ad79939727b6b7579539cd,148,101,4,259,148,0,05040,3
f5e75f06460256975b6d634d4753f542,22,22,1,154,22,0,04020,1
2a9aa9369841c9185acdd72d4bfa620e,27,27,1,189,27,0,10200,1
177323a01139a8432a9f14bf1d3c7c6a,179,106,3,417.6666666666667,81,98,05040,3
54916a541e248f07b27ae4049315da18,76,57,2,266,31,45,01012,2
cdbd2a01fa5f74f8c2f107327515fce4,9,9,1,63,9,0,11040,1
1b0936b2bc8600247e3b990c72edab63,73,60,1,511,73,0,04060,2
00e1c9eb4bf398d3c79b3c2161902c9f,40,40,1,280,40,0,09130,1
83db06be5ca010ca2a99b7eb2a9d49d3,180,85,5,252,158,22,01026,3
09c67f8363d22c46ff8cde21c64b2629,143,72,1,1001,143,0,10200,3
c037a316cb6f3380d9a88b0c81d4f4f8,205,160,4,358.75,139,66,01085,4
78bec50478dffb0d5da5d58511354d9a,20,20,1,140,0,20,01026,1
e5f489bd298a1a5ae11a4f025e6d7ace,39,39,1,273,0,39,01026,1
127e992af2e66ff5994ff5ad91a96814,4,3,2,14,4,0,05030,1
648d8a8bfb7366b1e8d42e77e29cdd81,94,65,3,219.33333333333334,94,0,02691,3
1fbf2adf49bc35f3f91caa4412e99786,166,81,2,581,166,0,05040,3
93a45d5554e20d3b413123555017af06,43,43,1,301,43,0,02650,1
ed356c9d9f0e66ce5371c528088fc0fb,86,70,2,301,86,0,10200,3
82c05596bc211a3a3299a370d12b9110,165,94,3,385,165,0,14301,3
48d45b27a50ef4db2930ef659fbbc51f,56,46,1,392,0,56,12470,1
3d88cb2c17aa329f2ddf950ca105a695,19,19,1,133,0,19,13820,1
e21531ee7e19260f1aed65e5f8cd35bc,194,87,3,452.6666666666667,67,127,11100,4
c83180aaf20c3bbbc876c363d6b36897,16,4,3,37.333333333333336,16,0,05030,1
17f8510b0953a648c66a89e59714de10,23,23,1,161,0,23,01026,1
a05ca071fa407a94163fc935591ed187,74,61,2,259,48,26,03050,2
b93f1d6be2d43f28fe400f0cbad9073b,148,106,2,518,52,96,08314,3
6b0ad2594b3cc5046b7dadf33a3a9ace,71,62,2,248.5,71,0,05030,2
f9fa7eb7908fefb6d4dfc99c1f247e36,47,39,3,109.66666666666667,30,17,01085,1
68059ad5e9a413721ccbda4dc1da2bec,62,53,1,434,62,0,02690,2
0d4b43e04b728e9aa68a5addfb644cd1,27,27,1,189,27,0,09130,1
9d1b38eaae048366fe13055aeb3e5caf,19,18,2,66.5,19,0,01026,1
659d9f0570210d53cd7dca1093b26c5a,27,27,1,189,27,0,05040,1
4f6bd86bc7f00b00c0f1770c80dff64a,35,35,1,245,35,0,05030,1
ce63858ab3f1a1e6238de043f23bf882,39,16,2,136.5,29,10,09010,1
ba9668084b63dfcc96f0b5760d897d25,63,49,3,147,33,30,05030,2
e55110e7fad881353534bf35359a76f8,109,77,2,381.5,109,0,10200,3
6f9d0edfe0661abb6ed991e33c9f1dc2,31,31,1,217,0,31,05030,1
cc078e87b35a45729e916a2c1717ae21,151,121,3,352.33333333333337,151,0,05041,3
a3b9cb7773ec050524d18f7a14009661,18,18,1,126,18,0,08010,1
fc1c6b7596af5f8b1165687fa614d760,138,80,2,483,138,0,05040,3
8421a7d50ad9109fdf1f1e0f35b39867,24,24,1,168,24,0,03070,1
3533f079d89fb596f2e62b3a9debedff,160,124,2,560,160,0,04060,3
f2072c0363de8b58fa3889905bcc307f,76,70,3,177.33333333333334,58,18,01012,3
1ae3df0d1ff3680b314e095460c60663,102,89,3,238,102,0,10200,3
cbe22624a2112ba16d11b5e346aa4f8d,35,29,2,122.5,35,0,05030,1
33ade7b3b85b4879537eea4a0ba038f8,69,59,3,161,54,15,01026,2
160269c8b76a6049be82c4c2c1ecfb97,227,108,2,794.5,118,109,01012,4
d4d192dcd956b2e97e59d594d94b9536,20,20,1,140,20,0,05040,1
9a3fe631e929780156b7bf01ef103543,56,45,2,196,56,0,01012,1
4cc691099f5e2948e62d49ca29657728,185,88,4,323.75,160,25,01012,3
ed02dabfe082f64bc89c027a4bef1307,41,41,1,287,41,0,10200,1
0d4074a5ec2c00757ade0cf873750251,8,8,1,56,8,0,11040,1
847f86b1c2354ee579524b486e15ee08,59,50,2,206.5,59,0,03070,1
6ca01fdcbc2044bb286d709bd4837d8e,91,62,1,637,91,0,05040,3
a8193680ffffafced2d55174f442b842,24,24,1,168,24,0,09030,1
abe8ee152566f3cb8eae59cf2dbbb06f,138,78,2,483,138,0,03070,3
3835cf8b550f4bc69c96b10cd10c9a46,93,63,2,325.5,93,0,09130,3
1efd1a50df594b5db4b0331e11304aa2,62,50,2,217,18,44,05040,2
c58d169927354d5afd03c908a5e72b12,114,86,3,266,114,0,10200,3
c9dfa895f3f38b2792f44ee86a71cad0,66,58,2,231,66,0,01026,2
a00eeec275af2d6f1cd44ee9be84fe11,42,42,1,294,42,0,11100,1
20e4426d028a7e036b3bc92fcbd8d735,174,88,4,304.5,151,23,08100,3
fe95c3f87ae0420681464ce78e97a8cd,23,22,2,80.5,23,0,08230,1
c7384dac3ff1d29d09e271353af3c53b,189,94,3,441,98,91,05030,3
b1afc394db308b46f4823ef2442c4d0f,92,57,3,214.66666666666669,92,0,06120,3
ba21ad4bb5940a25ae1d51469a4f5878,189,113,2,661.5,189,0,12670,4
5e0d56d2523c564e1d007f30a019bc6b,501,102,3,1169,427,74,12500,4
ec0e31d22a965ef9a509dc1fbdacb2d9,135,94,1,945,135,0,01026,3
f4dcb1c6302c561516d7e8a8103c8146,63,41,1,441,63,0,01026,1
e424b5117490fbbbd60114f4ef1ef006,17,17,1,119,17,0,05040,1
638adb3ee3a68db08b2bd7e3c8e4cd6b,112,87,1,784,112,0,05040,3
1d26b8d52ae01109029040d9531db99c,78,70,2,273,78,0,05040,2
d219c599c97048a72bcecd3aac26f4c5,26,26,1,182,26,0,05030,1
3718785099fa43d202e8762bb676ecd0,75,75,1,525,0,75,09351,3
e25073742f0f271eab9adcbccd440f94,222,110,4,388.5,112,110,01027,4
f857321d9504c0648f669337359c8620,28,28,1,196,28,0,05040,1
25eef44da61b7d7e661130c8e970aae4,47,36,1,329,47,0,13930,1
5ed3437a0e91b8bfb6ad1c3a25907b6d,30,30,1,210,30,0,09130,1
b2fb1cbe0641d512ad9488fe51cf9668,183,114,6,213.5,98,85,02610,4
cd3b073254f85b20a2a401a60666eb38,98,70,2,343,53,45,05100,3
c42951eb496ff27dfc9beaa8ec1dc173,37,32,2,129.5,37,0,10200,1
d26b68c6c98718aa7f4ee48745a084bc,41,41,1,287,41,0,05040,1
5b61c1303a325b08b72cb1c61fce90d0,36,36,1,252,0,36,08231,1
29a0cd208a872f6cab46eb9df772c905,150,49,6,175,128,22,01026,3
1d75f602693e8481dcf30007bba714c9,26,26,1,182,26,0,01012,1
8a97c3dd9c66e596d8973fd9f1957534,339,127,2,1186.5,181,158,01027,4
a5889d7cf87f3d492956dc164f84c971,356,145,6,415.33333333333337,313,43,05040,4
33fa7f62095ea4de0a3c1e12bdf2d28a,234,109,2,819,171,63,05040,4
dfb9e86bde5e73aaf1320fc5f397650b,426,93,4,745.5,109,317,04020,4
de61a892f8c1a10bad31f45d06d3f923,85,64,3,198.33333333333334,57,28,01012,3
63b4665567e30e4e9fe5f03cbd5cbdf2,37,37,1,259,37,0,01027,1
3af5ac584e8a563596175bb475112819,77,57,2,269.5,77,0,01027,2
0d77606fc36c6584fc6453e9a84a9461,36,29,2,126,36,0,11100,1
79a211b9bb2ab8424889f9afea075de4,72,60,1,504,72,0,01013,2
c3cd16bdb9c40e438aa351922c61a397,295,144,2,1032.5,295,0,05040,4
08eafdbc19a6d842a20d67392f335926,18,18,1,126,18,0,08100,1
e4a331ee5429fea628d9b5156c38cb22,42,41,2,147,42,0,01012,1
3189de7be9e4a3d99d766db5105d0016,127,80,3,296.33333333333337,127,0,11100,3
91ee2a281a608c8af6b2d494e36327d3,26,26,1,182,26,0,01012,1
fe35b0da5004c1adccbb8be8b8daaa34,74,57,2,259,74,0,09351,2
42f3a8ad545ff266ee173d04f1610194,22,22,1,154,22,0,05100,1
e2312b28a79876d18592f1d27e2a775c,35,35,1,245,35,0,01026,1
4cca7bbe8ca24f94d51f7fd424405f76,78,40,4,136.5,62,16,05030,2
93c67cd66d578b0d4bea5a4d8159d007,21,21,1,147,21,0,09090,1
d0c416c6acd449a703e4227cf645b6cf,32,32,1,224,32,0,04032,1
1d54da62e970fae067bf1a10ad317868,35,35,1,245,35,0,01013,1
7721a58b5f0ef876528473b58fa47eed,37,29,2,129.5,17,20,05030,1
061653525a759759b7c91664c3a7dd90,60,49,2,210,60,0,05030,1
f7127d3eb8e9e6f6bdce3759d58d4670,12,12,1,84,12,0,05030,1
801e7bb73340659d89584c9e9746382d,15,14,3,35,15,0,08452,1
f588b689af6c651b6a361c6e06d84e86,33,33,1,231,33,0,01012,1
e2834461b80de543698a029961452a9d,123,69,3,287,123,0,01026,3
672cbc7c47ddfa5bb6897e46c7bc7823,31,31,1,217,31,0,01012,1
e3239181b32ff7b562dc2dbe9b0ea8d7,441,118,3,1029,392,49,04020,4
95c0050466f242739dbaf7860e619399,57,45,2,199.5,57,0,05030,1
b221c0a6d92a8aecd7fd87070b51cc1e,30,30,1,210,30,0,05040,1
e25c4b15fc2513d459e3949bf279a31f,78,78,1,546,78,0,01085,3
7c32d3e42fbd1e469aba716547b0d301,40,40,1,280,40,0,11100,1
0525d2cd6f0f2372a8f787f7a15be6ab,97,71,2,339.5,97,0,05041,3
5088f7de9113f9e883db75889035a92d,159,94,3,371,113,46,05100,3
3cb14beebcf226225690118a8e01d379,18,18,1,126,18,0,09150,1
a7c6866aa0702ac5dfc7a80eb5e78f60,22,22,1,154,22,0,01201,1
058f8200c7d9d29c4aee55d350c27597,82,67,3,191.33333333333334,56,26,01026,3
1a78aaa3666335b060de06de83998638,162,89,2,567,38,124,01026,3
11f8c7e2f00e2a65eb7129e3ae92d768,18,18,1,126,18,0,01013,1
c329c9d343046a94b752a7ae2b2ad5dc,375,125,4,656.25,165,210,01027,4
ca50eb5287bc8621f230f3ab792869f4,134,93,2,469,92,42,08100,3
f4f4ebdf5fb932d240e96607407414be,172,102,3,401.33333333333337,123,49,01026,3
6675def75280cae77c60d3515b235e9a,2,2,1,14,2,0,11040,1
39972ab7314463b27ec504cdbffe5b6a,75,63,2,262.5,75,0,01013,2
099c2bf1ad2fc455c606634f1aced6d7,30,30,1,210,30,0,05040,1
3299ab22ed388cc99f57cd6b73531a67,18,18,1,126,18,0,09130,1
3e88f6c5d864d9723b63d6ed90393ffb,31,30,2,108.5,31,0,10080,1
48a1eee3ed8e1d9236a0e04301d83e10,34,34,1,238,34,0,05040,1
85921c3835c9ba5a9db3a4f3f7a8d60a,103,76,2,360.5,103,0,03070,3
f5fe2b43f9375d6e11f1f00b240c405b,118,76,3,275.33333333333337,118,0,10153,3
169c568ae7ca669df57e88d623664105,386,143,3,900.6666666666667,364,22,01026,4
2f60844a784a179825f67572885c6c9e,71,71,1,497,71,0,01012,2
230340c5ccb3b4310ead30ac599d5809,22,22,1,154,22,0,01027,1
381b4a6d09255c7b9daebf3d536a2a8c,38,38,1,266,38,0,05100,1
99a31661dae5c7889dc00fffa56d74e5,150,74,2,525,52,98,08231,3
cd43177bbc7cdaf455d1a41501aaccf0,9,9,1,63,0,9,09130,1
64da28375de39ebc25c790407ef647fb,57,44,1,399,57,0,05040,1
5d8c65f1d2d0c4dd0c47d25831b24d1a,313,132,4,547.75,282,31,10200,4
1153b8b8b7573056d8930cd8b9d941c0,126,96,4,220.5,122,4,05030,3
443e594cb8e53ac6c1dac16594ff8e71,81,48,3,189,38,43,06100,2
4cc23717752f53092ae1cd8b61eb2d92,70,56,2,245,36,34,05040,2
a937374187500ada5090f05eef0609d9,415,156,2,1452.5,379,36,01026,4
4c61ec6736ba31603782c48ba7a330b9,73,54,1,511,73,0,10200,2
624ca2145c2e0c7d37846ddcaf057c62,20,20,1,140,20,0,02650,1
aacfd7032dda6887dd0e1a2c99a6a1a3,143,86,2,500.5,112,31,05040,3
88205158e735df66fcbb7efd93a082ba,24,24,1,168,24,0,01026,1
b9f63f7ead53e70ab995d57552eb360e,228,128,4,399,191,37,05040,4
0b99e4a7aa24241d40ae9f7d55ec06d7,38,31,2,133,11,27,10200,1
f3c6caa283a3e0d78351950fc347791d,31,31,1,217,31,0,09030,1
3dcd12a1c87b45852b3c946ed1f2dad7,54,34,2,189,54,0,05030,1
58290e20fe042e81f47f9c2ede160d58,15,15,1,105,15,0,08150,1
7ab4e165e3550212bf7ca419f214a464,5,3,2,17.5,5,0,05030,1
2fe7f12b4d904f6523da0da6523e75e2,124,99,2,434,63,61,01013,3
d67bfddf33d9b18fd2d3b0d1abb8ff24,181,108,3,422.33333333333337,181,0,09150,3
28cce03f2a14d2bd4787c1def8cb4db6,40,40,1,280,40,0,04060,1
463e7a43a0fa0fbac005423bbc2e466c,74,59,3,172.66666666666669,42,32,04020,2
7c89b49d19572862903319daeee184d5,22,22,1,154,22,0,09110,1
fcacfda7aca631c76927767e5b8585c9,34,34,1,238,34,0,01085,1
83a4c58b1de62a29606b0c53af54586e,22,22,1,154,22,0,01013,1
88d5aad76f554dc65d814d270c2f69b5,73,63,2,255.5,73,0,01026,2
51e221f0cd73b02c736a510cf8294359,228,98,4,399,157,71,01013,4
ca12ecd06b623219d09dc8c7f6b08f3c,395,173,5,553,363,32,01085,4
b2c85b9e33eb34d9cf628e3edd30753c,22,22,1,154,22,0,05030,1
f46897399c1f70d14e9be16d1b71d2be,53,41,3,123.66666666666667,21,32,04080,2
d99be318a07322f7889be38e1476e99f,129,79,3,301,98,31,01012,3
990b6c6e9e56098c1f7d931aaa93d65b,136,89,5,190.4,86,50,14301,3
30d0f6dadc3314125bd51b2db3190f3a,5,5,1,35,5,0,02620,1
ee1da1d866702de24a5bb73a44f12579,62,40,2,217,62,0,10261,1
74a2756fc09a302b3bb0532f8f8e911e,21,21,1,147,21,0,05040,1
79e240653cf2d55b94772b7664c31461,13,13,1,91,13,0,05040,1
371961ccc4d635a0549ee4561e4b51d3,19,5,3,44.333333333333336,19,0,05030,1
cde252395db039c070f471f44c96ccb8,37,37,1,259,37,0,01027,1
03e04dc27cdea20a7194a07a9a271cba,29,29,1,203,29,0,05040,1
43e560d4117aaa4084e8a116955cc298,158,50,3,368.6666666666667,158,0,05040,3
a3c6a50e3b05c0118473c9b892a77503,123,85,3,287,79,44,01012,3
0e74f3d5016e4dc716a92ef98241ea0e,29,29,1,203,29,0,01026,1
9e5107e003c4f283e0fc49ae68f7c0c4,37,37,1,259,37,0,01012,1
529646ebf5944d097339f0395e39ce39,164,101,3,382.6666666666667,136,28,05041,3
8c5bb56738ba02c6a6de2cb91b1a01c3,39,39,1,273,0,39,13830,1
ba541ce6b7a3d81d91d39fbb39a044e6,29,29,1,203,29,0,01012,1
5dfeceed9644da31c7cff12a29dcb4ef,31,31,1,217,31,0,01026,1
31dde4c9ce6c2a13d7008dcddde48055,80,54,1,560,80,0,03050,2
695a73b7515f4b1b8ad36afc729ad3eb,78,52,2,273,55,23,01026,2
869d3666eb4759f232f17ba6ee189c72,197,69,5,275.8,135,62,01027,4
f64a3b2ad4ccc7ebe9dcca79e1d3265a,187,102,3,436.33333333333337,187,0,05040,3
81ed16cd4f41e1b66f08778917c38ebc,147,101,1,1029,147,0,05040,3
934ec7933b6fe47934778dbc375a77fa,23,21,2,80.5,23,0,11080,1
3df428e9fcabd8c744174287ecaa8142,65,40,2,227.5,65,0,08100,1
3e6e2279796d740e51b8843d09485c6d,135,66,5,189,119,16,03050,3
6696e92c3df6bc5eb09873b5e81865f2,140,59,4,245,110,30,05100,3
00897323e258f1132f08ab393215d76a,215,82,1,1505,0,215,01026,4
43cb514cdfeee9a679537508b63a71c8,12,12,1,84,12,0,01027,1
d11441dfd0cf5c45e7d1f6d67f27f5a1,58,54,4,101.5,48,10,01026,2
4bedb6e9a227e7aa0327ec04b2953678,63,63,1,441,63,0,01013,2
5350c5ac1abd109644fa60c6770e1fb3,129,79,3,301,86,43,10200,3
bf1f825874a496ff48749b50fa8a0089,695,130,5,973,566,129,01026,4
c8c4dea1d6ad2b78e4d9caafd181afac,72,55,1,504,72,0,05040,2
8cad07eb5a7613878583aede1739480b,175,76,2,612.5,175,0,11080,3
8154f73e6b127390f48be0fbb6163c3e,65,53,2,227.5,65,0,01013,2
b1e1a29099d61b775e829f36699c9cdf,20,20,1,140,20,0,08100,1
680fa56313ba3841344cb4cbde7de5d7,305,131,5,427,305,0,04020,4
f73f1b20148752b12003ae646ad2da87,54,54,1,378,54,0,09130,1
9277655cb59006053f5a19109e59a3f6,2,2,1,14,0,2,09010,1
707ac32fe1d997097a52796c379289a5,24,24,1,168,24,0,05040,1
b8e0c9c10bc6fee52d88d4348ab1c95e,37,37,1,259,37,0,10200,1
5138a8891fb7f179996941d42b2f5b51,73,49,2,255.5,73,0,05030,2
36b530bdf3f26b88a83b81b7522167c5,100,82,2,350,100,0,01027,3
57b1bb3e004759095a6a5e02af67c3d6,5,5,1,35,0,5,11040,1
6a40392b195614c1ee45be2999e4714c,65,55,1,455,0,65,01026,2
8ffe3079a7a6eba058d9a212e0d3c7c6,42,26,3,98,42,0,11101,1
bcde1b6d63cd02ca629e1432d710c28f,148,84,3,345.33333333333337,120,28,10200,3
ec8870da943913ff90d950b547ae4fb6,198,133,2,693,198,0,11100,4
0e7759546a0f4ecc0b9a3cf339c7cefe,102,82,2,357,102,0,12501,3
e7cdb21ae47a7d55e5bcc5eeeddb000f,109,67,3,254.33333333333334,70,39,08452,3
a291c94f01fcc604668cbf516869ca4f,41,41,1,287,41,0,01026,1
e247258f0ecb0b0a4e191d85eb9fc6ff,530,107,6,618.3333333333334,466,64,01012,4
e2f72f44de44e1e8a58af60ebc834147,13,12,2,45.5,1,12,02620,1
e9e5d8eff41eff0095583ae0614b41a1,26,26,1,182,26,0,01027,1
de3a27ebba85d99afaa6cd60b046e0bd,33,33,1,231,0,33,12650,1
7729776a4dc170ce7f3461190ebfe4b5,31,31,1,217,31,0,01012,1
d408784d1991c05cc39ced7898d88b34,547,179,5,765.8,448,99,10220,4
1f59148ebb34cbbd6aa7bd80a3fa8c33,48,28,2,168,48,0,01027,1
f51961a232d6c6b6087309c724da35af,29,29,1,203,29,0,04060,1
d9feae8fcb864d99fb61c2cbbbf7225a,26,26,1,182,26,0,09130,1
a3a0f0c98608a58faa9d6a7a774dfdf7,262,127,2,917,156,106,04032,4
7ec47f78b1084038dccd50555629025f,70,48,2,245,70,0,12500,2
c1483281e731fbb89129cc11f524c001,86,68,2,301,86,0,05040,3
8ba7170d0e425fbeac29cd37725c9272,60,60,1,420,60,0,05040,2
f2ca546ad6a1364869882571d63dc92c,111,98,2,388.5,77,34,05040,3
97089d0b0dc10931a9cf094db257937f,48,43,2,168,48,0,11040,1
f8b8d2957921fecb2e87a17ddf1ed96c,246,78,4,430.5,246,0,05040,4
2b667339212dd92ac8bfbcb144ef20a4,62,52,2,217,62,0,05040,2
2babbb2985734d7988ca1bababb2e6bb,56,45,2,196,56,0,01013,1
8f6c5eb09e44dfcf7ee3a65be65078eb,18,18,1,126,18,0,03033,1
78d6468751f89b6f1d1e7db6dd0c6f0c,24,13,2,84,4,20,05041,1
26908abe0b80d1062baf3b02500f86ec,60,49,2,210,60,0,05030,1
9d17b8800251e39f832f5528a3602e53,48,43,1,336,0,48,09130,1
81cdc474a10c0bf0012171efe1aca702,58,58,1,406,58,0,01012,2
bd79afd0b751896d1ea8e7204b2dd106,160,96,3,373.33333333333337,160,0,05040,3
13aacd7c6242df8b698e5b94446b70fb,27,27,1,189,27,0,01026,1
0552e1bd645e238ba38a2e4d7fe28ab2,133,97,2,465.5,83,50,05040,3
6db2c986af5c407f5a97f1a8b57d89b1,191,165,3,445.6666666666667,164,27,11140,4
b3096e0a0f6c36b67059771ec2cce34a,45,27,5,63,42,3,08032,2
b27979ba7ce70078d76b45e529c638eb,62,44,2,217,62,0,05040,1
a28b7c020f4772924ec54a596fd0e169,12,12,1,84,12,0,05040,1
d846e56993862c3d7a7e9d8322b03eb5,1,1,1,7,1,0,12410,1
1e2b908c18bef1f654954b664d3caea3,64,64,1,448,64,0,01026,2
54ea9962e79b1d0ed482c6c62b28847e,30,30,2,105,30,0,08032,1
28a6adbe7af3c2b94e9745ae235863df,2,2,1,14,2,0,08250,1
8440c60d6eba49414efd4b250b1e3b01,69,52,2,241.5,32,37,05040,2
e2115f71d1358505457f41f3b1778a3b,8,7,2,28,8,0,11040,1
1a526cd1ba7344e29602b32832dba068,12,8,2,42,12,0,10200,1
afd1ec50fc3b8334917d61ca40bb19d4,337,136,3,786.3333333333334,215,122,01013,4
cc175780aa1133fd635d1829fb4dca7d,293,142,2,1025.5,293,0,05040,4
a0853e77eb43eca3b506ef3f7a36305a,105,65,2,367.5,105,0,03050,3
0423339e04c79b9491cf7157b5584a14,382,156,3,891.3333333333334,382,0,01013,4
b71b4976e0b36e844f617f837754bd96,35,28,2,122.5,35,0,01012,1
2789614607e8398acc9c485ce8823f87,108,76,2,378,108,0,05100,3
fcd52ff42dfa2fe1885d145fea0867b0,54,47,1,378,54,0,04020,1
06e88413ab0fe6dd9e20fa3674bcc06c,24,24,1,168,24,0,12650,1
9d0624f753913ce382b962cf4b12edb1,8,8,1,56,8,0,05040,1
8d23ccc0a32cf9ed1f46c6f7b7c4fada,133,85,2,465.5,133,0,10200,3
0f753b55d7ddce9d1b520242b9a4fc2e,58,58,1,406,58,0,04060,2
1b7402d84d6eece3fe335b39ee597d69,29,28,1,203,29,0,09150,1
a6a0463a8ab2c2a4d2cdd243035a5a28,38,38,1,266,38,0,05140,1
5744c53ab093efc6c3a933028bbf21db,317,143,3,739.6666666666667,121,196,04201,4
4e9b1db76b8d1f7419da530a14b63e46,187,96,3,436.33333333333337,187,0,10153,3
41bd4802735863dcb0f3f0502204784b,38,36,2,133,20,18,03070,1
8596f0932bd5ce5fab333a0bb775c8c6,45,31,2,157.5,23,22,01201,1
d660e00500dbe74c9220407c9d9f5fc0,13,13,1,91,13,0,03070,1
3087229edd9a0e197a787ff0d989d3b0,13,13,1,91,13,0,09111,1
042b8f9e7d19c0be1a55d1031413af44,54,54,1,378,54,0,04060,1
dffd30107bc9f65e3b328f65c13edcd4,49,44,2,171.5,49,0,01013,1
4218ceb746b195df597a43755502a4fe,15,15,1,105,15,0,11040,1
f2002a2c645a0c2f3da9ddbef809326f,23,23,1,161,23,0,11080,1
9c039e3aa4a6420baedfef747e954432,36,26,1,252,36,0,11100,1
35ac8f0a7c12dac77d41dd4ad2d866cb,23,23,1,161,23,0,05040,1
e00b1b1ba7e5859f7876fbe5122c60bf,49,41,2,171.5,49,0,10200,1
47e6e3b5c82c4380a85b69f224f26574,46,40,2,161,46,0,01026,1
b9fd56415c702a2b029db3c69f04a457,363,151,4,635.25,218,145,01012,4
f241d67433f81d967d55d96c946336c9,16,14,2,56,16,0,05030,1
f9e155c227ad1ddd041c9cd29c620c61,186,108,2,651,123,63,01026,4
6a08677a3d0581ea5c5b2cdc08df3032,16,16,1,112,16,0,11080,1
9f8c8b7f72a90c57847dbad87b5a1b50,43,43,1,301,43,0,09351,1
b8dfdca4edc40c2c8d3ae74709da0ed6,67,55,2,234.5,67,0,01026,2
ad901f8f221756b0bfe5408f52759d43,34,34,1,238,0,34,02751,1
34bb84e14435ed516d594cb5892fd063,66,54,2,231,66,0,11040,2
1d881ea13d13adae928ede923496f7e4,37,37,1,259,37,0,10200,1
33729061bdfda0a92b4ea0560864a4c9,108,74,1,756,108,0,01026,3
3af82efecfd8d3e372c0e19228814959,12,12,1,84,12,0,13830,1
9eff8b44fcc1f8712e787993995d98b2,450,136,3,1050,411,39,01012,4
9afc1e392297ef5a29f90ca69ceeed62,5,5,1,35,5,0,03033,1
583858869435a476fe13ba9a26d6beef,27,27,1,189,27,0,09150,1
5d491e2c4054d0d6d34f4d5f2b4615de,34,30,1,238,34,0,12500,1
a7d2a3fcddbbaac8e50b27f6f2fa1069,85,76,5,119,46,39,08090,3
69be538bd38fc538f3677ff58a2297d4,79,65,3,184.33333333333334,51,28,09010,3
b916e9c667ef720c66f864b33ef28e63,22,22,1,154,0,22,11040,1
e17c4710b7e980662d0e2ea5432a5358,30,30,1,210,30,0,02650,1
fc80f0f51fea102690704dac47ac0f6f,21,21,1,147,21,0,09090,1
ebae031594535b29de8059a8af2ba155,91,48,3,212.33333333333334,91,0,09130,2
804de86e4507b9304c0efdc23e15d726,199,131,2,696.5,199,0,01027,4
048f00432bc5372576e66592e10d5a5e,47,47,1,329,47,0,05040,1
bbdb90c4b662d450a5cd31ccc6489c1a,122,95,3,284.6666666666667,122,0,05100,3
50ca706c51a2df26f073b06a6a261a4d,11,11,1,77,11,0,01016,1
13ebd0465a77d02a49cf0071381136ac,36,35,2,126,1,35,05030,1
c99273c8d15ff3a8706d45504d3bbc3c,36,36,1,252,36,0,01201,1
de44f9674507bc2fe5bcada4a0131fd9,44,32,2,154,44,0,05040,1
8d2f658dea015d5c62e02887b06e023e,103,81,4,180.25,81,22,01013,3
3e2c123bd432c6d375313215021781a9,550,129,2,1925,550,0,01012,4
3c3b911768e89d67f18f3c8f9db11184,58,58,1,406,58,0,03070,2
8ebd2a64b94f021107fa95d830408139,108,90,3,252,82,26,01027,3
5d344c07850bf81a278aabe07c911f94,36,36,1,252,36,0,01085,1
1e962259b9a91c5cdad076569906874d,133,101,4,232.75,112,21,05030,3
8e3cb5b1cbc5176e0a48720c911a4b19,166,120,3,387.33333333333337,131,35,01085,3
415c86e992b681337bedbecf54c9fef5,69,62,3,161,50,19,05030,2
c0c1369f1ee68fd8760635219b337d75,11,11,1,77,11,0,12500,1
3928d9ae4aaff0d3cb5f59a0aa3af065,502,152,5,702.8,455,47,01026,4
3629e8d641645455317f2b63ad153365,66,54,2,231,66,0,02690,2
495b6313f36d969c1ac464d3625f22cd,69,59,2,241.5,69,0,01013,2
82cfd3abdfc461b0e0e450ea77a35c38,141,77,4,246.75,141,0,11100,3
a3ebfb6e86d367c0ae71dda6ffc32cf0,229,154,3,534.3333333333334,229,0,05040,4
d843c537cd80a31cb51c3570c2dddebc,26,26,1,182,26,0,01026,1
66821c0370139f5729f0de64b45f1998,23,23,1,161,23,0,01012,1
29b4286b4bdea70ea9a73aeabe5f89d0,60,52,1,420,0,60,11100,2
ec1b0dd613872dd31abc1ba8a9268f46,150,88,2,525,102,48,05100,3
bb4f6c02fb6cf60ce5435be53b7860eb,44,44,1,308,44,0,01085,1
1c349a0ded2e37762552f8d36ee842f8,16,16,1,112,16,0,01201,1
ab8ce81f080bcdc04f85d625c17c8447,244,102,2,854,244,0,08032,4
13eea3eb7396b589305f195ad8affaf2,169,91,3,394.33333333333337,169,0,09130,3
f922866af3e84735ff35a58719ba8713,20,20,1,140,20,0,05030,1
bfdd9e32281704db45dff6401a8d39e9,104,70,2,364,27,77,10220,3
02062c58dc38bbc67f88e3b314f45742,111,50,2,388.5,111,0,01026,3
7af0c5e2ee22baeba7f5f9a8b5ea9f42,443,162,4,775.25,332,111,01012,4
718a248ed550b8c0f175329d8bcab07b,136,71,3,317.33333333333337,136,0,05040,3
578637edccdc60652a2211d80cb86ac2,43,43,1,301,43,0,09010,1
bc9be8aa94a1d8e9d82b13944c0a52d1,62,47,2,217,62,0,05100,1
34eea9c2e27c4106d898cf22cbdfd366,79,63,2,276.5,28,51,05040,2
81539bcbc350332c8668f67b3c5c8c81,36,36,1,252,0,36,02691,1
0b82f64e569fe83899cbdcfe574f412c,8,8,1,56,8,0,11040,1
a1a9a50ddd59df271d21b5652367715b,61,54,3,142.33333333333334,61,0,08390,2
fded3005207f1a906b109405bbe9587f,181,105,2,633.5,181,0,04201,3
c406b2c36bccc237a1c60709a13a6201,180,130,2,630,42,138,01012,4
5c2e7650102660ca2ec8e698ac7fd799,201,127,4,351.75,147,54,11080,4
1e55233f9370ece2e40bfaba47f36de8,218,98,3,508.6666666666667,180,38,04060,4
0dfdbfbe4891bd91d6b3bc13d80b3837,10,10,1,70,10,0,01016,1
c34ccc5231742e06a0b2c4d91b5715b4,397,110,2,1389.5,68,329,01012,4
9a0ae0ec1ef099c93d91c7ec9caac91b,36,36,1,252,36,0,03033,1
f614a30530de43ebae937ad98cda2070,114,71,3,266,114,0,05040,3
a08c175836d4c7555ffa998d70077551,122,105,2,427,122,0,05100,3
f07a7362f2096520ddfcfaf2ccb0fd84,77,66,1,539,0,77,01012,3
17ec5f5992e3e0d7ec795b2eae3b1a48,156,87,2,546,156,0,01026,3
10756fe9a717d3f73292a0b7fe3a1498,18,17,2,63,15,3,12410,1
8af9ecd1f63787f3ebb1033c60fb644e,60,49,2,210,60,0,08314,1
541d6ed078ffa184b747abcf939af70e,40,40,1,280,40,0,05030,1
8a6f6498505b8b3d67e6c9af82c7c719,73,61,2,255.5,73,0,08051,2
2fc6446d91e39a2732d136d4baee8a1d,43,42,2,150.5,43,0,05040,1
4c794825a184686f08a57b95fe6cc080,84,59,3,196,55,29,10240,3
04c65971cda831483d8d2fcd1ffbb21a,10,10,1,70,10,0,10220,1
0e89ccf48c1e1930187b9eb6de48ae4b,94,67,4,164.5,53,41,11040,3
cf8e460766c86c5f1c8c97b0c598d8f4,11,11,2,38.5,11,0,04080,1
bc10690c744944cc624fd7dee530ef8e,117,95,2,409.5,64,53,10200,3
6807621726d2f862a948cca07143f1ef,96,69,1,672,96,0,05040,3
b2217f587350bd25b61b6086f97c9e96,228,121,5,319.2,119,109,05040,4
042590445018321442d360075aab43aa,128,44,4,224,128,0,10200,3
ffbdc58fc398e416e1c39c0d9a2c77eb,43,43,1,301,43,0,12501,1
1376240d38ed891276c95846e51971f0,3,3,1,21,3,0,13792,1
7cfabc83fe748f12b735c31931ae10e7,206,115,4,360.5,193,13,10200,4
fffb92c1a8e51b709efb7567837b73e2,107,59,3,249.66666666666669,107,0,02691,3
e8cfdf20f8cb8a974f5aa758aa7cf2a7,453,120,5,634.1999999999999,378,75,05040,4
1a91637d139fa55ebbcd7e25b38602b3,31,27,2,108.5,12,19,05030,1
191a9066eac82ff54ef63dbaca6de5a1,488,196,2,1708,421,67,01012,4
1232e37180849a377ba1cc576eec5e4b,30,29,2,105,30,0,05040,1
62d59191770db4dbd13f656c2acd38af,104,63,2,364,104,0,05040,3
4510b3c7ef29524137a9f8b61669b1f0,128,81,2,448,128,0,10200,3
43e904d1a133cae4590b8f44bb389d42,33,33,1,231,33,0,05040,1
8f24b3cee13a19025be5a51e296f1bb8,28,28,1,196,28,0,09130,1
ba9749930e27909c3ed57c134656c751,19,19,1,133,19,0,04032,1
393ace72c6825c99ae2b79df982486aa,294,158,2,1029,57,237,05040,4
68e476a815bf212d526fcd21742a6825,12,12,1,84,0,12,05030,1
26d9cad4fb248fe3acab738695153606,294,87,2,1029,294,0,10200,4
ba306f5308a33028cf61187dd248f985,183,85,3,427,183,0,10200,3
efde4a11326b68b604422d70d19d384c,397,119,6,463.1666666666667,333,64,05040,4
8941eae209605c1ebe9c8de8a684b179,57,50,3,133,57,0,05040,2
2a97d6b885f36b5b25af88b8fe918df0,93,82,1,651,93,0,11140,3
1f856343039604c6b4aaaf62b28b0bbc,32,32,1,224,32,0,05041,1
dfe9a77342a647ee9c411c5bc4ec5c27,19,19,1,133,19,0,05041,1
f433df4c4ddb0295d6303112cfcff8f4,21,21,1,147,21,0,01085,1
22700f533b909f0e811171ffe0a353f5,25,25,1,175,25,0,04130,1
55337a5fd78436d33b3629f01b4a8912,4,4,1,28,4,0,01201,1
fe0823dc9a79dda294b64ed6260433a1,35,35,1,245,35,0,01013,1
15713b06e87d656a23f063a140435d05,59,50,2,206.5,59,0,01026,1
9b3dff84fa35176fe8462c0bf4d46f7c,71,56,1,497,71,0,01013,2
f43da5b2534f5df7bc43ab7b71f480d1,103,81,2,360.5,103,0,01027,3
cef16d74be3c8ffe74d028b0e409ae18,143,85,3,333.6666666666667,143,0,05030,3
19b3f4aa272884ff91966f8a63254784,5,5,1,35,0,5,05030,1
9b90beed6d0ea01552aac32a26f503a1,41,32,2,143.5,41,0,05030,1
90d24b942a78e75306d397f2bcd1a955,106,78,3,247.33333333333334,106,0,01026,3
a2f91f269b74f597a4da3d93c4168018,22,22,1,154,22,0,03050,1
2927f9aaa8150df94108083d7befd9d5,107,99,2,374.5,49,58,04020,3
62fabe7c4d6377767bdea11664d3d858,21,21,1,147,0,21,01026,1
e4725f6bfaf98e752e8bb2b65a074481,9,7,2,31.5,9,0,05041,1
6ddd29723c66d76b582e4628b62f5903,53,48,2,185.5,29,24,01085,1
7ac02ac4f572d68d4aaf09ecde8fc670,18,18,1,126,0,18,14301,1
fe0c52bab8e830a6ba7a1a7b754b4461,44,44,1,308,44,0,08230,1
42d04125fb83e42a3775266ffce1bbab,146,95,2,511,146,0,10028,3
b28492b66e59838630c83b1c9e664695,105,73,3,245,53,52,05030,3
966923fdbf39817e5de6843dd0dcbfc6,28,28,1,196,28,0,05040,1
042e8884aef52286cd7f9e440eb294df,28,28,1,196,28,0,05040,1
15e2c8e633a482cbecafb0a774faead5,28,27,2,98,28,0,05040,1
095229093a2603413b324a9f8920c050,125,91,4,218.75,67,58,05100,3
f587d1dd4d86ab229a733c5df54e7ee3,1,1,1,7,0,1,08230,1
96d673fe692ea3b1905eed6583316ff1,29,22,3,67.66666666666667,29,0,05030,1
112e2d0f10074c4e47a0d54b32b8cc59,41,38,2,143.5,41,0,12570,1
dde18b351994543550f954f1c4ae9bd9,229,120,3,534.3333333333334,185,44,01027,4
c4c51112cc7d7705886546e8135129a3,126,87,3,294,92,34,10200,3
9912fc15a749bb21c635fa3bff039349,48,48,1,336,48,0,04020,1
d2fa7a27ffb38d3d6d448d3de1a8e089,178,117,5,249.2,131,47,01026,4
c7b9286a7e8065b7d8cbbca3a7b5f332,20,18,2,70,20,0,05030,1
5a67615ae7e45333e2684f2b071c831d,78,68,2,273,37,41,01012,2
37be7843da19b9180b18b56bc885799f,196,119,5,274.4,196,0,01013,4
c1429067b6e28f81cfc37e5f146d029a,81,61,2,283.5,81,0,01013,2
e2924550a31839d1c0f8d349f01ec95d,17,17,1,119,17,0,10160,1
78b4af4d60ea9fc6c7e88c884b63a5e9,72,56,2,252,72,0,08100,2
5cfc2e58a2bf2c2b94bf6a8c7d09abb2,100,52,3,233.33333333333334,100,0,05041,3
5b40ed5a9fdf5d11b0646738d9b7e164,25,22,2,87.5,25,0,01012,1
8139c0c7a5bec49d663f7843cc55068b,59,51,1,413,59,0,04032,2
db1c8a156f3db303d7c0a92fd94cd37e,381,159,3,889,381,0,01012,4
ec2d4cf15bf1a18318985591a8d6b6bb,448,139,6,522.6666666666667,369,79,10200,4
864b36d3d76ce0604a0a49eb3a5575f1,19,19,1,133,19,0,09090,1
fb39254e6f79ff956af9d5951c7113da,25,19,2,87.5,12,13,08052,1
da10eae90def64687f754eecad3ffeef,164,86,2,574,118,46,10200,3
f66ed000138d008468824e0e5d7520e2,63,46,2,220.5,63,0,11040,1
bc1bd8d23e492bb05d6ba6feb9dcf91e,36,20,3,84,27,9,05030,1
62c10a0d9ded0f489970a02d8e63cfec,25,23,2,87.5,25,0,05030,1
27cc61a3ba5f13394d3cce97bb3e5736,34,32,2,119,34,0,10080,1
c6b4ac314c3a5498c9a023e1f4a3c3bc,22,21,1,154,22,0,01027,1
06e1c710c4d1f0e9799907764d8da9df,159,97,3,371,159,0,05040,3
e1708b9791a6e151084814d34832d096,44,44,1,308,44,0,10028,1
7421f37a13a129cd75973934c733e2bf,53,53,1,371,0,53,01013,1
17b2bd23a6e61733d8a48b8e25656cef,100,77,3,233.33333333333334,100,0,05040,3
4fcd7a3784f1cd52472c573be189371b,206,85,4,360.5,206,0,08314,4
aded8235674e60be448ac394beeaa4ed,127,86,3,296.33333333333337,28,99,01012,3
75b0e5f5ac1d16d11633a6d79da294f7,65,65,1,455,65,0,03050,2
69a905133f9460756f87c3eb45a7c321,38,30,2,133,20,18,04201,1
f03c212c90cc119294ea7e31a85b6193,18,18,1,126,18,0,10240,1
2277ce6c241fc125371e0ea196f0e579,81,65,1,567,81,0,01012,3
acf6f71d29ed5f24788033ed86af629e,113,75,2,395.5,113,0,01026,3
af9ca6b7f2899470096b15b8b3f9fd5a,164,68,2,574,135,29,05040,3
8a78956bacd004e7dff2322b3774da5a,319,139,4,558.25,215,104,05040,4
ad0e8d341e9e1fa74153c3b6e281aa89,562,121,2,1967,392,170,08010,4
62040af36e8176b2c37e45ca3bf50785,193,104,3,450.33333333333337,193,0,04201,4
da1014c23f30a1e5ccae7a219bacc28f,29,28,2,101.5,29,0,10200,1
d91ce2630d91f88b817835a307f5a591,18,18,1,126,18,0,11100,1
368be299a828ff2d2b75543531bb1447,48,48,1,336,48,0,09130,1
a829f26e17cde8b84a6ca6a3dd31af34,67,46,2,234.5,27,40,10200,2
7a85b30a33a76e54fbd3aebb03ef57e6,18,18,1,126,0,18,05200,1
e53245a6642b71cf545a97f07efe3bef,36,36,1,252,36,0,01026,1
50cea174af14e68b1169e36fd7564a1f,45,43,2,157.5,45,0,01027,1
2a2de33d1acc83111ac1ff6ebe8240bf,121,88,5,169.4,96,25,11040,3
c3e1eb924105f8f198e6dcf591b8156e,40,34,1,280,40,0,04031,1
fc4394703d73ed369d0735adf9fadbe6,40,40,1,280,40,0,09150,1
5ccc4ec9ccb0c58eb76d858a416cb5c1,44,44,1,308,0,44,05040,1
b5b8b755be6d1de7e24988c21f7a217e,95,72,2,332.5,95,0,08010,3
70b00b32ab9a466f632f8da6a00a0fec,69,69,1,483,69,0,09130,2
e337c8c296a9bf52186db21988ace2d2,145,105,3,338.33333333333337,145,0,04201,3
7f2b3339774ef14777f91339a4968b2b,49,49,1,343,49,0,05040,1
a8624819a5cf309135dda58c4c6fe903,542,135,4,948.5,225,317,01012,4
680c269b85e1a5ba28d702192635d819,183,107,3,427,118,65,05040,4
cca9776bd1753f5dc70831e67affedfc,79,60,2,276.5,79,0,01026,2
b4f9848a287508cf84851d38c744817c,67,50,2,234.5,32,35,05040,2
cc52470633b2e84c77591bd40f42a401,32,25,2,112,32,0,05040,1
9d076d2a8482e172f9d7d50af3669e8c,369,161,4,645.75,231,138,02691,4
96cc77fcc224889edbbb0afdbb7c24f3,33,13,2,115.5,33,0,09170,1
1eb3c83be41faa398e7d5b52d7d8ade7,48,48,1,336,48,0,02620,1
bfeac34529d8ed8d29bfca0ab4741830,250,101,3,583.3333333333334,124,126,01026,4
293d64c6da64e1a6624565b8e1119a20,110,80,3,256.6666666666667,74,36,05100,3
ab33572313e60025bce76caf6f2effcf,26,22,2,91,26,0,05030,1
185809da110d38d4708a4df9782240aa,51,35,3,119,36,15,10153,1
82f72b892cccfc3437a8a92d40d8bf99,85,54,2,297.5,62,23,01012,2
fd463e729a19069f5d55f127987b2d6b,16,16,1,112,16,0,02691,1
93fa1927b1b00fafa8cd48b4d8d02253,41,41,1,287,41,0,01026,1
8766d8e8437fe53a501e4307fb5e5c01,134,89,3,312.6666666666667,134,0,01026,3
df646c8c3c145bdbc87cbfac127a1d40,267,143,2,934.5,267,0,04020,4
3a1855ae855110feb7ca60ed3421538e,32,32,1,224,0,32,05040,1
f8802c74b4e81f2d3ad3559d0d61d89b,24,24,1,168,0,24,11140,1
526478a3eb79c07c826959c7005ea6aa,130,43,5,182,85,45,10200,3
b43901b6dd7fbee5b272c41751ee7103,46,39,2,161,46,0,05030,1
80fb284927854d07bc0e76d26bc67306,31,31,1,217,31,0,05100,1
834631eea05cba6ea0a6ff8bc36de3e4,68,58,1,476,68,0,06100,2
d5344c99b982838770032874766a3376,110,79,4,192.5,84,26,05030,3
66a7c86c4fecc5edb837dbcebfc7e829,301,158,3,702.3333333333334,148,153,05040,4
385559fb11654c012ff9c1a735efbd68,56,56,1,392,0,56,09130,2
0d1244db8116f59ad7c7d0d8eda30e1c,200,112,3,466.6666666666667,200,0,05040,4
989f5c9d544b9325cabefa56af8e7118,19,17,2,66.5,19,0,10240,1
5fa3726ebc5b7763f69c93af382f05c0,17,10,4,29.75,17,0,05030,1
6a3b3b61808c5fbc1259726ff22f0292,17,17,1,119,17,0,05030,1
bcf1ee5225cad60af433eb35b7f52c55,45,32,4,78.75,45,0,01013,1
63eef61f7aa6dff6869114a1c14c823a,46,39,2,161,33,13,05041,1
d4493a90ea4fc9b9bb5a26a79d866102,72,55,2,252,31,41,10200,2
abb193aeb6e0d840eb49bde2388f5a99,12,12,1,84,12,0,02620,1
6904d753a3b1a93e5ce89edfa8e9b838,168,86,2,588,95,73,11100,3
06af2c0d48c63f03a77353458ae11444,120,82,2,420,46,74,05040,3
734cba4a35cb16d692ec3bc9dc160ebd,37,37,1,259,37,0,10080,1
74bc221b40ba34c43a57b78e6777a880,89,67,1,623,89,0,01026,3
3a13e760376d60181e241f438d61e9a3,150,114,3,350,94,56,05040,3
850c8a552f91a6e95b178b9dc851e61d,109,89,3,254.33333333333334,69,40,01027,3
8c1e668b2ae50fb558238f8c50cef35d,50,50,1,350,0,50,05030,1
7dd69b4979ed9e5d5fef6079dbdc5a62,140,61,2,490,140,0,08150,3
3065a234c0a7f4244e6be1ce934b005e,138,54,4,241.5,138,0,05030,3
59ddfe819e20cf7201dfc3f00b9c0259,168,91,4,294,168,0,05040,3
0bf5b2f84e026dc5fc3faa8a4a97606e,1,1,1,7,1,0,05030,1
4cc6d11ad5a47c9d7bbe18a67145a7e5,33,33,1,231,0,33,05040,1
29494836d8bb0bdd7b8d8fc2eb5e410c,268,105,4,469,235,33,10200,4
ffaa7f5ecdcf5c39692f3407ce7442c6,30,30,1,210,30,0,01027,1
1a69cc8ce17cf52b6383a28f81c25318,26,26,1,182,26,0,01013,1
797758dcdada12cabef0e5cb15793927,19,19,1,133,19,0,05030,1
03364d4201f69992006ac057abdedc9b,47,40,1,329,47,0,09130,1
08d0ae05c17e3d24d59d3488cffaf7a7,262,74,2,917,262,0,03033,4
a244230aaf52edddbdda54d60adddcd3,49,49,1,343,49,0,05040,1
45178e6c3c3f699fa017441483511199,29,29,1,203,29,0,01012,1
2404a2b83d4d1f2c13a4ff2f6fe450ef,15,15,1,105,15,0,10200,1
35ea038019abc4cfbe6e6777b2972a65,33,33,1,231,33,0,10028,1
5303b5f7cf581cb3ab06fb315c4da0fd,109,69,4,190.75,96,13,11080,3
85bdac21dd6059fd27617cf3f34da8c2,159,101,4,278.25,159,0,01027,3
40fb1da8bb543dad6d420f9992e90b40,12,12,1,84,12,0,01014,1
996eebadd80b7c866ec2e8e551546747,70,49,3,163.33333333333334,70,0,01012,2
27b0acaaaef878145c54c0902dbc5c40,75,67,2,262.5,29,46,08150,2
fa8b62d6acc2b6520c391c3eff44f35a,11,11,1,77,0,11,04201,1
7f49be38ff4a32dfb423d82f221e0298,59,59,1,413,59,0,04060,2
d7f24e4dd4fdbc76351a311578f876cf,18,18,1,126,0,18,03050,1
cdbbee0054a35503638f95de4c88dec9,65,38,4,113.75,45,20,08150,2
5524b5ca79e4969ee87da70ab2cf338d,90,72,2,315,70,20,05040,3
620c2f5562a1209c487c41badbe34360,60,54,1,420,60,0,02691,2
d9c2abaaca89203bb7ed70960984a72e,33,33,1,231,33,0,05100,1
13dc2b9530ecad6620f4b2f442d8fc58,18,18,1,126,0,18,04020,1
f20f40b3b277a48954baee958a293a0f,57,40,3,133,47,10,09170,2
f4bfe5eb5088abe2c7e5bd4434a8f316,38,27,2,133,19,19,09010,1
f1983be2244e2601ab7139e8db59530d,24,17,2,84,24,0,01027,1
1e48482d26fe308db73ce752d48cb870,27,27,1,189,27,0,01026,1
a76ce61714ac17275579525ff33c8321,3,3,1,21,3,0,14260,1
4b7898f8ad674b00966d89b3bbdad282,205,100,5,287,205,0,05100,4
81e2a6d7b9b968cd12d7b3bb0ca4a3f6,46,45,2,161,46,0,09030,1
07afca4853d6b8d07a15b9c3bf194407,109,89,3,254.33333333333334,80,29,01027,3
54e0dda689f010390eea43593295c8f9,3,3,1,21,3,0,11040,1
cd09f75392fd85a0ea8169947070229a,441,108,4,771.75,441,0,05040,4
0aa9bce780934781ee885ea6105ea39d,85,59,2,297.5,85,0,01027,2
13908d78ad18290167f24f38680023c0,8,8,1,56,8,0,11160,1
146410e277e32891475dcd8b3581ab34,142,102,3,331.33333333333337,91,51,02650,3
9b6dd50de613b1f0d4d5a05916e1f2a8,119,59,4,208.25,97,22,01026,3
1b8e03e2deb74f6a90ed8dd95f76d516,96,62,2,336,34,62,04032,3
9df6bb2a5aba4e8e7de20d1fe1043b16,28,28,1,196,28,0,10101,1
38027deab27684274b8abac98b0da5ff,283,78,3,660.3333333333334,283,0,13930,4
75ab59230df721cef16f717ff68af0a8,42,42,1,294,42,0,01026,1
340e781d23b34a946d84e512f84143ae,483,159,3,1127,451,32,05030,4
780f78163949f66008a693377d462ec2,91,67,2,318.5,49,42,05040,3
c6485cdb2308c506352685f40c49a52f,70,60,2,245,70,0,03050,2
1b76688813d89006a947d75759097d6b,176,82,3,410.6666666666667,148,28,10200,3
9114afc30ff2b3cbb799bba62954304e,73,61,2,255.5,73,0,04020,2
a1301fd213a60952f5657e114aaea9b5,140,70,4,245,106,34,05040,3
ab3a16addd9301cb608d0915cc5c9da1,181,104,3,422.33333333333337,181,0,10200,3
3934bbfe1ca3ed9303a9444ebc5e5eba,81,81,1,567,81,0,12500,3
bea62202be377ed8fe371aee16c3ad01,22,22,1,154,22,0,09030,1
6d7f632d1bfd10684846c8a06560c0b6,20,11,2,70,20,0,05030,1
f40c4cf1e57e05e68cc2c0d2df69e570,33,25,2,115.5,33,0,05030,1
0777e1434f84a5078b4579e16d51bd67,31,25,1,217,31,0,05041,1
d8d6eac407a76d9600bb316bde061ae7,31,31,1,217,31,0,09070,1
db5170594230775bf843018b637d48a7,101,75,1,707,0,101,05040,3
4109b0d0a3b8b6d56e84ad811a606738,7,7,1,49,7,0,03050,1
2375ab7598b9cea4d203574628aa8cf2,249,104,4,435.75,198,51,05040,4
bcb6271bc92c0ed025f8363a1a3ac147,130,91,2,455,130,0,01026,3
68f1a898be01e11ccf064a2f434f8bd7,20,20,1,140,0,20,09090,1
b0344a5316777f78e038960a394258ae,344,97,3,802.6666666666667,344,0,05030,4
712dfce84fdbd77d095047f8a10464e4,73,67,1,511,73,0,01012,2
075924e1d9d25f06e46e5ca9c7a553ce,154,91,5,215.6,154,0,05040,3
82a761cd1e67698ad7696835c0309f22,97,66,3,226.33333333333334,51,46,01026,3
3da10d62388e45e5bd5b9b34edc5491d,55,55,1,385,55,0,04060,1
44a5cd9fff624ca494911a298135789d,77,38,2,269.5,77,0,09111,2
869f256d6521023180b4c0b92ce6d475,7,7,1,49,7,0,05120,1
1739c79d2b644e016ba3224784b30dde,24,24,1,168,0,24,05040,1
355fc08eeee6590b65607badc3d5bfa1,38,38,1,266,38,0,08010,1
a6afb0945e6d2eab8365540b96ca1c27,15,15,1,105,15,0,08452,1
cbac11d1e55bffcceb45163b741af326,442,191,3,1031.3333333333335,400,42,05040,4
9210f4ee00ef39984abaf5c63d6b262b,48,48,1,336,0,48,08230,1
030ff423a24f005d3e5e2113caf6f1a8,71,50,2,248.5,71,0,08031,2
23ed2081b45e25bfd6bc9301aaed5515,27,27,1,189,27,0,05030,1
f7670511a8ce87efb4c62cbc5e8aed5c,88,66,2,308,23,65,01026,3
fe98e268be54fce0bbbb271245e40d43,53,28,3,123.66666666666667,53,0,11040,1
51ee113a47303f1e940c417b286ed119,56,38,3,130.66666666666669,25,31,05030,2
5ce2e9877668d6d470103ed215a543ae,291,123,5,407.4,238,53,05040,4
2448813977df58a90b5ff257fff8c426,62,39,2,217,50,12,11040,1
2a577e7c8a641aac0856d6fd7b26e624,149,110,4,260.75,149,0,01013,3
c42c6c6e93c2ef5f8beeddaed9e43da9,180,119,2,630,180,0,09130,4
7fab1d81f3644281a6733523ed157c2e,368,168,5,515.1999999999999,320,48,05100,4
9849900b5d45c0fd07fb96bc521b4dc1,44,44,2,154,44,0,09150,1
b6eb7dc6ead7d40d044ab354d502a23d,331,117,1,2317,331,0,05040,4
a15c2b075f90391dea415a492414836f,74,70,2,259,74,0,01026,2
c4250327c9b6bd5c0f283e484c14e34a,146,102,5,204.4,140,6,11080,3
120718bbc8952b8c2852ae642f0ee538,52,39,2,182,52,0,05040,1
6703bff0204f18ff19d92195376a67eb,62,42,3,144.66666666666669,42,20,04060,2
085d6a364f2da7d7b5cc5d790e3952b4,31,31,1,217,31,0,05100,1
761374797b54ea78ee39764e09387da1,37,36,2,129.5,37,0,11100,1
f3043966e47bd932e34de11bd030f542,18,17,2,63,18,0,08100,1
ca3f25eacdfb47810536603412f62185,109,81,2,381.5,109,0,05040,3
a09d27a2bcda5949d37ade40eed074ff,62,39,2,217,62,0,09090,1
d5c4538355267644ced78bd940282794,44,37,2,154,44,0,01012,1
f69a4025d8d2a4b3865b21e38975f4ea,53,53,1,371,0,53,05040,1
15df750643d9e3c89e982c1a0d776005,146,60,2,511,146,0,01026,3
cf23ec1ee78db2811fa4a777d9d7274d,3,3,1,21,3,0,07144,1
3f39637685aef5ab0d5ba104c8dc9866,116,76,2,406,74,42,11040,3
d41149dad23ddd4f5751cfe1ce5ea5c8,39,39,1,273,39,0,04020,1
fb38433c1795cdce87bde239295a3090,1,1,1,7,1,0,08315,1
c940a3a7285122adb53feee647453477,110,100,2,385,110,0,10240,3
61c827b6f1f93221ac1f4a889c2f232a,98,75,2,343,98,0,02650,3
68e734a0489655cacb67c344966c5cf9,63,48,3,147,43,20,09010,2
5173753fd98e7c754d205706da8a4780,35,35,1,245,35,0,05040,1
00e9c71f0153690a041bf98e4617f282,9,9,1,63,9,0,04060,1
b3e2f742517e4505410ccab60d42a958,152,93,3,354.6666666666667,152,0,08314,3
e7597510dbae055739d3dfe486cc50f6,37,34,2,129.5,35,2,08010,1
b87dd5d877bd8fa7b2c694c891699042,36,35,2,126,36,0,08230,1
ee4ab84f37bdf53cb09aa9cac5c8576f,79,40,4,138.25,79,0,09111,2
8237043b25a1d9eae0ce474072ed1ee1,48,48,1,336,48,0,05040,1
acbd0f667c775552dbd7f993ff504dcf,20,20,1,140,20,0,01012,1
803405abaaffccb6357ef39f3f58797f,37,32,1,259,37,0,08010,1
8e4710a2d4f858f4cda9d4c607395d5f,40,40,1,280,40,0,05030,1
75bf2f1bd5621f277b32e4d38e890efd,316,152,2,1106,59,257,05030,4
b8ae6777984894af038ba679955c38e5,72,49,2,252,72,0,09351,2
50b4e3fd183c6c3a50ac9a90e9975b2c,23,21,2,80.5,23,0,07132,1
55c375e722a1a9c061683a33e3b6972f,128,75,3,298.6666666666667,128,0,05030,3
cc6ebb5ee4cb4dbb50202173feb25d36,19,19,1,133,19,0,11040,1
c30e2b31abeff43f4e402a9fe88e8707,17,17,1,119,17,0,12742,1
9bc52194fd0f8c7a08888f73a44ab7ac,108,83,2,378,108,0,01026,3
4053a74034aae6159e9d7caf207ec8da,15,15,1,105,15,0,01012,1
cfd3fe2cdf5a9dde6102358fe146cc96,30,30,1,210,30,0,10200,1
97cfe017c113a4989e7e08f85c247198,39,39,1,273,39,0,01012,1
41b24f49424e3ec6d687fd653505376d,46,46,1,322,46,0,02751,1
422b2cb48643dd37426200ffac6f9c1f,29,29,1,203,29,0,05100,1
fc7c8f4d6fa27b83714cbf6202e78035,83,56,2,290.5,83,0,08134,2
87c25ad81420d55147c589c99e81c4d8,27,27,1,189,27,0,11100,1
6bd3d3402c86ace80ddc5d0f7da51ee6,89,68,2,311.5,89,0,03050,3
f3edb2a3890f733cd483f3e5aadc2aa6,26,26,1,182,26,0,10200,1
708048830d7c47b9d6d45f7c041cb246,390,107,4,682.5,390,0,01013,4
e9d15aadaeba72e56572b99495ca3535,45,45,1,315,45,0,01012,1
0a011e42f913c6f90cac8afcad3b6f95,41,41,1,287,41,0,01027,1
511172b6aa478216d55b92901e01eb67,133,103,4,232.75,93,40,08313,3
a6094e4fac9cac64eb915fa0b2f990f4,318,147,3,742,318,0,03090,4
4e6deea666878a547d270a9cac7d2afd,141,77,3,329,141,0,05040,3
134dff2c7d717f11c60e5ef40a38be77,19,19,1,133,19,0,05030,1
e00681a445badc63141411f6ccce0cbd,51,51,1,357,0,51,01012,1
79c7c62909cbc74507b1c0e9234bc290,269,91,5,376.59999999999997,214,55,11140,4
aec168db8c956a255612f72db8bbe1ba,194,91,3,452.6666666666667,194,0,08031,3
e35d811b8a52104432974cadd314d4f6,24,24,1,168,24,0,08010,1
f2dedae5c08c3c8c2b7dca7a7325a67d,723,219,6,843.5,479,244,05040,4
66ac02c0ffe23cea6e7a2847ccef88d3,66,62,1,462,66,0,01027,2
2bd7591fac009a28b99d5add5df6001d,22,22,1,154,22,0,09170,1
b46bae8404b20b981cc02a7253b57981,110,44,2,385,110,0,08134,3
76f4ecad415d4a012c850a56d1da46f5,48,48,1,336,48,0,11100,1
580aac82b8ac59229ce81cf992967787,21,21,1,147,21,0,01027,1
81f5d70ba0138401383aca52e987dfb8,79,65,2,276.5,79,0,10200,2
e7206820b6569c8d61d92aaa6eb37467,730,221,3,1703.3333333333335,730,0,05040,4
88be935f32f6177e2263b2a7c25498c6,118,66,3,275.33333333333337,118,0,01201,3
a09942703c165d6fcdaf36d51764d926,26,26,1,182,26,0,01026,1
dfa5c7e77917a324b8686af038ba505c,114,79,1,798,0,114,03050,3
7c86a501ad5a6661849202f3987c2caf,19,19,1,133,19,0,13490,1
970e20f9a5cf509b39a48e20dd78d764,182,88,4,318.5,84,98,11080,3
ad40191e0321785ebbbe41d1542894de,39,39,1,273,0,39,01013,1
4812f246b0b2ce8ea2b286417a2b6369,49,49,1,343,49,0,10200,1
83454dcd4076488e42810538ed445374,14,14,1,98,14,0,03050,1
e5b1722109c9a1d262cf05549fb98a96,72,72,1,504,72,0,01012,2
eed3e954d371bd1630805b2b23ccf625,86,61,2,301,45,41,05041,2
25b71dcb63b8980be35aa2e96b7867e9,54,48,2,189,17,37,09130,1
88cfe890855b29d383cd14af8ea8241e,30,30,1,210,30,0,01026,1
57611dcc3ffdda4f4fe50734864b672f,164,106,3,382.6666666666667,164,0,08032,3
dd98ea1057b9d1a2b434c8631e594a4f,21,21,1,147,21,0,01026,1
702be4a6c3ca1dfa2682da2f147b2efd,174,86,3,406,174,0,03070,3
512dc1769d853e919da3af25d309159f,3,3,1,21,3,0,09190,1
8fc16dd73e90566982aa424db3e5ac12,276,137,4,483,144,132,05040,4
4b4e7bcbea3cfd106ff5b6be3fab0c58,37,37,1,259,37,0,01026,1
730c1e7404583d6823aefda039bfc14e,22,22,1,154,22,0,09010,1
cc23d0a6d5be95c76e133fb3d35da5d0,43,43,1,301,43,0,10200,1
b3e189b2044561339c750f76394aa95d,98,74,3,228.66666666666669,98,0,01027,3
4263f25cf509099caa236c866065bb6a,231,106,3,539,63,168,05160,4
e2a163b479d0e972605cb96be3463584,85,67,2,297.5,85,0,12501,2
a0124d16ba2eb0fde0fc10072da78245,13,13,1,91,13,0,09070,1
326d2b34a00a436e4f649de45c886754,22,22,1,154,22,0,05040,1
c3bf70c03f8ab6e853cfa4c11d5a80da,64,61,2,224,26,38,09130,2
54e10730d9f1bc10ee6d8f5b435c2dc8,81,69,2,283.5,81,0,01013,2
89433c560ad47222b6300390a3be6268,341,143,5,477.4,221,120,08312,4
4474a7738a6b1443656bdbfbbe996ef5,79,59,4,138.25,79,0,05030,3
8c8b1987d781551ce0280f2686abf9c1,9,9,1,63,9,0,11080,1
9abdc8ad4d1ae5185e23b66174faa769,34,30,2,119,11,23,08031,1
17df16d024dd9b54a615e418a9a783da,83,69,3,193.66666666666669,61,22,05040,3
f794af7352f400645b184b2e723f1485,268,131,4,469,268,0,01026,4
61eda852881119059c7c11e2009f7c06,86,61,2,301,62,24,08314,2
a1cc9843159506374cd7b267eede6b63,9,9,1,63,9,0,01013,1
8880a72434896753aa6d1e8c983a46cd,55,55,1,385,55,0,12500,1
8d83126e080607f34fd1aa5c63f7ac8b,252,97,4,441,132,120,05040,4
c1091c006c869eaa7c16df58d93d235d,293,112,3,683.6666666666667,293,0,05030,4
cc3c8ef82cee77317b457d0eacc2b66f,52,39,2,182,52,0,05030,1
0b8a4e4f714729e97da8fa0f135a442e,28,28,1,196,28,0,09130,1
6eee3b46a78b93cfcb98e622b2a2cbb0,170,97,5,238,170,0,01026,3
81a63f2446c50f874a313c62098c879f,23,23,1,161,23,0,05040,1
449edb411e4450a65f8efc55461983c7,199,108,2,696.5,199,0,05040,4
4bc34428ead5426406f50a034f8428ed,26,26,1,182,26,0,01026,1
6ebe7512b4fd0aba5c2aa50ac7a3da15,19,19,1,133,19,0,05030,1
a49ed5018ef68633fe8e58dc7ff1b711,30,30,1,210,0,30,04060,1
b19a632755d4b256b660e83fe6c40094,178,84,6,207.66666666666669,150,28,01085,4
e47a61f1834869f84b936cf6a8e196a2,19,19,1,133,19,0,14301,1
a78d1f9652d591f5099ae8fd577f3cbe,47,24,3,109.66666666666667,47,0,12691,1
c797f095c6a8abdb77dbde06a0b37b81,3,1,2,10.5,3,0,11040,1
8ff060569e039c5391f2466130f5dd8f,228,144,2,798,228,0,03050,4
b0b5d2126f393e2a313264f93e3a734c,24,24,1,168,24,0,01026,1
220bf7eca155f2d45761e45b3bc9fa1b,51,51,2,178.5,51,0,01026,1
645dad33ac63b29da22aa5d5b8c1b788,214,126,2,749,175,39,05030,4
13658e12902d30f337247286e49f86aa,3,1,3,7,2,1,11040,1
5bcfbfdd7dac63ab9eb945385940e43e,214,128,4,374.5,214,0,01027,4
5e5fe54dbf1e7f5a941199f8fe972287,35,29,2,122.5,35,0,09010,1
74751a88d01b8663c96562b22a80186e,26,17,3,60.66666666666667,26,0,12650,1
166df854206c983b197ec08ff375b2d5,24,24,1,168,24,0,12710,1
020914cd34c55f46673a4c85a6a510a2,43,43,1,301,0,43,10200,1
a2a48bca9f088a23eb1dac7647338fb4,113,72,2,395.5,14,99,01026,3
aac587ab722f99e4f2a46450b20c4775,403,89,2,1410.5,403,0,05040,4
7c174789bad67e1e331d7cbb335a4250,34,34,1,238,34,0,03050,1
f7a3408de5573a461f029432f3468baa,35,32,2,122.5,19,16,01012,1
2b75e5b610a8943bae27295c7f2a91a8,9,9,1,63,9,0,05030,1
6eb35aaac9744b324beacac05dad272e,154,96,4,269.5,154,0,04060,3
1a715095d1cdb072702a343407c606fa,85,37,4,148.75,63,22,06100,3
db3b8a896632eb2c5cad70ff022371bc,18,18,1,126,18,0,08010,1
954bd49b216e3b84ffa5e51b0761099b,31,24,2,108.5,31,0,05120,1
c61272d66055a59a845f5570270272ba,79,72,2,276.5,46,33,08090,3
45cd9ac4b4c8b0e4d5ac01546fbee1ee,161,105,4,281.75,124,37,05040,3
037ce11383676471f039a77a03aa776f,9,9,1,63,9,0,14301,1
396bc4058f4cbb06dedbdb1c4bba2a20,50,50,1,350,50,0,05040,1
f41fd00aa94420b4ef92088107943b62,139,89,5,194.6,120,19,01012,3
11feb5f3b35ca9442dabd1f1f083b11e,33,33,1,231,33,0,01026,1
8fb081aeaf3ea6db74ef0379a883f7f9,467,118,5,653.8,444,23,05040,4
418cfa3be30cceca02afc964addad245,54,24,4,94.5,54,0,01012,2
fac203cb3d78818fe22b3921f898023a,110,78,1,770,110,0,01201,3
bce31ff3f5933761a80ad7c2993ccbdf,55,46,2,192.5,55,0,05030,1
29947aa7370f36f8bb947ac58a133ebf,75,52,2,262.5,38,37,04080,2
17182f8060a50da785c35e6598ade05c,64,50,2,224,25,39,01026,2
2d06567598e16a99702fe20bd3065752,10,10,1,70,10,0,04032,1
bb9cb2f46b61930760f76eb6f6642615,32,32,1,224,32,0,04032,1
c69d7692b1554693ae0e4c12a7ebcd10,108,38,4,189,108,0,05030,3
628510acbb9304b1c5811c268df9488b,8,8,1,56,8,0,08312,1
768bdda0d28358a80b0929455459f1e4,118,75,2,413,118,0,12500,3
5539bb41dad59530224598c57dd5a1b2,48,31,2,168,48,0,05040,1
87d337e65213e2536ed12d24d7f4edea,68,55,2,238,24,44,04060,2
bda4c9d8620cfadd85cc8c003bacf764,570,170,4,997.5,570,0,05040,4
c762ac4b80fa2db79f6fa95ca58c0f98,29,29,1,203,29,0,04201,1
18c160e40df3d40da7f9475305355d7e,53,53,1,371,0,53,01012,1
7d518763b3b424b930b7513031f424d5,229,95,5,320.59999999999997,229,0,05100,4
dd3ba37ab5d51cf7a158f6fb269f1b96,62,62,1,434,62,0,03050,2
af3bdb2b524911f921fab9e13735e7f6,20,20,1,140,0,20,08230,1
255ee05755d0d9e9af4b42f71824ed32,142,98,4,248.5,83,59,01013,3
25379a1b675c5b24065e428346cd2328,30,30,1,210,30,0,01026,1
b4342bd23129ab63e2473b938767f3f4,178,95,5,249.2,146,32,10028,4
30530b45e0b825667b9cdfb6f3511713,190,104,3,443.33333333333337,190,0,04020,3
cccc1355cd751719358dd4e7d0c18ca3,61,43,3,142.33333333333334,31,30,05030,2
dcc96f21f492081035f9e3b16f2a551e,114,52,2,399,48,66,08100,3
0c3c53da433080616cfb87f7477e8044,64,64,1,448,64,0,03070,2
3467f85672cfc6d99b5f08b79c94a019,353,140,3,823.6666666666667,151,202,01027,4
a34f7ab81637b822f20377721fdb639f,128,96,5,179.2,95,33,01027,3
dd81caf5ff1110f68e75b958cfd5fac9,76,58,3,177.33333333333334,54,22,10200,2
969588db9e5713a71e2cd4596a5e9c11,209,135,5,292.59999999999997,168,41,06100,4
89328cc0669560d0483cd5f5c9c7f7f4,23,23,1,161,23,0,03050,1
3b7b69dc677488483fbf8957c6e679ca,34,34,1,238,34,0,01027,1
29c5ac0bbd602333ab0fe56247aef116,171,104,4,299.25,104,67,05040,3
2bfb435bedb321ebfd0dbdc5f4770c51,39,36,2,136.5,25,14,10200,1
48e0476466357c400f89917ba41bff1e,2,2,2,7,1,1,10080,1
97f7b0763ef0e1e6c98182e289f9ebad,167,85,5,233.79999999999998,140,27,11140,3
451041f2db8242a078e129271cbb0188,31,31,1,217,31,0,09150,1
e40cc5b06665da8eda40294ef0249dba,213,94,4,372.75,176,37,01012,4
94b833cc1f4604cdd83e14dc73f40539,4,3,2,14,4,0,11080,1
f41fcb23d980ec9c6a7a6ef487ae63bc,150,102,2,525,51,99,08052,3
d1cfea8a06b10416805c1aa02003940b,41,41,1,287,41,0,12570,1
623465b9c322497639e8c0ea9f530617,30,30,1,210,0,30,05041,1
70a6541f5a16692338f8d5c41e504ec6,33,33,1,231,33,0,09110,1
cc751e39706553e7f229958844cc58cc,32,32,1,224,0,32,05040,1
89a22d15cc93d94c0e385d0d1b59d1dc,216,137,4,378,216,0,01026,4
3d8f124dec067182df8d960234c3c9ad,136,77,2,476,88,48,04201,3
774c5bde8a7d5969e22e3ea26adbf3fd,35,35,1,245,35,0,01012,1
bee7b6769c1d83de6f2720f60384fffc,159,95,3,371,159,0,01027,3
c385d533a4c761c783064721bcfb57a4,32,32,1,224,32,0,05030,1
6fdeda86a0e842c22b2f9d2b79ee1574,19,19,1,133,19,0,03070,1
2d320fe9a83f6c9c6003f0e5d0e7fad2,75,58,2,262.5,75,0,05100,2
f57ffb7a7aeb8387e105bac2d80d21ed,22,17,1,154,22,0,11040,1
dd685dad37abc4352c9b251430c02ba1,48,32,2,168,48,0,05030,1
1ac30fd261b84d369fb037ac64516924,53,53,1,371,53,0,01026,1
d09ef6646441a0673898e0670b6d1601,43,43,1,301,43,0,01085,1
19144532e1733ec2938cae854f7c3e28,2,2,1,14,2,0,13930,1
256db02521093f40c55453bcbc1d3b66,100,71,3,233.33333333333334,100,0,11100,3
d59b97789bf31543d3eae89e1d13c267,55,55,1,385,55,0,12570,1
90815f8aab10def482dda37ab277bbed,239,91,5,334.59999999999997,193,46,01026,4
858ef92e0662fb4685d69017db065164,72,49,3,168,27,45,11080,2
2b67d3456fb5d71ef97ef2edceb0104b,36,36,1,252,0,36,09030,1
b1ca4de122ed44b4fb5e8d429f5d9f74,241,74,3,562.3333333333334,222,19,05040,4
c5a2e29fc086ac197f92aabb8260675e,110,88,2,385,110,0,04060,3
08afa8ec930c96fd38213c5bdbb99e22,23,23,1,161,23,0,01027,1
bda89ecfee94fd9fa64f50eee138a055,18,18,1,126,18,0,08230,1
ee2841134e9cd944007b8e37bf975abe,15,15,1,105,15,0,05041,1
807f675c58da08c0554adffcc5ce4e4f,9,9,1,63,9,0,11100,1
c0faa92663e60058e128d7a8bd36be2b,9,9,1,63,9,0,01012,1
fbbb7582dd3dc8b26fe30bb1ed0e3598,22,22,1,154,22,0,10200,1
8ff0b0b334a80adbd87cd071ae0fa949,146,86,3,340.6666666666667,146,0,01026,3
0aa1873e9c9646709f6e7e48b3456fe9,67,61,2,234.5,42,25,05030,2
8460a6f593785472de3ec183cd9300a1,70,26,3,163.33333333333334,70,0,11080,2
43e93633f84d1050b09b520e0c27704d,209,139,4,365.75,131,78,01027,4
936446412c6082d2050d9fa9c66f2201,53,48,1,371,53,0,09030,1
c4f79d00e7fbdf9a60ac76b276206895,14,14,1,98,14,0,05040,1
5334884356b81f25a08157b6b77656f7,20,20,1,140,20,0,05100,1
bb792fe33e820c5c66501bbe45fec1f0,64,46,2,224,30,34,05040,2
bb5cfafc16d2d2105535d0aa4f29792d,34,34,1,238,34,0,05040,1
e7f119be066de667368503d86e54f06f,99,54,3,231,99,0,04060,3
7d85d7ee304587798cb3c0276e2d8c65,128,69,3,298.6666666666667,98,30,11100,3
8c208a89e0d8ef189b45a53373963fc8,60,60,1,420,60,0,05040,2
672c78dbfbe9dcc04c3ce95ef82a8dfb,25,25,1,175,25,0,01085,1
8b71d043a0f1837ed8fa1aa2b375ea38,133,93,1,931,133,0,05040,3
3c38d9f5b2441c65f02f6fbd35d3ec3d,67,57,2,234.5,67,0,05030,2
cf4a9c391269eda5eba1139a9920936b,76,57,1,532,76,0,09010,2
005657f891fe26a59ff7c86ecdb3540f,53,43,3,123.66666666666667,53,0,11100,1
46ef812b4f21e85a21aba5beade5afac,16,16,1,112,16,0,08032,1
347b316982bac3aa852fbc2dac978ae5,190,122,2,665,190,0,05030,4
7ce991b33d0d32852ea99f49b25d50da,401,118,2,1403.5,56,345,05040,4
8219a5a347437a351c6a7e47167022ae,38,38,1,266,0,38,03070,1
eb2c651816628ebb936755e32b283048,74,66,2,259,38,36,05040,2
640c1049c47577062cdcf9618b50a9cf,23,23,1,161,23,0,02690,1
f5405a07bfc5f09daa9712e78fa8b05b,82,61,3,191.33333333333334,82,0,11040,3
5a89efc22b9590fd935b251630556ba4,41,41,1,287,41,0,04060,1
762c9cebc09bb1916c1310322e8f8c8c,12,12,1,84,0,12,05030,1
6568d495509dd8a9185f1890bd3e9fe4,3,3,1,21,3,0,11040,1
c577418a97817ab3461e9f886294b3b7,17,17,1,119,0,17,09091,1
e8e9e95219395ca492e0430492a259e3,38,38,1,266,38,0,08090,1
87c95ca96539d7d26c353e5b1c9935d6,62,62,1,434,62,0,10028,2
3ffe4c725a6d9c78b3bb28bd223ac1d4,19,19,1,133,19,0,11040,1
80e8fa47b7c23adc46099e2f3960c656,13,13,1,91,13,0,10200,1
bf9a5ae19996ef4d133ca928ef0e4b33,225,104,2,787.5,225,0,04060,4
9f019c6ed84b679b9ee11b13e5313670,54,44,3,126,41,13,11140,2
37f88586f7ef6f92a3d6f331bac0a488,21,17,2,73.5,4,17,04020,1
cd4b265667cf83d66c676247ed0502f7,90,76,1,630,90,0,01026,3
a1ad746cf426a030245d416ada3fe4e1,81,60,4,141.75,53,28,05030,3
7d0f53f6ccb2b736e80fefb517711b14,29,29,1,203,29,0,10200,1
1d794bd2f31fe274c6e10cee73ba560e,50,30,3,116.66666666666667,50,0,11040,1
891074d52fac689c2b5ede4b88e497a4,26,21,5,36.4,26,0,11040,1
e488d2b8b799286a2adfa29bdda46a71,46,42,1,322,46,0,08230,1
1c93c0306a5e046a4ab5c0bde63f6862,136,66,4,238,136,0,05030,3
05228beefca579b24ed2150682c60c35,21,21,1,147,21,0,01026,1
a6f9dfb1dae23de504ac77ed8621c177,44,41,2,154,44,0,02690,1
8483a521f232fcc079ae644c8eefd451,45,26,2,157.5,45,0,05040,1
71fce9a96a16e85def8576dfa8e069c3,51,42,1,357,51,0,08051,1
7af728fba9bba014cd0662bb64928952,19,19,1,133,19,0,08150,1
7be1707239235d6ca09c47a102638ac8,65,52,2,227.5,65,0,04020,2
34254f974b32901e5fefab3f6bf9c855,1009,226,2,3531.5,929,80,05040,4
f9e56b2e139c2919d0c93a218bea3868,13,13,1,91,13,0,01017,1
55a000efa98264f45bbe87606754b155,98,65,2,343,70,28,11100,3
da49318e122f3e411540cfc24212de49,167,76,3,389.6666666666667,130,37,11060,3
a503130b4528bb9f5f2dfe7acfe2cc3a,34,33,2,119,34,0,01013,1
1c6bc42ed645afe1200d435cc4c1a453,23,23,1,161,23,0,08052,1
c7d573c3f6d7277f0cf8f8b1bdde7633,91,58,2,318.5,91,0,13830,2
3c513de0c68a914b14ab613fc42f952e,43,43,1,301,43,0,05040,1
95ed92e7184ba337902a77837e916104,26,26,1,182,26,0,12590,1
5fc9cdbe819b18333400f7966552bbb0,19,19,1,133,19,0,11100,1
8670f625a9a3e0acc679ac0a04840d15,28,28,1,196,28,0,05040,1
25be68e80b308c0cd8dbef601266448c,114,75,2,399,114,0,10280,3
a60fde20f5bcfabf856734d8b67fec4d,69,65,2,241.5,69,0,02690,2
24dffa8a84004fa40c8dba35870fc47d,89,51,3,207.66666666666669,67,22,01012,3
8cd0a7e41dd21111489a522d95c798cb,24,24,1,168,24,0,11080,1
0af970805f18e078f1fa709658fb105d,34,25,2,119,34,0,01085,1
e773217f370cd1e503db01007dbd1e91,65,52,2,227.5,32,33,08230,2
c84c8a4e3b75d8fadb3e8cd723fb74dd,5,3,1,35,5,0,11040,1
a560b59087dce9d6e5fe241324995e02,19,15,2,66.5,19,0,09190,1
1a80dc685ac40a3aea303baded189dfb,137,93,3,319.6666666666667,101,36,01012,3
0b893bd3f455772c002656a9fbe04ef8,267,133,2,934.5,72,195,05040,4
0f1c17f7e577fe8b0a100f63caea4d66,39,39,1,273,39,0,09030,1
5412f9abbb6ef3d0d949dea5f1a1c633,29,29,1,203,29,0,08051,1
80da7d7ea455b4a8ede448ef5ae0ddb9,20,20,1,140,20,0,12650,1
8f1e529840683efb1b02cc47754dae06,12,12,1,84,12,0,01012,1
e61d5c7f5e6db32191a67280a8137a34,42,39,2,147,19,23,04020,1
1061b0e9bd1f984e4d0f9057b6a12509,1,1,1,7,1,0,09170,1
7d211f708630535ed7cc7fad2ff39649,37,30,2,129.5,15,22,03070,1
74ed1c6d96236054b44ae30959eeee47,38,38,1,266,38,0,04060,1
128e0d6ea2be3fad16bdef9fa0e699a2,88,58,4,154,88,0,01027,3
462ee06a657778e7ec9de8dab1b6b600,47,47,1,329,47,0,03070,1
0b802065a7006ded9b354593b5838051,82,76,3,191.33333333333334,76,6,01026,3
9424cc9a7df40a682241bf8af1316fde,16,16,1,112,16,0,10240,1
40b5db8bb3f68fc3c8d33b871d2b7838,71,59,2,248.5,71,0,01026,2
0f7e1071af3542deab4393cf1e29de2f,95,72,2,332.5,72,23,01085,3
3b287bd6da2d9e3aa81ed0c356ea9979,43,43,1,301,0,43,05100,1
88a602c3a8e18056cbbde4b85d819b63,86,56,2,301,86,0,05040,2
e1b20fb218df9d738b782d03938a0dc4,133,63,2,465.5,133,0,01201,3
2fa9e8f31f980ec001bea8908ec8d5dc,160,65,4,280,127,33,05040,3
4f4830dff58773c3e203d7f2cea16baf,12,12,1,84,12,0,04020,1
8faeef2ad09d5a3853b5704e93c70373,198,75,2,693,198,0,01026,3
a15adcda332ecf1f7ba26321fb8986ad,11,9,1,77,11,0,10140,1
6a866dc5ced84fd6a3dbc789fc387f3d,25,25,1,175,25,0,08010,1
4a9c8cb53c200dc262fe7cbe6da159d2,192,44,2,672,192,0,10200,3
d27a7d0389c1b6c9060572ae65f8fe57,76,74,2,266,57,19,05040,2
87709736288af76865d343be69e20bb6,48,41,1,336,48,0,13830,1
21e20a6a53438f9d07ebc0c42c34d462,41,41,1,287,41,0,01026,1
5ae4a2509a3048675902958ad25cb493,15,15,1,105,15,0,05030,1
97335eb111ba1e1c5ecc638403c17393,88,74,3,205.33333333333334,88,0,01026,3
d1f75442b19afd82c13ed9deeb282458,22,22,1,154,22,0,06120,1
fb8ee8d624adc6b07fc5d4634bbb42c1,54,54,1,378,54,0,05040,1
2722c1a688a82d8a425141923915c269,27,19,2,94.5,13,14,11100,1
a9693d256770ab61f1bfb27d5fc460aa,128,71,4,224,128,0,05040,3
eb2b76cf9aad4f86d2c548e5afd99528,86,64,2,301,86,0,01027,2
5f9a30445a52ad92709594e1a47c46f0,266,129,3,620.6666666666667,266,0,09150,4
e53647741954c604199ed2ed2b447116,36,36,1,252,36,0,01026,1
7fb3ba5ec8de701066bcc8b250d06387,59,50,2,206.5,59,0,10200,1
4bdf4c915d75e6c3637baa35e0bdded1,53,46,2,185.5,53,0,08100,1
43d2a098f3971db87833cf7bd92582ce,45,45,1,315,0,45,05040,1
4c9f327aa1d619848e745a3952462b5f,26,26,1,182,0,26,01026,1
6c952c431da17b1a0ba730f75093c01c,70,58,1,490,70,0,01026,2
dbb0cbbae3c34f3f360232deff9f7fae,96,41,3,224,72,24,10153,2
7d4d0e16752c08b8867d2827f6a40a06,47,40,1,329,0,47,08051,1
afb8b0e7f446423cbf6dd39f35f1e04b,197,79,4,344.75,85,112,01012,4
1868d4d4c9f288325688cae5c35c345a,129,78,2,451.5,82,47,05040,3
403716c33af6f4c3790e6c5d46ea36a7,50,42,3,116.66666666666667,26,24,11100,1
0e6959750e4cef720644ba0541d6d99d,31,31,1,217,0,31,02620,1
fc488c893827a7a83474ac26d9fcd43b,88,79,2,308,88,0,08010,3
f269f1e71e3891102c1b57d9503691b8,47,42,2,164.5,47,0,05040,1
70d5b14f5fe0c539807e4255c1de4f39,60,46,2,210,31,29,05040,1
2a1b5e4ae0cc871c188aa1ab8bcfaf98,8,8,1,56,8,0,10200,1
e965609a7d6e1cb4be5c3c8310283c28,401,116,5,561.4,205,196,01013,4
8e19f80ea27f4e5aee9d02a9f3494175,81,69,3,189,81,0,01027,3
8d63f5e5d5c04797facb1ffcbf4920b4,163,115,2,570.5,163,0,01026,3
b7fdce9fc31011f073ed91ecd4dfa961,131,60,3,305.6666666666667,72,59,05030,3
1c43558e69dc91c1f456162eaa844b96,15,15,1,105,15,0,09111,1
98d71939ce8eb0b2aca7e42bb6b961c0,70,70,1,490,0,70,03050,2
632e40890ce0f807e2fb5ba78ade3ca4,184,101,3,429.33333333333337,184,0,10200,3
7dd88553d5e2bcb26f08bd4abe5a7215,19,19,1,133,19,0,05040,1
6094a7ae28465e896cd3375be14c2e99,4,4,1,28,4,0,12470,1
8964d6ac8987f47a085f6712bc4d9276,110,71,2,385,110,0,05100,3
2c8a2712553cd1b0df640040e5c13030,33,26,1,231,0,33,09090,1
320c0ba3849798867e6606da5765fa2c,130,73,1,910,130,0,03070,3
b6b21822bc45957afe28b2101c198db2,38,38,1,266,38,0,01012,1
acd841a4295eaedc3bfe6c953e0f9ea0,972,269,2,3402,972,0,05040,4
5875d7c3b33d28264001a77783e0c5cb,31,31,1,217,31,0,01012,1
859293b7be594f9b7671862d78bcc280,29,29,1,203,29,0,09130,1
e0ea41ab2aba90af3e6675920c8ab87a,3,3,1,21,3,0,11040,1
830bb0a23815fdf9605061416872202a,72,53,3,168,52,20,11040,2
cc9ce018a1ae36f57c1ee6112d6eec21,91,69,2,318.5,91,0,04060,3
b18e26e0f5a2abdb65c070842f09d545,71,42,2,248.5,46,25,01026,2
e42e890e38b433619cc76be46703d23b,261,126,5,365.4,261,0,01013,4
582d8e531021858d491fb65947a80578,17,17,1,119,17,0,13830,1
64fcb7e3499986304e76d4249b108f70,29,29,1,203,0,29,01026,1
f0ee01eecd3ba7bcd03f7b55cc6cb408,24,24,1,168,24,0,08090,1
cf3c9a60cff383e74c377f4afa39477f,55,46,1,385,55,0,01027,1
dd3c234af039b0028de1b964aed5b4b0,24,24,2,84,24,0,08231,1
65ebeb750d5efef62cbed98ac981c858,78,32,6,91,74,4,05030,3
c1764c69087ad83f49d5e311f02a3846,208,84,4,364,208,0,01013,4
8d2856f21855c478985eee1bc3cf8064,258,105,4,451.5,258,0,05040,4
50b46dfe5bcb6436876a20a5ef2b65b4,727,258,3,1696.3333333333335,727,0,10200,4
9f15290d8ae9edeb891869a8c63ac117,261,115,3,609,189,72,01026,4
0fcbc727e466bb5d31fcad63d22a46c2,20,20,1,140,20,0,01027,1
3b6a6c59d1480172dc022daaeb4a42e9,51,41,2,178.5,33,18,08032,1
f21d1da9f967567b2b796e4abb2f5882,114,69,4,199.5,114,0,10101,3
578776db2fc8003c70b9f1d59dc0897b,171,163,3,399,171,0,11140,4
28c0dde394987a40d8cd359a571969c3,7,7,1,49,0,7,04060,1
32c6e5d07be6a6be3d353215dac32252,126,88,1,882,126,0,01012,3
275412bfbd9e4d8a95f95a828a1e1b5a,118,88,2,413,118,0,04060,3
c615f4f4609c060cadc5f61eddc7cef7,256,115,4,448,216,40,01026,4
7d7a263a1c071bbc7608780af906d591,91,67,1,637,91,0,01026,3
1a29515b1503d394c71a99ef77491e67,87,53,4,152.25,87,0,01027,3
55c0f01ec4b262717e3ea946635f4920,14,14,1,98,14,0,10261,1
6ec94eefb4cf1d9c69cc2f785ddfc4e4,100,67,3,233.33333333333334,76,24,10200,3
80902972ee860922c094f496c6b17c3c,17,15,2,59.5,10,7,02690,1
c9e7a7a871425e2755d5d36fd05bc9e5,12,12,1,84,12,0,01201,1
dc24548d8271da90c950ed83b16659be,24,24,1,168,24,0,03050,1
fa63ef4a6d88927c844bc4eb27db4dde,32,32,1,224,32,0,04080,1
73d5d2127e522e4e3dbb2589dcc746d1,79,56,2,276.5,79,0,08100,2
3c18a0652f59c4d52a854816fcd73e01,48,39,2,168,48,0,05100,1
b076dea9200ae869e18be5736cc39366,70,50,4,122.5,70,0,11140,2
879b4ba2c6cda30905e0e546edd5684e,82,71,2,287,82,0,06100,2
5696d2a4e4dcb76cfbcefecc67c0eddc,208,107,2,728,208,0,01012,4
00621b050938aa94253b4907ca3a423c,72,55,2,252,72,0,05040,2
ee05e04d31484879276914066b7c27a7,230,99,2,805,230,0,01012,4
daf79ce8b445602f1c7ecd6bb2e30d45,64,45,2,224,29,35,09130,2
3218e8afaaba0a9502b439dbb794eaaa,255,136,3,595,152,103,05100,4
698cb617d6713ac827b04921f01dfed2,15,15,1,105,15,0,03050,1
91de430dd90ce3685cea876796542187,18,18,1,126,18,0,05040,1
0bb4175aa3ab74ad998b995f6338a8af,86,73,1,602,0,86,05040,3
26294685b0ef43230118d8cbd2d7b3c6,89,39,2,311.5,89,0,09010,2
fc323525a07c50b510ba7ec0a1f7884f,23,23,1,161,23,0,01026,1
26fd2620c590a20d07803d74eb098e41,84,68,1,588,84,0,01026,3
5123fd7a7e9d46ceb054324814f35a3d,63,63,1,441,63,0,10200,2
7ee7530b0f1e6eee2572fcf8845b9055,28,28,1,196,28,0,01027,1
8c33ce3ae901e5ade3fa0c758fae8b51,21,21,1,147,21,0,02756,1
05cd3651cd980e17f83df473d8e82154,14,14,1,98,14,0,01012,1
1b3e07bb0eeec78630e99d66ba8cc924,70,59,2,245,70,0,05040,2
e50caeb026f7c6f534901cbbdf73d585,217,81,6,253.16666666666669,158,59,03050,4
3396b30ba170a3888ea883919ac130be,292,131,5,408.8,227,65,01026,4
67c2b6efdd2cfd7806449afb149c9397,61,61,1,427,61,0,01026,2
d620d1648dc02af642b65ce1ba1bb476,134,60,4,234.5,114,20,02651,3
57fb47ce2b2228156f716505020c1959,87,72,2,304.5,87,0,01026,3
73d94fcef88b15b4db45733cc0ac2e23,38,38,1,266,0,38,08010,1
d198b08715f5a689e6c448a88af1c7b6,190,93,5,266,159,31,05040,4
81a93f3c73f2e0a7cb011ae4c9be6439,184,94,2,644,1,183,04080,4
253e9abb0fa25221997cc62420dc792a,113,81,2,395.5,77,36,10220,3
e5df97ff15ab7b28adbc0113e0ed9164,69,62,2,241.5,69,0,09130,2
a71af27f251a87783b40eb62ff04215b,14,14,1,98,14,0,09150,1
e350e0e88a603a39de032041a7449d38,59,39,2,206.5,59,0,05030,1
7d5a41cfa3e68350902687f2a4d02f5b,313,155,5,438.2,232,81,01085,4
7de4a5fc8b0ac3c6ab93c3bdd7480733,10,10,1,70,0,10,10040,1
611d0c45ac975821454573f29111a986,99,62,2,346.5,71,28,05040,3
5bdb00d40202d1c11d0422dbf909ecf0,370,101,5,518,326,44,09090,4
4c1e5cdb35b09f1745b3a0c45bd94f3d,34,34,1,238,34,0,09090,1
3ba2b7ca3a8e25af541dd1cf64a93fd3,39,32,2,136.5,39,0,07123,1
717944b726e0ab851100018187dee09a,78,49,3,182,78,0,05030,2
26f806dc41cf24f063a00ec731ece7ab,366,155,5,512.4,366,0,01027,4
7c1b458b94d53e2603e3a12463637540,15,15,1,105,15,0,05030,1
85b654dd837b908f02f6044fbdd27c10,36,27,1,252,36,0,01026,1
86fce598e1117cbe5ea6cc19878c79de,102,66,2,357,102,0,11140,3
e7c83b7ce98f03812774fa1233be70d2,45,38,2,157.5,45,0,08314,1
8761b49266ae0260497386dacf82f0d2,31,31,1,217,31,0,01201,1
14336d6a5ed63700decf8ec8ef90622c,97,69,2,339.5,33,64,02650,3
fee2bcce6b26f41e493660b93e7b3dfe,318,162,4,556.5,255,63,01027,4
0bfb3b79a780838f9cc244f028e39b04,201,90,2,703.5,201,0,04020,4
3dbd42bc1589d9503a7a19a5a26262ef,98,69,3,228.66666666666669,98,0,02751,3
b4dbbbf8283445945f0cb138739f449f,682,152,3,1591.3333333333335,110,572,01012,4
3063a104ab487cccbbc2d1f428941071,30,30,1,210,30,0,01027,1
60a291ba142b93f8577aee58d372a8ba,314,156,4,549.5,313,1,01026,4
279ea14a5c4578083ae4cfa95e29a346,23,23,1,161,23,0,01012,1
180f29c55e2f0a03bad167816fb3a38c,276,136,4,483,237,39,10200,4
2188bddeb86c0e659fab8be8b78323c3,128,71,4,224,128,0,11040,3
3b3e51a692fcb5d510d067453ca3d05e,121,79,3,282.33333333333337,121,0,05030,3
743b14c39fe28fe6b34a98b34825e680,99,53,2,346.5,99,0,05030,3
45eea1cad209657c69a10fcc153b4c50,180,104,3,420,180,0,01027,3
513cf2a4b1bcb92f32f59234868e2696,137,86,3,319.6666666666667,102,35,10200,3
20e4fb078cf6c9260795e4521c7c969d,34,34,1,238,0,34,05040,1
3c35d801b463181ed4c2b81a37facaaf,62,49,4,108.5,62,0,12590,2
f4e5093ec0a19fbbd7f5160b4a3c487d,51,51,1,357,51,0,04020,1
ab610a6cbf67ccb2e1b04c1d4757a75a,69,44,3,161,60,9,09130,2
9305235ead5601905c8cdd07c74b7351,70,69,2,245,70,0,03090,2
09fcdaa72cdfb327023abd80ced876c7,31,31,1,217,31,0,01012,1
6fae78dc62d83eadc902e43d3118300a,32,32,1,224,32,0,08032,1
c84ac76e3d3a80743f64623a51f1919b,35,35,1,245,35,0,01012,1
9a22e123eecdaf338d9979c55497603b,83,66,2,290.5,83,0,02650,2
6901532d060491118a4f311f593000ed,43,39,2,150.5,43,0,02690,1
cc7754ac82036cc84c09259c77429381,125,82,3,291.6666666666667,125,0,05100,3
daa4e40b2ab9036649fbb37bc6933b51,291,147,4,509.25,110,181,05030,4
f97fc00e9419e2f1995174a865655ded,32,32,1,224,32,0,10200,1
9d3c957862509503999a64dfb4c866b0,73,51,2,255.5,73,0,05040,2
752acbf3017e1ecfefe827bb0d40ae16,227,96,4,397.25,227,0,10200,4
36294544e83d6dc8e932eec9f8e3d786,33,33,1,231,33,0,09130,1
a3d3663077187f8c8ed2f3fedea17a0d,191,100,4,334.25,115,76,05040,4
7739bad96eb699849a5b4b90beb489ee,89,74,2,311.5,89,0,01027,3
d0b696ee47e4585385df7068b9816500,13,13,1,91,13,0,07122,1
b16a72348e4527cfaa13946bbed05335,163,87,3,380.33333333333337,163,0,05040,3
22508fc65dc79607b86ce15ab630de74,60,47,2,210,60,0,08170,1
c0d70bdfd82970430176251c7c70ea53,48,48,1,336,48,0,05040,1
fcbd8e9bc4cecf3d0c0439c4ce088af7,138,90,4,241.5,138,0,08132,3
f5e23291d449433ca7746b2e6564b136,32,22,3,74.66666666666667,32,0,09010,1
90dfa8a6b58c8cbccb0cbe801d50b425,22,22,1,154,22,0,04020,1
dc041dbf7db478f092643b0a3b9c9cca,38,27,2,133,38,0,05040,1
a39a725e964785095fafb66b1dcb9843,200,106,5,280,166,34,05040,4
88c3997a2b960d11d678478d84023b93,126,69,5,176.4,105,21,05100,3
d24f3c167393053e6a18b362ca1e6591,20,20,1,140,20,0,03033,1
a25876d7d7eb2dd91e5a1e90661980cd,19,19,1,133,19,0,01026,1
7308c61f38ecf780bb3a3735ce997517,28,28,1,196,28,0,01026,1
13d253ccc1db792fa99dde32dfab67f9,122,75,3,284.6666666666667,122,0,05040,3
ef5df3e18db479fe79d23ee4d805d399,95,73,2,332.5,95,0,08452,3
0053f67b3c94ef9758de3aa1e43abe65,305,126,5,427,275,30,11100,4
3d4378c718c2a533661863c3841c97cd,567,233,3,1323,524,43,05040,4
142acb1ac5fa1bee1f187f9f49a4aed1,128,93,3,298.6666666666667,107,21,07144,3
32451349c3b1dc52562aa71a459d1b19,117,88,3,273,67,50,09130,3
c6d694c393a19750ed70e31206e4da27,20,20,1,140,20,0,05040,1
d4d59930d68cb781a5eb89e21cf61183,81,53,3,189,81,0,04020,2
81053b411237882f867d62bd960a36d0,131,64,5,183.4,118,13,09110,3
f305a798b0aa89c43b153c9ad477ed3f,18,17,2,63,18,0,10080,1
7484ca9bd902971ffbfe4ab0ff7481e5,226,128,3,527.3333333333334,226,0,01026,4
496e0f28181df20cdf821f4d4dcc2fbb,224,148,3,522.6666666666667,120,104,05040,4
02db84bcbd1117be7353bc517cda911a,69,55,2,241.5,37,32,05040,2
9ad9f09f5616362c4e57ca5862505618,386,179,4,675.5,386,0,01026,4
d7b495a1d819bc96600d2f42123a7580,34,34,1,238,0,34,01027,1
103110af157d5a47930e0076a80a64f7,35,32,2,122.5,35,0,11040,1
529d6d2ab0bb06386c156a760fa75cf4,85,76,2,297.5,85,0,05040,3
37764691a19ed32903854048157134c4,42,42,1,294,42,0,01028,1
1396ba35b1c205e7ecf77d2baaaca850,269,65,3,627.6666666666667,269,0,05040,4
48c60358563cc6435035f8e6f006155c,47,33,2,164.5,47,0,11040,1
054ded2958698ec60089b3c11475c9f9,64,50,1,448,64,0,01026,2
c8c5eea1dd83ecc91c4e5207dfa90fc2,406,135,6,473.6666666666667,371,35,11100,4
8dfef587a4c265b2ac074aed09b1cd62,191,129,4,334.25,171,20,08314,4
554acc64359711fe5e517f95cee46d74,114,81,3,266,75,39,14301,3
92ad0f5c94b60a1762ec599d3205a9d6,1,1,1,7,1,0,05030,1
7a89ebcd5a9254a016139470ed312ba8,22,22,1,154,22,0,08314,1
c17e6e970f89716a0a0da1b5639ec744,79,64,2,276.5,43,36,08100,2
3eeb287e04657f3f2b8e20421f74e2b4,77,77,1,539,77,0,01026,3
e407a32e64d7c3c5fcb1da4515f16819,14,14,1,98,14,0,05030,1
777452b60a6dbe6b117209dc54fc8a9d,35,35,1,245,0,35,03050,1
9bf3c4c1119871a7de1b819de0b2fa46,16,16,1,112,16,0,12500,1
21c79081ffedaa018efe36e798836eef,146,104,4,255.5,109,37,04200,3
db4650320ca59c0935721590c64e6f61,87,67,2,304.5,40,47,01027,3
2b8a51918a59b0269325a643f60203e9,39,39,1,273,39,0,01026,1
97689f0ebf04c08a08dcd609e31be83e,55,55,1,385,55,0,05040,1
98ef8fe9d0f43be07d75cbaa7dac2316,15,13,3,35,15,0,11080,1
9f2715b408f726e5dd43f893fdd05981,228,109,2,798,228,0,05040,4
f460f2d6040105e9f4f7b68ead064174,273,136,3,637,273,0,05100,4
bab2ee9a8a23d602e8b722d1616651c5,52,52,1,364,52,0,10240,1
521e130bf2cbf7adf9d53274993b93a0,77,73,2,269.5,56,21,01026,2
2e7668efdb48dd07d6c54b2226a3ca65,21,21,1,147,0,21,10200,1
cf69f164da888a9e0caa9cbe0bcd1c2d,20,20,1,140,20,0,05040,1
62b9d9a316d53b41d41337f1d0442712,16,16,1,112,16,0,01012,1
6ddf12bd6d878059f7a2f0f905bdd50e,156,61,4,273,130,26,10200,3
78dcc7fc5545cd38bb7acf7031f25e7a,183,72,5,256.2,161,22,05030,3
54f70f23dfcf787db86253cbd0bf1361,15,15,1,105,15,0,03050,1
ed8a19be27967c7a08bb6b01dee79c68,186,88,4,325.5,149,37,01026,3
73f40019e5f03ca03c6fa1b6a07b195e,29,29,1,203,29,0,04020,1
7f1ab17096a2d18decca4cd71d57fe49,25,25,1,175,25,0,02720,1
7c9243d92e5a39224320fdb9cb22bfc6,2,2,1,14,2,0,05160,1
701be9b5c2f9b2bc187f2485ef49a628,22,22,1,154,0,22,01012,1
4035d20ef192f0dfb9f40639b99f84e8,14,14,1,98,14,0,11100,1
dbb95806e3fcfe2d7e595c3552364898,47,39,2,164.5,47,0,05040,1
972ad02f3e9270ab9659dabc8c2eb6af,54,47,2,189,54,0,05030,1
d1d83cf05e9b1d59e2c462edb0eb637a,22,22,1,154,22,0,04020,1
251eb7b012d8f3bc5a37113b67410265,55,55,1,385,55,0,02756,1
d01c7bd30d866e627270478e603b6e02,17,17,1,119,17,0,08150,1
2bb391ff6542d7eb418ecb2e6f0b6370,155,117,3,361.6666666666667,155,0,05040,3
ebac0922c1e3ffd08cbd1bb44b21d7d9,132,108,2,462,67,65,05040,3
d114120752df8c60768aa0c8f965ea9b,17,17,1,119,17,0,12500,1
0688f5803a61463828819d6d22375868,132,77,4,231,103,29,08052,3
1471c31a46145aae2b0df2e27f19ee9b,83,63,2,290.5,83,0,05040,2
b020f80d772b191fc9ea9e48df3e4ab1,84,58,4,147,64,20,10200,3
f87d34cfc2d3dfe9e191140640a5cf55,152,64,2,532,46,106,05040,3
fe59cecfa9303ff10376f5162ffbc4ab,13,13,1,91,13,0,01027,1
b2c83457998d6b0fe522e80b6b80d58a,115,66,3,268.33333333333337,115,0,10200,3
b64c8e41634a2436fa98bc319ef73918,77,59,1,539,77,0,01026,2
0cb33a8321575bfafae16a099ed263fa,338,138,5,473.2,270,68,10200,4
38b075f473254f6dc9dee07f260a034e,93,64,2,325.5,93,0,05030,3
055978d7571ba3a572f62788a1ba2429,9,9,1,63,9,0,05030,1
8858c2731cd2d89cf6d19f4428755f03,112,81,2,392,112,0,04060,3
4f8dd965903ccc01e15f1dd7b5fc363d,39,31,2,136.5,18,21,02650,1
dcf1c408ec10f14e87f63d3bfd68c8de,8,6,2,28,8,0,11040,1
6418b516e9c0fc8e5c16dbc3010c3c37,86,64,2,301,86,0,05040,2
5b06eb52a9445250127b7723c32a720d,82,52,3,191.33333333333334,82,0,05030,2
a4ee5c240f559bf83051ba8cda3e3247,90,49,2,315,90,0,01026,2
64e619c794231ad77958638f5f7067a9,63,55,2,220.5,63,0,01012,2
fff39234b274f2f6fd12e43da7881398,11,11,1,77,11,0,01015,1
d7cf6d8ac2827f1c2ad61eb3a39e3fca,110,63,4,192.5,75,35,04020,3
b7a917cd6e08587fbc67c5c0e7108551,62,62,1,434,0,62,04060,2
642732465d27b05a68258f1547678dca,48,39,2,168,34,14,08150,1
9ab891e5f7dfce1a0a695b9187da3e19,65,55,2,227.5,65,0,01026,2
67d070d867edd321ba31a94d7daa075e,29,29,1,203,29,0,09090,1
21f1ee72744d72811fe8bab0738c0e08,235,98,4,411.25,235,0,10200,4
b204b6cd276ec948eb69701d7524115a,14,14,1,98,14,0,09010,1
8d40d642c809cd1897295286d8bc112e,473,204,3,1103.6666666666667,473,0,05040,4
3aac11b3278e5f4e2023afb573e0ba6f,61,57,2,213.5,61,0,11140,2
42e2735c6848bf182124b0649ac40489,138,37,6,161,95,43,09110,3
060cd28d06b38837ed7d907e77ece22e,18,18,1,126,18,0,09130,1
62efdfaabf4dadb1fda59141ee88fe4f,171,66,3,399,83,88,05100,3
042a43b0a432e83bcf7bff94c187f976,137,78,2,479.5,109,28,05040,3
d1520b69dccd8aa537e5a04822e0618d,27,27,1,189,27,0,09170,1
78d86b6d97887ab61a7dfe279eadddca,29,29,1,203,29,0,01012,1
4a3ff2804b43e255fd5217634c361cde,145,99,5,203,117,28,04060,3
e69330dd611aa41bec407e4a19139c69,103,71,2,360.5,103,0,01085,3
14818924bd283e79d9244d3e1300a84e,24,23,1,168,24,0,05200,1
d393a9d9bedf7a4e93145185c14ac28f,30,30,1,210,30,0,05040,1
1af48eba94d1e05ad857a5c0186579c2,21,21,1,147,21,0,09130,1
2bdbf9a0f819b41a21b6ec812bf6717e,17,17,1,119,17,0,01012,1
24c7e192dded83d59f6a39ed64ced185,350,145,3,816.6666666666667,350,0,05040,4
6317c2427e734122b95f76e96655e359,42,41,2,147,42,0,01013,1
cf425edd45f7f192c8e69f49df575176,49,49,1,343,49,0,04060,1
435e6f761cd07b7722bac4ddd83fedf3,10,10,1,70,10,0,01027,1
5c1e23367be0178e34d8294ec047c939,441,213,2,1543.5,441,0,01027,4
d32af5e75944603ea3d00f2e47eaa586,12,12,1,84,0,12,10240,1
f8df84f9246a372be15b2ec692ac695c,29,29,1,203,29,0,01028,1
3e7eedd1472a5ff1993b27b477ab00ac,314,126,3,732.6666666666667,314,0,01026,4
150831a4b466dfc78ef16c525305db83,124,99,2,434,56,68,01026,3
957d3d70dde52d2e09d7e9449ee4dd48,1,1,1,7,0,1,11180,1
1052747684afe89dc499591f9896a6a4,41,34,3,95.66666666666667,33,8,11140,1
5cafc2cbb351bbb9fd83a92e82fa5185,344,106,3,802.6666666666667,284,60,05040,4
8e7812cb307753ff5fe18a1e3f69dbbd,290,155,2,1015,57,233,05040,4
0787cdf0766087764fa1f2c5fa64ffcf,23,23,1,161,23,0,01200,1
8404e7cfce3df0ed67d12938faab09d6,287,135,4,502.25,135,152,02650,4
0e2d35f12a076dc7b788b00d5d60f533,362,122,4,633.5,334,28,05040,4
0897d8da7365cda9335242a07fee8e56,52,28,4,91,47,5,04032,2
166d5616e0c849b72b3677913d6ccccc,85,42,2,297.5,85,0,04060,2
9dee34087c86d21e3df0ddc49d66ab0c,94,82,2,329,48,46,03050,3
a91775e45012f063d57f3c9f51dda5e9,28,26,2,98,28,0,09130,1
8d67d1722877cda3478aa9b465c07456,33,29,1,231,33,0,10200,1
cad087734c305ea28aa7f67fcec6fc2e,92,81,2,322,63,29,01026,3
b714842e8dd2f9a4451be9904d5627f5,24,24,1,168,24,0,09130,1
cfc83105d1693d6ce51ab4a18ff3ef65,165,104,4,288.75,135,30,01026,3
6379987a44eb1f04b1eedf169b82967f,198,66,3,462,198,0,01012,3
3aafecd0b2582d7bcadb3fdc6ee9a99e,398,155,5,557.1999999999999,180,218,01026,4
37a7da81eb302bab33fd4a10436be981,67,46,2,234.5,67,0,01026,2
c2787e326eda1d85cfe0c4a698463478,45,31,2,157.5,45,0,01085,1
a14d8688cc3dbbf578028d58a2dd35d3,66,58,3,154,66,0,10200,2
427f1fab5f1b5a5b1cdfe39ab4901848,24,24,1,168,24,0,01026,1
38f86516e07eb68b42c517e525e49fd5,100,75,4,175,60,40,05040,3
a2a0f8f985d25b8a601e42b060903d2c,53,53,1,371,53,0,05040,1
fd31fe4e4d8838b0649f0cd0e2cc73f5,79,53,2,276.5,79,0,05040,2
b362adbd80840fb5bed4298e3ef878b8,124,85,2,434,124,0,10028,3
b962ae0eacd0210973c3dbbb8c4fcf5e,29,29,1,203,0,29,11100,1
e458a3c036f9761e880022e04da6e5e8,80,57,2,280,80,0,01012,2
a06a79ccd2b89f7c38b981325c55511a,138,75,4,241.5,138,0,05040,3
43f2998f9351d706e8cfad0e2f7bd7ad,57,57,1,399,57,0,01026,2
24a8d7a7b199ea15c2e3ec8fec211dfc,73,58,1,511,0,73,05030,2
3cd43d4ae663ad436d1be23761a87418,56,56,1,392,56,0,05100,2
650ef7de28d7b144d4b14fe14626d66e,104,77,2,364,55,49,05100,3
37f84e10294b6c858a8e5385e626f21d,20,20,2,70,20,0,08090,1
7e16abe205501621baa2dce868454ec5,64,42,3,149.33333333333334,64,0,09150,2
57c2fe5f60c238d8971ab033636104cd,44,39,2,154,44,0,09090,1
23c832fd7c06dbbea920b6b2fcde79ac,168,77,2,588,168,0,01012,3
9e347ce1944425ecbb4a57802f70a3a0,69,51,2,241.5,69,0,10200,2
ca50e0c9d6afe7045d5417afce540439,17,17,1,119,17,0,08100,1
6f37ee05f5cd9b34fa3d0d9b009bbe02,50,50,1,350,0,50,12500,1
7bc343903c5cbb34779efd1e7067ef3b,4,4,1,28,4,0,13930,1
c5e81e3963e90292ed7a1f5aa7631ada,16,16,1,112,16,0,03070,1
81035029fd4ee18fb695425a57fd3d9c,124,102,2,434,124,0,02751,3
a309dcbeac613ca4ea8fefabcce2675e,20,20,1,140,20,0,05040,1
e440e236536b6cfd800efda4aba22fbd,40,37,2,140,17,23,11100,1
baefb44403be65b318c6a81318918144,12,12,1,84,12,0,04020,1
241b8234aa80f4bf8180e80882e249b6,102,82,2,357,102,0,09010,3
04432991f296349fa497210df9ec4bf3,297,170,6,346.5,243,54,01026,4
46e34b76b1c972166084930e1036f80e,298,68,3,695.3333333333334,275,23,10200,4
c01e6c29c6d751654aaf67fbaedbfb76,81,59,2,283.5,81,0,10200,2
cda880d9510e4dca92511bba2d947cff,190,96,5,266,145,45,09111,4
fb7e1ab6a25539ee14ab79c9550ee0e3,30,23,2,105,30,0,03070,1
fa28a77b461d3106e0dd564611f21293,37,37,1,259,37,0,05040,1
4d2dc35d0f3561f14efdfa337d1ba0ce,29,29,1,203,29,0,01027,1
fd52ed9b74f923d273ed6249653c6694,5,5,1,35,5,0,13875,1
c611a84efdd58cc5adb8f97adeb6dcaa,45,33,2,157.5,45,0,05040,1
efc656e76b0986f72a7a0210870d8adf,52,32,3,121.33333333333334,52,0,09150,1
1fc76264ce7c68b03c55bfbae46aa3c5,82,63,2,287,82,0,01013,2
cd620fe9311a5e51230cad5bb7c96ab4,10,10,1,70,10,0,09091,1
0235454d22eb99d3dc7477221d659b3b,30,30,1,210,0,30,05040,1
80e447c0ed070d15261fb5f2a5bf53e5,99,67,2,346.5,99,0,08230,3
e19749fa41391dc3aa886ed113ca6b8b,62,62,1,434,62,0,10240,2
34bac37bbe0a08835687220cde776897,31,31,1,217,31,0,04060,1
3314059e61b678ef9c7ed1ebb8cfcf01,37,37,1,259,37,0,01026,1
2afcd55d6dc10ae16d2e26bef5b08bdb,328,103,2,1148,154,174,14302,4
aa8c94be5b583aebe0ffd1ab882ffaf5,84,58,4,147,84,0,05030,3
163d35e123f4a0ff41b113ce2e64e480,40,40,1,280,0,40,01026,1
08cbfe43ebbff254605fe3a4514d69db,90,59,4,157.5,90,0,10200,3
f6621e89855ace7fcb35e53a699c3ed2,7,7,1,49,7,0,12710,1
bfe165bd63bbb80a900f7f47a5320d3c,6,4,2,21,6,0,13640,1
6cd36d72b1b8da814dee58cba01f01d1,119,66,5,166.6,119,0,05040,3
4f64637154c8d6b3a59fcacec3c4b086,142,79,2,497,142,0,01012,3
efd3d476d39d36fd623c4f6f055e89c5,30,30,1,210,30,0,02690,1
5194c67d57c726f207bdac4768a58896,59,50,2,206.5,21,38,10200,2
52ac333682864267a5c789287e67ee48,137,67,3,319.6666666666667,137,0,05040,3
b33ad1a6cb9efb60e7e77f1282a775ca,180,100,2,630,42,138,05040,4
e948f98b22bb46b0acfb42a3c3c79be1,3,3,1,21,3,0,11040,1
73ae7d18d40d097af72ff7256566a056,51,40,2,178.5,51,0,05030,1
a77a6d6e94b1d182ea07bf8f32a2a8bc,72,56,2,252,72,0,05030,2
0b10cf5748dcaf5592d73141721eafe7,36,29,2,126,36,0,10080,1
69f7a5a40a443c317221fdbc95d82772,37,37,1,259,37,0,05040,1
829474dcd929d0b4282d9175d17576ba,31,26,2,108.5,31,0,10028,1
49ab69862a663e100de6dd98951014c9,418,153,4,731.5,322,96,10200,4
8723d6d1141b7dcfa979a23c3b14f0c6,7,7,1,49,7,0,12610,1
0d1843d128c9d0598046744b8ce196bf,52,47,2,182,52,0,01026,1
fe37c70fa731c614538a1a2b6b62e706,279,182,2,976.5,279,0,08313,4
be02bd5f98545c2cd8d93fc990f31675,291,124,3,679,291,0,01026,4
a7dcd055500b47144797156ad6a53a14,40,35,1,280,40,0,01026,1
05d1a32cabba11acc93162bbb2dea4b6,51,37,1,357,51,0,05040,1
8a456f2745860ead0bc56e43731726f9,472,155,2,1652,213,259,01012,4
aa15ec40b6b9b29ab9e58cacacc5d4b3,68,68,1,476,68,0,01026,2
1f04aa5d8fe5ce6bc71b554715504ef8,27,22,2,94.5,27,0,10080,1
dbee3e8140ddb21d7dc109231c1a1202,21,19,2,73.5,21,0,05030,1
6b4d284c00dff53659a7a3be51f5c6b9,37,30,2,129.5,37,0,03050,1
2002fc1a761dade4c65644af64aa507e,61,46,2,213.5,61,0,03050,1
02cf05c759f7fd6badff0888a34d219f,39,17,3,91,30,9,09010,1
857f7a068c80b1bf6dba955362e32088,66,61,2,231,66,0,01026,2
824fbae18b0a4341bf538c8ecccc546d,167,114,3,389.6666666666667,105,62,05030,3
a86ea64b8dbcbe7c9848253d135f2c9e,196,134,2,686,138,58,04201,4
e681a3f15dc71a567f4722a8d01c77c8,24,24,1,168,24,0,01013,1
8814021ed0e06bccf05f83fd9c0ecba6,8,8,1,56,0,8,08314,1
65b92e93ea5650fe7da0e70ed55a8dbf,54,39,3,126,54,0,10200,1
ffacd38ff85daa06403d86e4b756a4bc,11,11,1,77,11,0,03070,1
b37becad6f2ba7a0135a972c80628c78,97,68,2,339.5,51,46,05040,3
4df614dd17aece5c7ed7446b6b6c9e9d,55,55,1,385,0,55,05040,2
9c00d474a714adccfaf50bbb9164421d,37,37,1,259,0,37,01013,1
dc189da56ecc54d4d54dfbfdd962bf90,329,137,3,767.6666666666667,329,0,05040,4
c048a22b40551a179bf01673ca2313ab,34,26,2,119,34,0,05030,1
caba78a4d5a526860b24b12e4561c7c9,291,125,3,679,291,0,04020,4
e9e4507d4270c935e2e14667cfba32be,233,74,3,543.6666666666667,233,0,05041,4
d841bcfff80a1de923b43c0b8959509a,72,63,1,504,72,0,01026,2
5b727477d4f3cca8dd4b6c9003089564,330,124,4,577.5,146,184,05040,4
a1eee1c94321c16fdbf7f1ea695dedd1,227,142,3,529.6666666666667,227,0,05040,4
0d18ce0cbadecf107bd7ed7095fbe34c,47,41,2,164.5,47,0,10220,1
e1c763dd5e427f8c71ce344af32b57af,119,95,2,416.5,119,0,01026,3
9de4de3e5778984e5dbc9b58432fac22,23,23,1,161,23,0,05040,1
c8e9300a8046f441048b06f1a11f3f5c,237,138,3,553,191,46,04020,4
7dc146a58b8bece1e87ace181adf1b38,41,41,1,287,41,0,01026,1
b8a43fc22577078e77d023aeb3dbb269,26,24,2,91,26,0,05040,1
655d0e7dc95f62fb3cb94db1fda13035,170,107,3,396.6666666666667,170,0,05100,3
3c367935cd74d73c1e2446f3d9457634,38,24,2,133,38,0,10200,1
7ace9fce0fac8ee22e443b48fd6850f0,30,24,2,105,30,0,11180,1
1726e8bf097c11793497a11e9fab7e33,206,99,2,721,128,78,05040,4
bc25f0066dec282eab65b9e19e8eb0b2,29,29,1,203,29,0,01026,1
977dfd044c465400ed92144b6708adde,22,19,2,77,22,0,11140,1
e1eda74c5518e8aacefddbed5b8e7c04,52,42,1,364,52,0,05040,1
715f81bc598d3b83eb357392bae02c63,125,95,3,291.6666666666667,125,0,05100,3
48ecfd6d1c6ff91541f6033c64399021,23,23,1,161,23,0,01026,1
4e37edb3e76377a314981f3cdef04709,78,46,3,182,78,0,02620,2
47452ef28290024e5ff578f87bff8aad,368,172,4,644,267,101,01085,4
f353e2ba57f73a83d29b562864522ca9,20,20,1,140,20,0,04200,1
a945508619921c7c0c3766eebceab28e,41,33,2,143.5,18,23,03050,1
f6c443fe56c4dc6181a1341405e5b241,186,83,4,325.5,111,75,01026,3
a5ddadc383c38c64c40413674e537daa,70,57,2,245,70,0,01085,2
5d14f3662d43433d49b143be2a5edf46,52,52,1,364,52,0,01013,1
edff1f758eac2c10f7237f4c0484b4e4,25,25,1,175,25,0,05100,1
03ab86afa7c96b8abdc5d8cd2b3c178c,97,74,2,339.5,97,0,03050,3
ed960538683f763be53b6c2db20cf6aa,63,53,2,220.5,63,0,09030,2
dfdabd077b019ecb2956e5d5ac9dee0a,27,27,1,189,27,0,05100,1
5d5a880a2c8bb0c8795e8b79d7b414ba,443,135,5,620.1999999999999,403,40,05040,4
ae7bca878bce69606a4e833e81f8781e,33,29,2,115.5,33,0,01016,1
ed0a2c50ac989495cf5cd468488a2ee8,21,21,1,147,21,0,01085,1
03b4ccc106f2ef28e200b24453be9391,30,30,1,210,30,0,01026,1
4c6eef32ca691f7563d9aaf3e504faa9,374,125,5,523.6,307,67,01012,4
566c48e3485af1acba4f650e2e2f0daf,2,1,2,7,2,0,11040,1
c6f5390c121f18ff7cf434bebf3f9fed,10,10,1,70,0,10,10200,1
8e94c371ead82915a94dc46dcb9dba94,57,41,2,199.5,57,0,10200,1
d84d396d3ec89e89717ff40988459f96,55,47,2,192.5,55,0,08100,1
a0e9316c22ebbe3555547cd02251cb12,305,100,2,1067.5,305,0,05040,4
a14b0883f7e1321b976b8aab6f3e6f22,43,30,3,100.33333333333334,43,0,08312,1
be4524547628697ed689ffd2bf7fc9a3,124,55,3,289.33333333333337,84,40,01026,3
206b0568f7d7fa1c7fcce4ca0383bbe8,17,17,1,119,17,0,08100,1
e64d7509e1ee74dc4178ad91c85d4221,50,34,1,350,50,0,08230,1
93f4ad686f609d9b8eea47e213e5b62d,350,191,2,1225,350,0,01026,4
8616a4c56443d50f994448d653d0bbb4,60,40,3,140,37,23,11040,2
b677915bce76eb27a3d8212b584ff506,26,26,1,182,26,0,09130,1
fead4919a3e92c454ace8e88d346e119,36,36,1,252,0,36,05040,1
4e234db0e18c221be766f5a2dec93022,115,92,3,268.33333333333337,86,29,09170,3
48e9d73133873d39dd5c5ebe455c8454,33,33,3,77,33,0,07143,1
5fa7e47be701146f09ac00df5bdb787c,53,17,4,92.75,53,0,10200,1
43bf16a74fef361fd0a034ad6d965ed1,223,101,3,520.3333333333334,176,47,01027,4
dc0b88750181d105f6599e9cd0721562,39,31,1,273,39,0,05030,1
5298169475262f5edbb8b124b68fdd07,26,26,1,182,26,0,05040,1
655942ce4764328935834d604f714ec9,305,113,4,533.75,305,0,05040,4
734ec49b19e7b9f4e8f4a9f1e659753d,9,9,1,63,9,0,11040,1
34d3381daf10b0e0a1030860d74cec37,95,72,2,332.5,95,0,01026,3
bc51b4cc43f6fda12226bcc74a737405,79,49,2,276.5,79,0,05040,2
38b2c4348c943c007dba5faf00d959f3,559,198,3,1304.3333333333335,559,0,05040,4
91395265a418125cdef2b0e0d3566d4b,4,2,2,14,4,0,11040,1
d2ea017a262aa72063def2fc979b60cc,25,24,2,87.5,25,0,10200,1
0ec9456b026c6aae00be40b7bf1a022e,271,140,1,1897,271,0,09150,4
9da5a6bd999070c52d6cb1760fb58632,36,36,1,252,36,0,05040,1
1c5177143021b4d51c19402081a92cff,14,9,3,32.66666666666667,14,0,11100,1
8d3733cd5a9462c1cb889f994b13bd59,53,42,2,185.5,53,0,01026,1
6539dc5cec69e2016ae677075ace3dcf,17,17,1,119,0,17,01027,1
a9cbafcdcaba9ea9adeb23c12c7d12d8,15,15,1,105,15,0,09010,1
6ee48baf29b4ae5d52f09ed34953fcf6,421,138,4,736.75,346,75,05040,4
02c93169669814ef137629d13fb6a83b,32,27,2,112,20,12,04130,1
c14ee91e615badf8b16d8d7dbb2776d6,36,31,2,126,36,0,05040,1
0fb3bb7246deabfe4fd9f4075a6212af,28,20,2,98,9,19,09010,1
9a18e8d423dbc1fe1550effb60e25cf0,253,111,3,590.3333333333334,253,0,05040,4
18b260d59022d96f766fb1aa0ed14f1d,1,1,1,7,1,0,11040,1
2aebc48919c874f43b2da6cf6b6ab12f,16,16,1,112,16,0,05030,1
c813d73c8d9be894846c838e05afea7f,105,75,1,735,105,0,01026,3
1079cd9f91f510bd20d31f98bfd60791,181,83,4,316.75,137,44,11100,3
960c704b8129d6f9d077a09f73d2bb23,254,120,4,444.5,254,0,01026,4
41717eb4e01c5d93802d15472659ca01,15,15,1,105,15,0,09070,1
b735af4d6c9b3161beeb2f712ca83700,89,56,4,155.75,89,0,10220,3
c7c1ab36710ed75ae8593a80f1c263d6,36,36,1,252,0,36,01012,1
2e235e3297bf98ad611f879923b6a59e,78,55,3,182,78,0,05041,2
64bf43e1ffe9aa8786e666ab45a4fad4,494,215,3,1152.6666666666667,494,0,01027,4
dec616236b33556ef05c442f3f32d981,325,109,5,455,165,160,05040,4
d61e959138e0b33d105707cdd2802c8e,13,12,2,45.5,13,0,11040,1
7a9d993cdb735e94f68e595ef7bd3c29,71,59,2,248.5,35,36,03070,2
2bb7e4c80996e33348aed997612f2a8f,17,17,1,119,17,0,03050,1
bdb0569596961163cebae4a9e6a43cf7,93,69,2,325.5,93,0,11100,3
f03a1fe54153c3e62778bc86e6b6f944,44,30,2,154,44,0,05040,1
837a589ac522e3c2ea72a2b824b095ea,166,107,3,387.33333333333337,166,0,05040,3
00a7621250bfbcd783e476f8f829c998,23,23,1,161,23,0,01027,1
164211cce3efcc76c26cf6280d4ed02f,185,114,2,647.5,185,0,05040,4
34fa51246f68ac13094f349f25da319d,93,93,1,651,93,0,03070,3
386e060d2fe047fcca9bac997adb1810,25,25,1,175,25,0,05040,1
b163ab208cf75c9cfeaa826bf4561f94,50,33,3,116.66666666666667,29,21,05040,1
23f780fc08e9773ad317a4953b132466,15,15,1,105,15,0,08331,1
ba17460f4e9be3f20ea0d00d44c77204,130,92,3,303.33333333333337,130,0,01012,3
ae0fe113ce6b1fdeed2d1ef3b9f3be7f,26,26,1,182,26,0,01012,1
69efd60cbdd45da1d1ada7efd3ca9620,32,32,1,224,32,0,12410,1
40f73c9b23ffadcb7bc70ca2658aeb23,15,15,1,105,15,0,01027,1
8a2b483ad1f44f3b790d70483a5dc155,145,87,3,338.33333333333337,109,36,01026,3
1fe17ea97664d07cadacd8cb70e8dc23,52,52,1,364,52,0,01013,1
b1c52fccdf3403dc7fdd99aeb63e8be1,34,34,1,238,0,34,01026,1
e2f61c77ae49f4ac0b8ca0fc20465f44,18,18,1,126,0,18,01012,1
66cb14232bb418c1459d34ca8da05661,92,67,2,322,42,50,09030,3
da4c453b841d8d0773f009e9cb3a8f4b,39,39,1,273,39,0,01012,1
bcfd6011454c366e6414cbe063cee845,447,130,3,1043,368,79,01085,4
54e8d014ea8515ac6122d1e240e37f31,14,14,1,98,14,0,02690,1
38943fa4a43f7768ccc8b4a35f5e4272,25,22,1,175,25,0,08010,1
f0093a81edc3391a82784218c6108356,22,19,1,154,22,0,05030,1
a21264b47f10cc6cd47d534a2b82969a,66,44,3,154,28,38,09130,2
3db6748f2638ac10b8ffbac8aa5ca730,269,118,2,941.5,88,181,01026,4
e2c389589e01f7d1b7b46aaddb4580b1,80,64,2,280,80,0,05040,2
11964d0796cd6b6bf2f66698bfe6c5d2,36,35,1,252,36,0,01012,1
dc92291051c4882c4a728d880d38dc41,64,56,1,448,64,0,02650,2
7dd6d24e54616e6189e12e1c461b01a3,40,35,2,140,40,0,05041,1
a7b184a4cb814a5312e0c6a956b8b112,35,35,1,245,35,0,09130,1
e38eea606ff554665ba514000b423b76,54,46,2,189,26,28,05030,1
9fe4c7fa3a4822d770c11b76d0741aee,649,210,2,2271.5,594,55,05040,4
32247a0680c2a138705572437d5a2ecc,89,64,3,207.66666666666669,55,34,05100,3
215637aefbed5a348464e39483eb70ed,93,62,1,651,93,0,01013,3
96c04959f60dacecd0eb7960a339870b,46,36,3,107.33333333333334,23,23,11100,1
b07518c39c1991d59a5046dbab9f2079,79,61,3,184.33333333333334,34,45,01201,3
ec8d6326ab999027d460beda83b89885,128,74,3,298.6666666666667,82,46,10240,3
2b7755291a31003aa13e109190d835a7,9,9,1,63,9,0,07142,1
9a4ce4e2873a27a80ec2eae1bd361852,96,83,2,336,96,0,05030,3
e935b3dc90b91eec8a69d9187c2a5e09,207,151,4,362.25,207,0,01026,4
e5f25e2af3db6c23db57a151e427bfb3,214,95,3,499.33333333333337,214,0,04060,4
6de9d526c6e0dc8b440d03b016a071c6,80,54,2,280,80,0,05040,2
bebe81a42c20cc92c96977cee8a39e68,20,16,2,70,12,8,11040,1
df72023ec812e0ec782a9d7ea4bee1cd,69,57,2,241.5,69,0,05040,2
3d554aabd998c1c88274af47f0d3db32,328,187,2,1148,221,107,05040,4
47056dc143c82e171b8397dfd1210b50,35,34,2,122.5,35,0,05040,1
c7ca8b1ccf766448addd1265dc1b1825,37,30,2,129.5,15,22,05030,1
f94b93dc402803e828a99f302a01db66,32,21,2,112,32,0,11100,1
ce0e473237b81dc72d7d004032cf8f3a,50,50,1,350,0,50,09010,1
67fb3d8dcd3110c6e467c570885e7b2a,52,34,3,121.33333333333334,31,21,05030,1
17d41f5d3822beb28416d7485a408956,31,28,2,108.5,31,0,03070,1
43f52c0f4fd4f52fa314b36e8351db99,53,46,3,123.66666666666667,32,21,01012,2
41e793b95622a5f0f6ffa98790121e20,127,88,2,444.5,127,0,01026,3
8332ec2b6734d5ad3abed691386555f0,348,126,2,1218,348,0,01012,4
8f00c8a04774bf1d93e921061b2e4674,8,8,1,56,8,0,01012,1
ee45c29ce5e9560920c0f29abdfb3c96,72,36,4,126,72,0,05040,2
6000390550efcbe4db4cbfb696d55aa0,179,130,3,417.6666666666667,145,34,05040,4
a5994200f8b73d48c3bd940ef73f3323,37,37,1,259,37,0,01026,1
6dedb366579167303ab5942b43e5ac88,31,29,1,217,31,0,08150,1
f2cd8ee69e705b4e72dbeb46a5a1b1c0,35,35,1,245,35,0,01013,1
9237c83b0d456ffbf8515cab8d26144a,18,18,1,126,18,0,03033,1
54c6b8a27cd2ef9ecf141665efc3f962,129,86,3,301,129,0,01026,3
fe60923157d39d5d4442391570cf4129,84,49,3,196,84,0,01012,2
10af1d63c94f6b8fc6ea1b83a3a335d8,19,19,1,133,19,0,05040,1
e6a72b3266627c4296b77d9970bf80cf,152,87,3,354.6666666666667,116,36,13953,3
bbfe058613fc7e42a165f80ff012f88e,87,65,4,152.25,87,0,05040,3
2a59093c28d2c999c98c492eb080d926,77,52,2,269.5,77,0,05040,2
898c0aa3f0310e96125f1a56a236195b,1,1,1,7,1,0,11040,1
a6ebb4652a1153eb0b3a09277fabff6c,323,147,5,452.2,230,93,02650,4
4ba68326b2120ea68b4275306a27c33a,4,4,1,28,4,0,04201,1
83abda85af018bb301c48295984767af,155,76,2,542.5,155,0,10200,3
657793d3bfe3f21b69080d3a25801ea4,151,92,3,352.33333333333337,151,0,05040,3
3de6e7924b965886ec3144d1ceb84e57,68,62,3,158.66666666666669,48,20,05040,2
19d3a680adacf9180a12d7c9b1538b7f,29,29,1,203,29,0,12500,1
3ec5b8e72bfcd1dcee2b2104729ccf00,31,13,3,72.33333333333334,31,0,05030,1
7cc693a9a299df5958bf2fc8a373ad35,495,203,2,1732.5,413,82,01026,4
aaf1ecd6dd8670a803fd8e0262f33fed,83,63,2,290.5,31,52,05040,2
faab91d248b634773dd8f5d69ce321be,58,58,1,406,58,0,05100,2
31eae64da900867dd1514c4bd0ed6d2f,32,32,1,224,32,0,01085,1
12385efdd83c9fd8489cc2ac1723df1f,248,101,5,347.2,119,129,08052,4
57dec4181464f4ba3fd7c37f529c3c45,41,32,1,287,0,41,01013,1
84452920dab908d9dbb9eee4f3b32533,51,51,1,357,51,0,01027,1
48992c8d18bb942d87e42ed53887b1a8,17,7,3,39.66666666666667,17,0,05030,1
738563c25d892a812a1e013cc27ca9cf,67,52,2,234.5,34,33,01026,2
7ff81d8e7eb60a99ac23dba9815dfb9b,23,23,1,161,23,0,05040,1
7be77d6cd73221d40d6ddbe7896e7ce6,89,68,2,311.5,89,0,08010,3
595a56673269bb90a1ed37e8a9a5a118,32,32,1,224,32,0,05040,1
7b4b493b15578ac547638dff725fd0f3,42,38,1,294,42,0,12650,1
b7a3ffda19de7ed79b6aeb9350932d18,43,43,1,301,0,43,01027,1
9c895c90e8aa3e11cca86ccacf35f226,36,35,2,126,21,15,05030,1
6e381743f1250c7aaed56e38cc37b4fb,145,82,2,507.5,145,0,03070,3
878114ccdd33bd786f859466c764e45e,27,27,1,189,27,0,04080,1
1d862eed5119da53c24346b51c848649,535,160,3,1248.3333333333335,535,0,08314,4
224a98aca873703b108406f546aae8dd,273,139,4,477.75,219,54,01026,4
a76f179e35d9d405899a81df9ef07b94,84,59,3,196,84,0,11040,3
b4dcf5420b685f3384f1fb1eddf4c8fb,24,19,1,168,24,0,10200,1
83107d38fce303534238085e5e61b0ee,183,116,4,320.25,183,0,01026,4
befe208fa439f4641d129ce97c80974a,23,23,1,161,23,0,01012,1
ab510881c8019741025c1b88944deb04,10,10,1,70,10,0,01012,1
ed2b0256a0205fbfc1ae1952163548e0,235,94,5,329,193,42,05040,4
918ab91b0368e8fc41654267be314b80,315,182,3,735,203,112,05040,4
0d52ad5587360e2d0a21135a7e7c6306,28,28,2,98,1,27,01026,1
2b4db7197f05a8bded873402c38e6312,36,36,1,252,36,0,01026,1
4f3b2a4eb3727d1cf5e6d09afa9e5e7b,24,21,3,56,14,10,05030,1
43e616e887fa0452cab522212a4708b5,293,106,4,512.75,293,0,01013,4
b29e045626196f43ac0824723211e8a6,50,42,2,175,50,0,05040,1
78bf59e97ab6d2bdd2907c84c81a5d9f,124,73,3,289.33333333333337,99,25,05030,3
c670b389f08638f0cb0e6b846b624482,22,22,1,154,22,0,04032,1
b1aba449a55459931117293f5f26f52f,83,73,1,581,83,0,08010,3
884c13be32789805055e6fe16a870e2e,37,37,1,259,0,37,01026,1
e4820e59fd04cbe3f5bab1da36932ec7,32,20,3,74.66666666666667,19,13,12410,1
dc81e91400c76a6454c97cca0a12395b,46,46,1,322,46,0,05040,1
ec2db5a904797adfd333b08396ff7f16,42,42,1,294,42,0,01026,1
40fd95d8ca2750aaf0a58e97761574d7,30,30,1,210,30,0,08230,1
fd65a548c7f07c51396bb522826bc444,42,42,1,294,42,0,10200,1
95d49012d86e20f902c2d67d1a0a2f7f,36,36,1,252,0,36,08052,1
3a9c4100772d5f2e1fad6f87f00c64d9,324,149,2,1134,18,306,01026,4
639ce1c27bd7b4920b5bd41107f7ee5a,51,40,2,178.5,20,31,11060,1
777405eb032607adfefae97cc8f241bf,45,45,1,315,45,0,05040,1
80edccb67fe40752ba3b15d7f7554af6,50,38,2,175,1,49,09030,1
4829b552375db482bf94882faa54af51,75,75,1,525,75,0,01028,3
911d53ebf5dea72eeba1432f026e4a05,42,42,1,294,0,42,05040,1
08c9c215dc8ab1c0a397b9182e787d53,4,4,1,28,4,0,05040,1
68c0de7a1485279b3886515e1db7bffe,8,8,1,56,8,0,12501,1
eb0ada05e33fd198a6914c33350773a1,29,29,1,203,29,0,04020,1
6efb619c55038abdb600eb89934e34e2,17,10,3,39.66666666666667,17,0,05030,1
d1f2412b41bc0fdad42661823b503074,149,106,3,347.6666666666667,79,70,01013,3
e4d4fc5b0f17d664e403170715c925af,5,4,2,17.5,4,1,12650,1
5ef6c27d19e658bc7ab3652fa735abac,157,93,3,366.33333333333337,85,72,05041,3
95f7091e24b85cfa9ea145850aabdde8,107,60,3,249.66666666666669,76,31,01026,3
e15f5b145a901968ee7cb853714249f8,16,16,1,112,16,0,08132,1
3d1fa68bc2c07e7441a2336aecdac2ed,54,45,2,189,22,32,05040,1
45dd6bdb74a5b936524012d8937404ca,40,40,1,280,0,40,09091,1
99dfc69f9d71d864734c14b07f74b0b8,38,38,1,266,0,38,05040,1
a17a6397d6129fbc4c1da122b7e8bd43,110,45,2,385,110,0,01012,3
d92c08bc2ed0f8f3968643767e9015d2,19,19,1,133,19,0,01085,1
32dfebec6dad0269a9efcee1b6c232fb,136,87,3,317.33333333333337,136,0,04060,3
39dfb4e0e7458fc3bcf5f195048574d9,50,43,2,175,50,0,06100,1
310cb0664f2d834e5d3b9521a507f1c2,16,16,1,112,16,0,05030,1
05d521e6ef2d586f162f235a6dd6a5c7,66,37,3,154,66,0,05030,2
a2e93a5596a29ee6927b281cbc241763,26,26,1,182,26,0,09130,1
7778589948e5542c0db63d5f6e6129f6,216,116,2,756,216,0,01026,4
4da520b777e445bfd6ed0c7e16dde8fd,35,34,2,122.5,35,0,05140,1
817ec89f8023dcfeea68f96de57047e9,287,98,3,669.6666666666667,287,0,01013,4
fae74a3db73af0eaaecf13b8e8456dd6,277,116,5,387.8,277,0,05040,4
54e24643cd1a56401d93ccceeeb50112,107,74,3,249.66666666666669,71,36,05041,3
49c69aae9a30e616bca34381f77fc32d,8,8,1,56,8,0,11100,1
2217a7487dbe79a256b8581e1a333d02,75,75,1,525,75,0,04060,3
4b9e959fd844a18e5eb39b96fa6488dc,68,55,2,238,30,38,05040,2
fe70190fcc29307e0c43ea7435060277,102,70,1,714,102,0,05030,3
c1438cb38578204a5ca72f9be2264ad6,46,36,2,161,46,0,10200,1
702f44c10066e95ec35960ae0c7bd9aa,174,80,2,609,174,0,12670,3
73101ee898cdc88e308f7b15e85bdb35,34,34,1,238,0,34,01026,1
b848e66731378bb99cdd32a77ced26bd,45,30,3,105,37,8,11103,1
42fdd76b570eaf5808bb2670bfc9f5b9,20,20,1,140,20,0,08010,1
6df944fff5f3e222275aefbdede2e098,394,141,4,689.5,394,0,05040,4
f562148f16e05ca484b30878d62d4fcc,405,167,4,708.75,363,42,03070,4
0e1041ab40e5b86db5136f0f0873c0ff,145,105,2,507.5,2,143,01027,3
ad1e3532207c51cea777f85a6e00f18a,29,29,1,203,29,0,01027,1
45b761d6fddb393032fb2de0c0dd7eda,45,45,1,315,45,0,01026,1
d0c2c47d0ab824cfd49be7e269418021,73,54,1,511,0,73,08230,2
b2f10ee3ec2ad5853056d3a4325a8042,28,28,1,196,28,0,01012,1
e68df71eff46f55b1a39a646dabf3292,10,7,1,70,0,10,03070,1
4e5ec1875f9a5f529708b38982b00e45,32,32,1,224,32,0,04020,1
4a45c65a614f71c7cae6b5e1f69454ae,79,52,1,553,79,0,11040,2
13d7e42ca639fb8e307f963baae5db79,26,26,1,182,26,0,01012,1
8c4065f6dbf652180ac03b098775efbc,98,85,3,228.66666666666669,98,0,03070,3
a10b3f406426ce097dca9a4546233dae,18,18,1,126,18,0,09090,1
86059f788a94abb1c799770d0a46277b,89,65,3,207.66666666666669,56,33,01012,3
43a278b700db1b8fe26944afb1d79c4c,111,95,2,388.5,111,0,01026,3
82001815815bbdb15fdc48faeaf56a70,16,16,1,112,16,0,01013,1
318cd91a3f1d2d63cbf0e2313e5109e5,108,63,3,252,108,0,05030,3
3659be5448f7312eae1eac5c58da7ad5,21,21,2,73.5,20,1,04020,1
f70463ac1a3bbb229fe7477381811617,275,165,4,481.25,243,32,05040,4
2efb16ee5746ff62123f1b6ea146d72c,51,51,1,357,51,0,01016,1
e6ebbe585b23d60956ad44dafc7447eb,1,1,1,7,1,0,09010,1
900ca45f2a048f42fb2862208c07c058,49,39,2,171.5,49,0,11100,1
182c5c71dda468a1b506f271c61870d7,3,3,1,21,3,0,11080,1
dfc59ffbb1c6f01f051493f65712e4c9,65,65,1,455,65,0,05040,2
ae128ef2367ba54fb3ce4709e465abaa,42,40,2,147,42,0,01026,1
c38e7cfa1eed7c2012c183b1b9078f84,14,14,1,98,14,0,08232,1
14a94c044c6b683435793c2a02699968,102,84,2,357,102,0,01027,3
99d09283d037647e7f195be1e578f552,19,19,1,133,19,0,12590,1
364dc198f27513a908f8fbad45a02c0e,46,46,1,322,46,0,01012,1
9fdf24e48e25d19834b7b6c69849ed6d,44,44,1,308,44,0,03050,1
668d1c6fa409e78cb6cedfb9e172b602,144,116,4,252,101,43,01085,3
6b59e03778b355fda6d73425c264e2ac,17,10,3,39.66666666666667,17,0,05030,1
00f24d3c714d477a823a376aa112e318,81,62,2,283.5,81,0,04060,2
daf75e2d017017aa13bdb6747b41f0bf,131,64,5,183.4,105,26,01012,3
67aeae764cabc60c60ce4cdf0049b694,23,23,1,161,0,23,01027,1
dd86f1c74e7ae8525607a7fadf4770dd,177,121,3,413,121,56,09030,4
1bd7fdb44415fd9da982f2e0ea31e1d2,87,71,2,304.5,2,85,10200,3
a4f02270d278e77e684db45ce8620b0c,171,124,3,399,115,56,05040,4
ef3eb6b05b7f50bf13d5dfbca3e35e06,208,100,3,485.33333333333337,208,0,11060,4
eda2e68513267604f195144817b1b19e,54,48,2,189,27,27,11100,1
ab17117c4af1e301e4dd3d204336fb6c,203,74,4,355.25,136,67,02690,3
a0c6d92734259c6040e1fce24be8f8ca,16,16,1,112,16,0,03070,1
2ff7be55fcbb8fdc0db085a529c9ef57,180,115,3,420,180,0,09130,3
f1fb2d76b2416dbf463a1f60b51c0113,38,37,2,133,22,16,01027,1
4e99beb822fc28d5a5ab724026426548,138,75,3,322,138,0,12670,3
d98c633e093944986449b90039526879,38,38,1,266,38,0,01026,1
6f9e004e72137a1b1e0de4cd58552cf6,115,76,3,268.33333333333337,85,30,10240,3
100035456c6678fc8884e11de523c1ff,71,60,2,248.5,71,0,11080,2
e694f38e22542b778453c2f93150963d,301,114,4,526.75,179,122,05030,4
814d44872efd26d517b2a0f37683ef76,64,46,2,224,64,0,01012,2
225d3e69c214dc1047b21046569c7840,62,35,3,144.66666666666669,62,0,08150,2
88d3cd0efc3eb2884ce7fa5b7ee3e00e,30,30,1,210,30,0,01013,1
be0ec61982ebf78c516f07117d287dd1,26,25,2,91,1,25,02650,1
723f276bd442249079acb0b746f75cfe,64,49,2,224,29,35,09030,2
afd5e621575b59aa5fb820adfd5a05af,19,19,2,66.5,19,0,11100,1
fb73d423c3de7523077a76eb709cc69b,117,91,4,204.75,90,27,10040,3
0079984b08316a6c59ffc60f2bf2f0fe,146,98,3,340.6666666666667,146,0,01085,3
7b614bca1e83507240810c0dd1150554,46,38,2,161,46,0,09150,1
96f0d5b389df0b92e4e95f8867e90571,81,60,3,189,62,19,05040,3
42ad202d5ab0b72d158839779433c211,28,20,2,98,28,0,09170,1
10e6cf1cd2d55a4b1581af81538c62a0,24,24,1,168,24,0,01251,1
f6515c36fe96823787c824ce53b69522,56,41,1,392,0,56,08170,1
c7c036d0711313e06d14ad48a7e72367,29,29,1,203,29,0,04020,1
a40e75cf73b531420a584c39a2d747d9,41,29,3,95.66666666666667,41,0,01012,1
5ab984dbd35fc1d51f557a5461f15b9f,93,47,2,325.5,93,0,05041,2
a6e386ce96849cd9285e4c83a93e4731,14,14,1,98,14,0,11100,1
7b9187c2b0c132c6b71a181cd531f838,10,10,1,70,10,0,01085,1
939987c3adf4c38d24242358fef14b9a,8,8,1,56,8,0,05030,1
ede59059b72c6d8020d4a26856b23862,14,14,1,98,14,0,04020,1
2b316814a108e9e257c35ff62b3a9120,49,41,2,171.5,49,0,05030,1
7b11a1c7a185e721f479521b052c7f65,112,92,1,784,0,112,05040,3
b8cd72236319dfe46e2c5852bce48b1d,25,25,1,175,25,0,10280,1
11fec6d7b4c589cfe795022762b39b56,17,17,1,119,17,0,09090,1
e857bdc36c7aaf7f7de04f562bf02c42,60,44,2,210,60,0,05040,1
e9de5fcada151f9b365038a96dc218c8,144,33,4,252,144,0,11040,3
6327b7083f854077bfa846c99b9901ec,328,144,4,574,328,0,05040,4
123d3daa2590b84344a251da7e3ac460,147,89,2,514.5,60,87,01026,3
ca08497dcba399859e17e71eb01a23c5,90,64,3,210,62,28,08100,3
755fb36b1b55a21d832948d0fe081338,117,69,3,273,103,14,05040,3
738e71c6df9bdb570af00cb8fa229129,166,105,4,290.5,166,0,04060,3
2cd9b4e4762097d57c2bf1a30f8b91bc,500,136,6,583.3333333333334,160,340,04020,4
00ac2054f836bb2699e53a42d4b73f92,284,159,4,497,284,0,05040,4
ba41e8fc9036fc2ceb95e33325b265fa,21,21,1,147,21,0,01012,1
e4435555f2f49f0164e6194112c3e8ae,20,18,2,70,20,0,02690,1
5a3affde14062d03a7f6bebdb73abb6f,34,29,2,119,34,0,10040,1
2dd10a17a61d59eed81afadd05679aae,46,41,2,161,19,27,05040,1
49ad945d543bddef58f1087b9c8d4201,12,12,1,84,0,12,05030,1
3e575561abec8728ec50e9861aab583c,72,55,2,252,30,42,12670,2
c8852c0c687192d85822f431b4b3e60b,261,125,5,365.4,198,63,05040,4
43ed14a4a728e8d71744bfd18b6304ed,22,22,1,154,22,0,09130,1
aed88502a37fa394c72f07895927b98b,66,57,1,462,0,66,08150,2
c4162dff8e0170dff1b855824682cecc,39,32,1,273,0,39,05030,1
ae99efb845f2bd3a77edcb6d2f5a6476,81,68,4,141.75,40,41,09150,3
8aac04f3a989ddc255db0e7e97430c0c,236,149,5,330.4,158,78,01026,4
274aff02d51732ccd40e04d2cbfd2351,297,104,2,1039.5,297,0,11040,4
5eac545e1f70e8129fdd9291cccff1a4,22,22,1,154,0,22,05040,1
43e47219b549652a5e1407fd618b89e2,79,52,3,184.33333333333334,61,18,09130,2
ffceae3567a396c24b3bd91ffad9c772,91,66,4,159.25,91,0,05041,3
566194806a261835391f373ae88d4f80,31,28,2,108.5,31,0,10028,1
1725e418fe275b0578279b76b84bc93e,41,41,1,287,41,0,05040,1
a33c8edfd111e8548d3886d3aaff1142,117,117,1,819,117,0,01026,3
10d78d8c9a9052d4638e4262069bfd91,207,95,4,362.25,153,54,05040,4
3e2588432c03c7de8407ae4433eed34d,59,59,1,413,0,59,08312,2
31746d53e2a9db1963d82a763970475d,116,52,3,270.6666666666667,116,0,01201,3
cc5fdad1968d7b0f90bb3ae1544330e8,63,52,1,441,63,0,06100,2
c1fcfd2e04f06617372aa308705d36a9,66,61,2,231,66,0,08100,2
fa443d6ff6060a2fb591c7706f26a8a9,26,26,1,182,26,0,06120,1
12aaca1a7df2c988a72336751573a20d,19,8,4,33.25,19,0,11080,1
d56d815141a4b678a0b1aa9151b1eb1c,30,30,1,210,30,0,10200,1
2cc4b4a1ee171e23b8d2cb56acdd378f,58,39,2,203,32,26,05040,1
84828133be2ed908948ed83a678ebda4,18,18,1,126,18,0,01026,1
757e3009a093524868753cb03491b72c,37,37,1,259,37,0,05040,1
6a591a6d9626b57b1dc49b1c9038a8eb,4,3,2,14,4,0,13930,1
88da7314e3155ae04e0bc7d679c3a9cf,22,22,1,154,0,22,11040,1
042982e9e565b85147f5d46f71c58aa8,50,40,2,175,22,28,12470,1
eee05f43f1fde97c275f701d7e900bc2,48,42,2,168,48,0,05030,1
de3bdac1a826ce7002071dd0027b1d03,54,42,3,126,23,31,01012,2
864d08bdef715a7348087497ae5d92a2,61,32,3,142.33333333333334,61,0,09010,1
281355b1abc20e09d4150579b01641ff,5,5,1,35,0,5,12430,1
301f57b66c76d5e60ede382a052d1112,141,80,4,246.75,141,0,05040,3
280b08068372b11868144130c0abf405,56,38,3,130.66666666666669,47,9,08032,1
cb7947f8a44ff31f12791300750d78d1,30,30,1,210,30,0,05100,1
6de3f079b5d57499336e2143ee6053f0,84,35,3,196,61,23,10220,2
d17ef9f3d78ce915cc341c61cd4eaceb,97,82,2,339.5,97,0,01012,3
a5f025340fd57f0b4e82502d19e3a4f1,63,45,1,441,0,63,05030,2
b0fea5093e45ff488ff9a805cac04151,35,27,2,122.5,35,0,11040,1
a1e69b335d50b4f5313a88c5870b200c,115,89,2,402.5,115,0,01026,3
c0f985cb5fea35a5c77ccb94c1caf03f,435,154,4,761.25,308,127,04032,4
7c47070d97a9dc5ab6ef520cfadca780,48,25,2,168,48,0,05041,1
282aa2bceb3bc863b0efe596ff5b9d1e,59,59,1,413,59,0,01012,2
15c0f3f90cf8a309c9cd4e8b61cdbc7f,52,52,1,364,0,52,09010,1
6c8e4a255df44eec0203a8396c69bea2,28,27,2,98,28,0,11100,1
55c9a39002d552b8b921d1817da2a195,532,213,4,931,532,0,05030,4
6f16d6b50c271529778273ba2c9eee23,101,70,2,353.5,101,0,10200,3
a89d280e8a8228da572cdc10d0212586,173,100,3,403.6666666666667,121,52,01026,3
3c6685eb61c237c7aff5a9dbd23e8601,44,44,1,308,0,44,01026,1
a3249300a994558ce756d1db0907eb60,89,56,2,311.5,51,38,05100,2
174f89385bebdaaa50448a53cfb7fac3,2,2,1,14,2,0,11040,1
8197753e00a1fd573aad94b8e9d23f02,587,225,6,684.8333333333334,498,89,01012,4
feb524cdbb7d30fcb8c627dc4419246f,88,64,2,308,88,0,01201,3
9741b17215b9e0a91073a1612b3e3213,32,32,1,224,32,0,05030,1
331101db47f3e886084bf854398b1314,17,17,1,119,17,0,05040,1
916cb5ca6527fe488bcf6098ca3a9e98,7,7,1,49,7,0,05030,1
812652095a69bf58cf3cc6bcf582729e,19,19,1,133,19,0,07141,1
b260e176d309f1cb928d2460dc7ace06,55,55,1,385,55,0,01012,1
d9c5b42687419720aeb8f3059df1d83c,37,28,2,129.5,37,0,11040,1
cc767cc248a3317286e8a45ddd505018,2,2,1,14,2,0,11040,1
ee8aec55238bc3f7723a90a6f6b8b406,35,35,1,245,35,0,11140,1
5fa42f71265976c59fdde74dce776c20,36,28,1,252,36,0,10153,1
c0fb5c0957f48d7eae0753b2fdc6471d,155,72,4,271.25,50,105,03070,3
17f770326b7b3037838089bf9a6c5ee2,28,28,1,196,28,0,02690,1
44c7a0f590589b9ca6fcb1942aaa67a4,12,9,1,84,0,12,08010,1
0d1dc2ba0475531f68995e2d5cd64aba,36,36,1,252,0,36,04201,1
9fbc5d217bf447695aaf788b503f8ed9,20,20,1,140,20,0,01027,1
d83d5822c1414abcbf92518aef74f95c,6,6,1,42,6,0,05030,1
46af48aa187b4abb1a303c0b9534ef90,86,60,3,200.66666666666669,26,60,05030,3
c9c5a1eaa0596da76e65fece2988956d,14,14,1,98,0,14,11100,1
0378a27fc7276970e37c85a7d2ddf345,19,19,1,133,19,0,08052,1
b522707c083b1cd74164d9da37a69dc3,127,56,2,444.5,127,0,11080,3
cc2ae93db1923458c1dc39e22a7ae81c,47,40,3,109.66666666666667,23,24,11100,1
44c536faec7c7c0c3e3d40122ff642df,45,37,1,315,45,0,05040,1
b679fde5cf298437f33a62885b16c286,235,67,4,411.25,148,87,11100,4
b44db111f92b2d49de302e20cf2249ea,116,85,4,203,89,27,01012,3
0902ec64248723bf8a8665102e41ca7e,123,66,3,287,123,0,08100,3
8f4a4a214e002d4871d4ee751bd02f90,105,70,5,147,80,25,04020,3
ec86710919afc01517df758d6d0741a0,80,69,1,560,80,0,01026,3
e0bd44d8dddaf315225141f7037190ed,53,37,2,185.5,33,20,09130,1
16863f3ba44eb4d842f584d98d16f01c,12,12,1,84,12,0,09130,1
6a02e02592cb98b08cc4799f3fee9813,196,84,3,457.33333333333337,196,0,01026,3
7fb22e763bb853ba56d11eaeff123352,50,36,1,350,0,50,10200,1
e6122c851942a1469069793414851417,14,14,1,98,14,0,10080,1
d343944b45ed8525c0b633e769aafb75,46,46,1,322,46,0,01012,1
e0676676be2b1e427fa29af9d08ec1a1,106,82,2,371,106,0,01085,3
dd445bbffabb19faa7ba703dd5d33ba4,37,37,1,259,37,0,09110,1
6cfefc11e986be632743c80a2975f35b,73,61,2,255.5,41,32,01026,2
6dc7fd838e8ea1d51965701994a7d603,34,34,1,238,34,0,08390,1
29adbd484d2cb9d36adad30052a29b4c,122,82,4,213.5,69,53,05040,3
f18e46da4b8b03a3785aef90824ce10a,34,34,1,238,0,34,08230,1
f91b13cff9792c7bf494c4f6511cd9d1,63,46,2,220.5,63,0,10200,1
97f484f8cb8098d8ba95a58873af5749,55,46,2,192.5,55,0,01027,1
f5b565eed20c6a9b0c68e2414c628d66,7,7,1,49,7,0,11180,1
56341b212715444edf35891c073b918c,167,108,5,233.79999999999998,132,35,05040,4
cba215ff2bea80542e42524d8b9f8371,208,121,4,364,208,0,01026,4
15e332e7b63d52bb6bab7ced03e1da66,88,60,2,308,88,0,01012,2
9e4c3cd60bd5ad63cf99a96e90fc0dab,303,146,4,530.25,64,239,05040,4
1fc294bba84ac2dc76d848d8ddc7e618,116,90,3,270.6666666666667,77,39,02650,3
296c3670a1537ab5d4ddece08debc203,279,137,4,488.25,199,80,01026,4
423ca9c93ef8f5332420c03a769c0ff0,11,11,1,77,11,0,05030,1
f4a495820c1862711f9c72555dceda5e,89,53,3,207.66666666666669,89,0,01085,3
ae3df7132f25a023b11f508f528153a9,15,15,1,105,0,15,01027,1
9721e357b9d4c507c1dc0bf21dbf2444,226,108,2,791,226,0,01027,4
145230977bb91dfcaf21d86887fd4964,223,159,4,390.25,204,19,05040,4
3a1210ec72cc449abc2c4126e6dc12e5,68,47,2,238,68,0,09130,2
ef71b2859513d6023e6549b0a268259b,14,14,1,98,14,0,08032,1
194128201546a3cc4cf5901d7de77b05,55,30,2,192.5,55,0,10200,1
601e78a2bc4c13d8e639f42dd8ce5f0b,32,32,1,224,0,32,01085,1
1009eca815628b9a0dd947e2f0d8669a,194,93,3,452.6666666666667,194,0,08131,3
73f2420ab54f06d899dc17bb49450ec6,95,56,3,221.66666666666669,95,0,10200,3
5add30e97d2028352e071ec003861553,20,20,1,140,20,0,08010,1
74a3d56b8b9988e1d3dc5c3bcccdb382,309,213,4,540.75,223,86,01026,4
5b663d08577928b74ad484edacf3303b,51,43,1,357,0,51,01012,1
b613b22c22d122cf23faa9228e6b10c4,22,22,1,154,22,0,11100,1
f4d73501900da321efa685a85aad929c,19,17,1,133,19,0,10200,1
5f5b1390a5923c59d7be9f0d2e0bdfa3,13,10,2,45.5,13,0,05030,1
56e539b23ed27322cae07d0f9160d1bd,36,36,1,252,0,36,03050,1
2f1b2357b4f23fe65cefc259f48674d1,14,14,1,98,14,0,01026,1
eb0371376c03322b3a2c027dce79e014,6,6,1,42,6,0,05041,1
dce61d4e4f0182b2b3e0be187b80b6c2,18,18,2,63,18,0,01012,1
c2146732845f8d093ed7519ad12b5936,40,40,1,280,0,40,12500,1
d4e93c67f6a1ad338d2f0f2b91dfbf6c,2,2,1,14,2,0,05030,1
f86143191da2509fc656c21583806130,44,34,2,154,22,22,05041,1
4bbe95c12f8c914b492d099344336821,39,31,1,273,0,39,11100,1
458a6b2e66c3621a946460afd708b9bc,26,26,1,182,26,0,08051,1
0e2f7dc2ac5ab7b808671fd9a322bd8a,97,79,2,339.5,1,96,02650,3
136def00dcb8e511a47d265341232ce9,120,75,3,280,120,0,08051,3
ca3699a098cdabf827077931d4cb981b,7,7,1,49,7,0,05030,1
88ce8f2609385c82c1eeb1f940d77934,239,170,5,334.59999999999997,184,55,01012,4
d0746cf25622db7812b0c73375d0acd4,118,74,3,275.33333333333337,118,0,10200,3
0e705d2fa8b3465a70963ffc5ecf33ac,19,19,1,133,19,0,11040,1
d8fc2ce5cd60ea5984ff5180fe64bf75,3,3,1,21,3,0,09010,1
f04874ebf3b70e79af8265fda78da763,155,78,3,361.6666666666667,80,75,09010,3
a5654caf5ead5b10eac296882ff46456,21,21,1,147,21,0,01026,1
0a9be7ae7aababf27c6bb829c4234175,12,12,1,84,12,0,08230,1
43a2983fef96c17b02c52b9f88de6182,21,21,1,147,21,0,05030,1
b60102094c42cff2aafd9813d665f569,205,65,4,358.75,205,0,10240,3
fd4f3653f1b2f6c3b5374d935f21a9f2,16,16,1,112,16,0,01026,1
f0eb4a3dc85cd1cb0fe0a4a7e762c657,172,86,4,301,172,0,02756,3
987ff424af347b9819c535f6e3eae1a8,69,37,4,120.75,69,0,01085,2
c158cde3a28027561452eb887f6f06c6,62,40,1,434,0,62,01085,2
b197462c110ddbe5538c8d6c310e991d,139,83,3,324.33333333333337,65,74,05040,3
a95654575964c47755b870d3cfbc55ef,36,36,1,252,36,0,01013,1
95b2ff30a39f56bede3e278fe7e070d5,22,22,1,154,22,0,05100,1
ee2dd6c8126d359438cb79ea5fd9d2b0,33,33,1,231,33,0,08010,1
102ef68c611a9bb9071d41cb7587a912,80,78,2,280,80,0,01027,3
06cf0d006cee683c8f738049844caab1,55,55,1,385,55,0,01026,1
0dd4a4a082ef382fb415c0a25e238f14,22,14,4,38.5,22,0,11040,1
7fcee0df2bbc19efd7ebee3ccabfc920,30,30,1,210,30,0,01201,1
36a52d7aebd0e1ae54d8dcfaeecf31c6,38,38,1,266,38,0,05040,1
1dc2fd490c323424aa52814244b98f93,139,50,4,243.25,117,22,05040,3
cb0c7b63311f324ff462a798465b1f6b,1,1,1,7,1,0,09010,1
ccd01e2bd5eaa202aae4c2164f3b9529,33,33,1,231,33,0,05041,1
c8e929e226dc6c7d3fd87b355fd80764,221,132,3,515.6666666666667,129,92,01012,4
b40cdb42b0484046897963fd79fe75a0,37,37,1,259,37,0,04060,1
6bf80d1b0be9b83c67a3a22b4f429807,102,64,4,178.5,102,0,09130,3
e46d4e45259d49fca44ccc47dc66ea77,20,20,1,140,20,0,10200,1
bef1da30fe39b555dc81cf043bebb732,210,125,1,1470,210,0,05100,4
a9f0a8534eddabbeee0976284610a273,129,95,4,225.75,129,0,05040,3
27923b11afbadb5c64450c550e83e3b1,46,46,1,322,0,46,08031,1
54ec7fe4bc15bde548f39db031c88b63,35,35,1,245,35,0,10200,1
e8ce59a111a9475d7c3733b749c44104,62,54,1,434,62,0,01013,2
82ef87fda65bb1857e775933191e76ea,44,44,1,308,44,0,05030,1
8b9e5755a6e494d0f54c188584be6836,443,149,3,1033.6666666666667,398,45,01013,4
ed31fb4de945b742702539a420283b52,19,19,1,133,19,0,01012,1
4da8b89279725fcabb4fdfc9e485d50f,38,29,2,133,19,19,05041,1
4aff7af3abf1ee4eabd793aa5a8332a2,20,20,1,140,0,20,06100,1
874e7f2a5995c7c747f7c80df8120c8d,231,82,3,539,152,79,10200,4
5d8db244a18deb11f02eef1a7bf82884,279,91,3,651,279,0,10200,4
eac0fc7c5d1eb80a2db275dbbf1b3bab,40,40,1,280,40,0,01085,1
eb23e466044b4a0ea3de6bda703c8b91,3,3,1,21,3,0,05030,1
caf4ae846ef19661c118eec8d678d90d,74,58,2,259,74,0,10200,2
0f06898b3ad6d4a4e40d34d8369602e5,216,95,3,504,69,147,05040,4
402d795649d0c7efbfb70c5fc98e8e9e,107,80,1,749,107,0,09351,3
f8a09e1b9e093145ad6692d423a330ef,147,86,3,343,89,58,05030,3
e22c10abfee59bbe76baa0491c600fab,52,45,2,182,52,0,08031,1
f17da58ec4353eb077a675337c1c2da2,74,59,1,518,0,74,03070,2
32ba706da131a8c67989b719038e5f2a,83,55,3,193.66666666666669,61,22,11080,2
597ee2e064c6de0937aaf55608704e3e,166,90,4,290.5,166,0,01026,3
df794a19c3183ed4f4656a83d47b4a0b,41,41,1,287,41,0,01012,1
be18262acdb129f3a7e952416251f402,28,24,1,196,0,28,08231,1
21f37304b938bf2692b3fca493566d78,37,37,1,259,37,0,01012,1
e1b478caf3e605562fc9497f9713e094,71,58,3,165.66666666666669,28,43,08100,2
1af0440545bedcd8bc457c0cb7907d3a,30,30,1,210,30,0,05100,1
88f7c2c72683bb5e893532e1021733c7,25,25,1,175,25,0,10220,1
43bab911b0455c3d41c3b6b18a5b2bbd,20,16,1,140,20,0,02690,1
b9cd8e95f35a57e99436cee8f81e465e,54,54,1,378,54,0,01012,1
a899737b81287175976654535bc4da52,60,47,3,140,60,0,05041,2
c84c071730cf88cc8dec172cb554a6cc,114,80,2,399,114,0,01027,3
19825b5e74e82bafe170d2b5f37e17c3,176,76,2,616,176,0,01027,3
29286f3f5ce847e561e2932d717aec19,101,56,2,353.5,101,0,03070,3
661905bd53e601f134819c25ae0db07e,69,50,2,241.5,69,0,01026,2
f0b622d29e7a100c9ff7bb2e25cc329a,15,14,2,52.5,15,0,06120,1
634c9b0a7841a0b3c184f75efd2a34fe,59,41,2,206.5,59,0,12710,1
b3d3f7793d444db7e46d3b69f6063c1d,26,26,1,182,26,0,04020,1
0bff7cbe787d1f373ef46a6bce63b264,2,2,1,14,2,0,11040,1
8dec0b14f42b843b937681044a42f60e,428,158,4,749,345,83,05040,4
536214a9c77efef484bf808db3d334c5,145,75,3,338.33333333333337,145,0,10240,3
7a3416f0ac55adb78831bb2e5afca4e0,26,26,1,182,26,0,12710,1
1e91aa3ea886e6c0d68c1aad6322a98d,13,13,1,91,13,0,09090,1
a9a3b5f8562f4ab72235fe50ba9eae33,22,22,1,154,22,0,04201,1
a9a6c9402b0c158e8b986f7aa0813d81,81,59,3,189,81,0,05030,2
dad2cee731ea0760bbfe03b7107e625f,38,38,1,266,38,0,01026,1
a1fb59c8d671864def99b566a7e4384d,237,103,4,414.75,202,35,10200,4
cabdc50b31ce4bbcf210bb3dc9a58d9f,493,135,2,1725.5,464,29,01012,4
f3eaa1b73c6a66767e913302d386cb69,3,3,1,21,3,0,10200,1
c5ecf5ba3f8be7702f0515f739b35658,104,71,2,364,104,0,08232,3
00d8f59e05d4fc602c2b60ef1f5c96b0,49,35,2,171.5,49,0,05030,1
0f0b76888f058244e726d0224f01ec8b,5,5,1,35,5,0,05040,1
c29a320b9101ab55855e81aaed31a3d5,73,59,2,255.5,42,31,01012,2
5da2795c679b59599071c1ddf0655393,22,16,1,154,22,0,05030,1
d5aa16c9a58c824e87bc8a9090c8ae5d,135,98,3,315,98,37,10240,3
4ca0e92fc34a58e91eead00ce6632799,30,30,1,210,30,0,02650,1
c803b2738ff8a367e0798537466f3914,27,27,1,189,27,0,02651,1
3ce6958934a2b06abca19f2da8a84f7c,90,48,3,210,51,39,01012,3
a0e309da3e11cf9631613f296d02c468,54,37,2,189,54,0,01013,1
3452ce695f95957eff0e826e13513f27,198,141,6,231,158,40,05030,4
a012cf03bac8791893848a4b4be0b04b,49,46,2,171.5,49,0,01027,1
c4d690e3e8b411339665a600cbce5523,24,24,1,168,24,0,09030,1
adf2cc25c883f45d791ae778da14c15c,142,91,2,497,105,37,09030,3
6f64115eadd6417d9e14e25bf66f4f0f,17,17,1,119,17,0,13490,1
c9645f1ef02fc55d0d84b1ae3728ae10,25,25,1,175,25,0,13877,1
462cdd52cc0f42f68236076fc413bf38,66,38,3,154,66,0,05030,2
14229122833932e15d8fee97df5fdb79,70,43,4,122.5,70,0,11080,2
9d78f88dc6c7c98543f56e61889f3e73,48,42,2,168,48,0,05040,1
4f141ab11356bac75367af739d30500a,4,4,1,28,4,0,05030,1
d4b0fabcc907fee4d76021cb611db2bf,112,62,2,392,15,97,09010,3
244417ce8b277191a5b7d318c1fa47da,190,78,2,665,190,0,05040,3
fbe3c563c18ecc1161c8e688035d0b5e,62,38,1,434,62,0,11040,1
43efafa4ac75a65a5cadfc5c8051921d,51,45,2,178.5,51,0,05030,1
ae0d5571ab37f891d071692dceb0b0c9,40,35,2,140,20,20,01027,1
701e1633ca710ed3ca27fffaf97ae954,243,133,4,425.25,243,0,10200,4
4ab8e3cf02892e33fc0fc221e5d4a920,44,40,2,154,44,0,05030,1
07a40eb2774ec9363fe9dbffd7ca36fa,110,83,2,385,110,0,11100,3
be4b2c61d8f9655a42229f7db3e3e198,67,50,3,156.33333333333334,46,21,09190,2
fb7cf08bbc2a54a5b374086dc11004d8,144,82,4,252,84,60,10200,3
c29f6885e6455bdbfa6d55ae71273038,179,97,3,417.6666666666667,179,0,02750,3
f0e75ec262e60615c95a096d4057fe3d,27,27,1,189,27,0,04060,1
5d5f08f6224f6444cbc2042a1cb95f8b,34,34,1,238,34,0,01012,1
617c332f2cd4f4fae683aa2baeea126b,178,112,2,623,178,0,05040,3
efa5d86711b0dafee88b110f4fd2cc31,158,91,2,553,158,0,10200,3
d3ba17d916b8e9e7ea2378829c2cbf8c,45,45,1,315,45,0,05040,1
cf9d03d6ace77ad595b29e2a31612f8f,24,24,1,168,24,0,01201,1
63d6a714ccf8e7fd5a0b591d1c91554f,40,36,2,140,40,0,01026,1
e2f1de58efd881990c6f0992542de22f,89,50,2,311.5,89,0,05040,2
a4d9c27d9f1ea5e3feb6fa0e3e2925ec,21,21,1,147,0,21,07131,1
7210f066c5b870502b4a19d63ce56918,354,76,4,619.5,354,0,05100,4
a812b272d93284a0dd58884bc6be4ee0,50,50,1,350,50,0,03050,1
3641105354d938c7c1725bfacd7ed09e,27,27,1,189,27,0,03050,1
19148e217640312f7b8c5919ceda501f,10,10,1,70,10,0,09130,1
a91282791d38d0beed53fa3898832835,360,110,4,630,183,177,05040,4
9e4871c3d4eff645d915393cb0a9e24b,38,35,2,133,38,0,05040,1
fdbe7c68cb201b708a9288a1f50f4f2f,23,22,2,80.5,23,0,04201,1
b5eb66bc7e79f092dff6787f83c01a92,6,6,1,42,6,0,01012,1
4d74fd77bc3385d75beadea29276afca,43,42,2,150.5,15,28,04201,1
36ffecf6d3599f0d4638fba677de61c1,209,106,4,365.75,166,43,08010,4
959edf5d45a6d5524dc2746481bc4ee1,93,76,3,217,93,0,01085,3
9b7ec5e3cc48e5d96f2afedbabf07047,549,166,4,960.75,549,0,11100,4
6b15b909c2dfae08788a1797dc1300e9,33,33,1,231,0,33,01027,1
f0943a1098431c8b2d1f2db221927617,131,76,2,458.5,28,103,11100,3
53c767c35fb3f83fe4d6f3f4c44cec7d,37,34,2,129.5,37,0,03090,1
8d26c3736ba0956d7f30a1ba00716464,43,31,1,301,0,43,10153,1
256b4634c66d6b2d8001520ebda9c645,49,49,1,343,49,0,12500,1
1f7e93d63bfaeb179d18c4beae3f232b,8,8,1,56,0,8,01085,1
4e0b1e89411a8b0e0eeef65535217772,188,107,3,438.6666666666667,136,52,01012,4
c2a4af66d75777d6b22159d79a363e3f,19,19,1,133,19,0,03070,1
80742c18b3a5a9850c654441f93bd111,75,63,2,262.5,75,0,05040,2
30ce9c7ad9f4f65d1e599915e96d610a,88,68,3,205.33333333333334,88,0,09130,3
94f0e6c3b29e9b483dfc6b9024372e26,138,94,2,483,30,108,01026,3
5361e235a3298102582aa767d8562b7f,66,52,2,231,66,0,12501,2
6b3786b4efbf804a5ba4ff1cdb534d55,206,77,4,360.5,177,29,05040,4
1a74d2439b3f949b0e39d9ef8037a448,177,75,4,309.75,177,0,01085,3
e6f9718f2dbbb85b02b547923e4557f8,26,26,1,182,26,0,04020,1
710cc6cff2b7c568eb13b7a0e08fc204,129,50,5,180.6,108,21,05030,3
c249730e4a1d127c3df2e2251ad6a48e,30,30,1,210,30,0,03090,1
27e4da0e1460a899051ab0fe80542542,15,15,1,105,15,0,04020,1
f5c5170b4f3f3600130581cce20d69b1,239,105,5,334.59999999999997,221,18,02691,4
83d370a7c8950cf4d0c606d398caf0e1,20,20,1,140,20,0,14351,1
f6d004f3baabda229a5dd1623db7d5ba,16,16,1,112,16,0,01201,1
026425bea76a9f7488f1724ede4388ed,201,134,5,281.4,201,0,11080,4
6b7cbee93ad95cf0dc5b81512295591c,19,19,1,133,19,0,05120,1
6f52b5bf1670b6d4c27d21d2cf376adf,8,8,1,56,8,0,01013,1
f7260b878a9f1ad4f0ec231f9efa5f4e,16,12,2,56,8,8,10240,1
19ad6d69b235b19bc74d450a0c6562ee,76,76,1,532,0,76,10220,3
61520d285dab8bb3a12e66b70563873f,35,29,2,122.5,35,0,12670,1
286a16534ce694821347e3ece4cc8acd,25,25,1,175,25,0,09130,1
814ad94f0441c4f3dd8435d40cf43b2b,32,32,1,224,0,32,08090,1
0d58655362ce1be258092e2b32ef60f6,85,72,2,297.5,85,0,01013,3
d83d9ad60e8771fbfea19ec26576c2a0,120,100,2,420,102,18,05100,3
e24581c9f1f0534a7128a333da75b78b,26,26,1,182,26,0,03050,1
a5ba3efe1203f47594af60dea3708c98,47,42,2,164.5,47,0,05041,1
38f0c93ea4d484b9d9df856560238bd2,167,81,4,292.25,167,0,10200,3
7e8143f24d3c8d7f0a979f1a517fdcfc,12,6,4,21,12,0,11040,1
f30414b22057627f035b3f41cbe94c0b,118,89,3,275.33333333333337,118,0,01012,3
c425cd24c498601d4b69d851a7ced1a3,72,36,2,252,36,36,01013,2
f5c2e1595717d3ffd3ec6369ad1033f2,46,46,1,322,46,0,01012,1
d9e406e937296dc6eb0b154ff1b97c52,166,79,3,387.33333333333337,120,46,01026,3
8650a5998e21af0d385093fbafef8b17,34,34,1,238,34,0,02650,1
e5404d8bdada7a35c0e49f398a6ece38,14,14,1,98,14,0,09010,1
5c4671e9c337bc2bdba0f5205cea3ab2,6,2,3,14,4,2,08315,1
fdc99261b6e4b6e3ef152bb21e110bf3,31,31,1,217,0,31,01026,1
218fafefda3857cf371985117c744537,114,50,4,199.5,84,30,03070,3
21f5d130797167551655d09c0a052680,11,11,1,77,11,0,12650,1
78c6ef1d17c6e6f65e6cbc6dfa129fc1,152,82,4,266,114,38,11080,3
d2209e96e2ecfcecf722c12dc1f4b1b8,20,20,1,140,20,0,12590,1
8d5a9e3d86b847ba1ad9a1d42d3cf761,93,74,3,217,49,44,05100,3
ea9377a77b7caa0fedb13bb16b3ddd2e,135,105,2,472.5,135,0,10200,3
8ed0d93b5306392cff21ab4234ca7f4f,91,64,3,212.33333333333334,91,0,01026,3
f30357d602f63e57d287336425494ab2,15,15,1,105,15,0,05040,1
ca44b1d2df8c9bdd2aa56b50fc0921c8,233,130,5,326.2,188,45,05040,4
de4d88ead221dc2ead1c397f5f074b77,58,58,1,406,58,0,01026,2
418883a92b74c00cbc52007b4d060703,96,74,2,336,96,0,04060,3
44fa13a8fb72c2fea318571793a74b98,174,54,4,304.5,104,70,01012,3
8c3c3bb9b66fc8640351fe1a93ba50e9,9,9,1,63,9,0,01201,1
183496cf444a6bdc6753bfa3a4a48847,216,111,4,378,139,77,05041,4
983f06acf13beba40c8f8e60d805132e,179,101,4,313.25,124,55,05040,4
60f6c8ffe7debac32e593afe3ca1d983,41,41,1,287,41,0,08314,1
fcc25eb5f7c40cc09521e6c891f59f63,7,7,1,49,7,0,05030,1
a6dced6e1c3a843b1577757ffdb54f56,88,54,2,308,88,0,04032,2
838084a427a08f484ccd9523f4d3632a,24,24,1,168,24,0,01201,1
8ef71b25f39305f7242b489ed07daebd,139,101,2,486.5,139,0,01012,3
8427874e4d21887f10ff451d06e4af11,245,131,4,428.75,245,0,01026,4
a8e3b9c4ed844b386b8adae0c9e0ab12,28,28,1,196,28,0,02690,1
0742fc12192debbf2f778ef231bd0c29,694,189,6,809.6666666666667,627,67,05040,4
db0118a038a841ce2a351f85153ed0e2,27,25,2,94.5,27,0,03070,1
0576cf49778253161204f95d618ad3a9,21,21,1,147,0,21,08032,1
ea6fd30fc600684110e88f15861fa90b,104,76,3,242.66666666666669,73,31,10200,3
226d854f417a37f7cd72bb42dc7dd557,86,64,3,200.66666666666669,58,28,08314,3
39d5dd457e77a3f19ad5d6995d10a23b,539,189,5,754.6,477,62,05040,4
c16052ba95676a119a0f97c25e418fad,17,17,1,119,17,0,01012,1
db94b088aad770eabab65c471c557cdf,36,36,1,252,0,36,05040,1
9dd398536d6727a2cab790160728ebba,26,15,2,91,15,11,09030,1
4532a157deb2614aae685a35b70c1d88,285,138,2,997.5,285,0,05030,4
94aa54f1d68be8b4978e7c7ed3f48573,65,52,2,227.5,65,0,08100,2
816e94919ee01e52aa8d45f486993630,288,116,6,336,250,38,05040,4
984c5bff9f4f1052dfa0193c151ce0f9,8,8,1,56,8,0,02652,1
614275455a4be830fcbc90c091f741cb,122,60,4,213.5,105,17,01026,3
0a6adfed81e3c6cf54f30a5b023d3720,26,23,3,60.66666666666667,26,0,13490,1
a5702a86fa35a7ebe1b410427140cf70,25,25,1,175,25,0,01085,1
936f81d17b05971c8c614466f37a46be,4,1,2,14,3,1,13930,1
3677118e0a9be9603ae75fc377d7d305,10,10,1,70,10,0,05030,1
cf64a6bcf69327e6a97faddb8c709c4d,184,80,3,429.33333333333337,79,105,10200,3
23eb4655e76031bb23a6fd7d0bd4299b,39,32,2,136.5,24,15,05030,1
c23330d365a5cfc6cb8ca3b789c08b00,445,216,2,1557.5,56,389,04020,4
a862b87b086ee310763cb7005b434444,76,47,2,266,58,18,05040,2
6720e30dce91b393536312b64b33b196,186,88,3,434,186,0,05040,3
f2f29ee1fd26ee3d5a89d82000b6c55e,145,70,3,338.33333333333337,145,0,10200,3
d6127b02edbb509470296ed455b570c9,121,53,4,211.75,75,46,12501,3
9bde01ce004d286b8c1bf78cb5b8001b,11,11,1,77,11,0,10240,1
265d78ddcb0dc04e8667a9e8e6b07760,147,102,2,514.5,147,0,01026,3
c63c6f45f63b99e84fad646316551dc8,244,101,2,854,220,24,01026,4
53df9f7706134ae07abc25ae42cdb418,126,75,4,220.5,95,31,09130,3
76e158bc1ed1d1da84f48fbf6ab12faf,62,41,2,217,14,48,07123,1
19d01bb7cd24b7e6a03ce70745ca25fa,75,71,1,525,0,75,03050,3
ac58fa4f124d2289b241ca4e66569e7b,13,13,1,91,13,0,08090,1
534056521c63792928895e3548f447bb,65,54,2,227.5,65,0,01026,2
a255b0fb1ff8ad766c7194ae6db353d5,482,135,4,843.5,482,0,05040,4
6ec0d744658a6ae6779029d02d40678f,218,121,6,254.33333333333334,206,12,06120,4
bb458d930e4a3f73aeb00993202fad1e,10,10,1,70,10,0,11100,1
e0b3ea07f524214f5b03f04914bbc01f,48,48,1,336,48,0,01013,1
b9d225354e5c5730e5eaaffd75b5c321,1,1,1,7,1,0,12590,1
b123c3d264b8647b613a854e4ffa5f92,43,43,1,301,0,43,01012,1
0576381f893561267ebe90d9ed07eed2,106,60,3,247.33333333333334,106,0,08010,3
ed71abb727f1b0f6494bf365c774a664,261,145,3,609,261,0,01012,4
a0d2c81f0436913947937956570835dd,150,75,3,350,150,0,05030,3
1d08d3e2220c969fde7a5d383079b331,37,37,1,259,37,0,01013,1
572c42a03b3327c5e209eb505633016f,18,17,2,63,18,0,09010,1
18aba9eaf103a2c4323f7ea928a29f0c,114,92,2,399,114,0,12570,3
7478b0981b7896e9740d7233b76e952e,70,51,1,490,70,0,01026,2
7099dc6a03bc7bbe951630bb47559afe,61,40,2,213.5,61,0,12650,1
e9b9ed6f07b893e3c7a658c831dbfee1,16,16,1,112,16,0,05030,1
a39403e0e189bc198bde9c89035c9419,1,1,1,7,1,0,11040,1
b4b6ece66d571d07e9684f66cfc67dc8,188,125,2,658,1,187,08314,4
32d34d2620603e65e74f6550ede3272b,17,14,2,59.5,17,0,04060,1
ec95532b4795b1129635b40d86463763,92,85,1,644,92,0,01026,3
d3dae87b8486c563f0e26636ddc7ee31,71,56,2,248.5,37,34,01026,2
5ede27db1ddba28f577a14d73e4b957b,284,119,4,497,235,49,10200,4
1d5f4b2e27f5ad1f4f47fa709d2ae714,86,68,3,200.66666666666669,47,39,08131,3
25420ee8eee264c22f3f61c4f5e8ba98,24,24,1,168,24,0,05040,1
45c25780f94280621d7af4194a0ecc13,59,49,1,413,0,59,05030,2
cdc389b71a85400f457d4948ec25225c,62,53,1,434,62,0,05030,2
3411f7cb8e28093c50637396a885c238,103,85,2,360.5,103,0,08010,3
1d75f5204d20af9eead4d1d1967a9b29,27,27,1,189,27,0,01026,1
5f1bcd2d0e677494fb184a7bf55b14b1,108,85,3,252,108,0,04032,3
13908999570b51f6fba36b2ccdc7e101,60,60,1,420,60,0,03050,2
84fe7972e5f1e03bde982adcaea0398e,533,141,1,3731,533,0,06120,4
4757cfccfeaab79384ebe84d484635fb,373,160,2,1305.5,373,0,01026,4
44ecdac5ead32c38f41475d346d3e32b,48,40,2,168,48,0,01013,1
368c718fe8bfa9bd6c1858ff8f942ad3,184,97,3,429.33333333333337,119,65,11140,3
27bd1a52ecfa3164678fbdd57c4fb36d,47,47,1,329,47,0,05040,1
ab48fac50a24f3a8d54f7c9307b3bc0d,17,17,1,119,17,0,01026,1
83cd03198eefb3a7903cf4c7a1774c14,21,21,1,147,21,0,09130,1
c079f2931ed8cf5b4b24a8233a016bca,42,42,1,294,42,0,01026,1
576410e6357ebd40abbb8a6f5610c300,248,134,1,1736,248,0,01012,4
9deb0e915feb3f8bd0be634c58e3eb13,140,75,3,326.6666666666667,140,0,03050,3
04fa9e3074028fa742c5f9f998ac160a,91,78,2,318.5,35,56,04020,3
0991eb5a3288bcef05f29a3afdf6f66c,24,24,1,168,0,24,01012,1
2f1aa07d3341391b4c576a982305710a,74,74,1,518,74,0,01026,3
91f045e1f48954502dc9a08d66403fe4,133,100,2,465.5,133,0,01026,3
7a321fce1de9e6e5a217b9bbb0b95ce0,63,34,2,220.5,28,35,05041,1
2c8cf246f2d9531beb562e49c4853b6b,56,43,4,98,43,13,01026,2
d7b882bb6f5255c345050fc93fc2cf77,179,103,3,417.6666666666667,179,0,09130,3
778b610989a7f9adbd0241ef10e79528,37,37,1,259,37,0,09351,1
3c31836ec21f721edf2bc90181e94e00,46,46,1,322,46,0,09130,1
78354c93770bdf3ff5745c5b60cb19c1,23,21,3,53.66666666666667,23,0,13490,1
df924d986bfdc792dc32e8033c045d0f,158,90,1,1106,158,0,05040,3
43394c3aeef8c79bf97507ecf4cc73e2,110,78,2,385,110,0,02691,3
7c6dbccc285f44810a44fcf8496a41a4,10,10,1,70,10,0,14301,1
e3c80cc723a6f2895ac3e8f3cc2fedad,68,42,3,158.66666666666669,36,32,05030,2
3e5df4ed73216d5a23d5b12405eea551,84,84,1,588,84,0,01026,3
e855be11a5f67702cefc7e538c8eb5a1,233,81,4,407.75,174,59,01012,4
80d8af433236b2e45d460d262426ac77,38,21,3,88.66666666666667,38,0,10200,1
d3a4ceb17e7de3c35aa395b329124bd7,156,112,2,546,85,71,01026,3
c1cb4238368bfb8dc02f0dc737295cda,147,91,3,343,147,0,05040,3
efb1f923036aed22a1a80cff78c4e674,38,38,1,266,38,0,01012,1
b334a51b1cab0aa6ba71b868b5ebcb06,21,21,1,147,0,21,05041,1
26b725057b19cc25ad0a29bbdb0c0acd,90,55,1,630,90,0,09090,3
3205b8d2423f5bae3117935445b3736c,43,43,1,301,43,0,01012,1
bd2bebbb68cd54580fd7faedaf1b0185,46,38,2,161,46,0,05100,1
ba68daca6ff3c5021852e5813928ebdd,122,94,1,854,122,0,02751,3
ef24ecf130194c4fcae13100d387e978,2,2,1,14,2,0,10080,1
bb8b46c673b6bdc5090e0754b4043c47,152,82,3,354.6666666666667,152,0,08313,3
871d76d6831d13f0853322e2366fe267,16,14,2,56,16,0,12670,1
a84aea44eb72e9364fe8f60ddf29651f,42,42,1,294,0,42,10200,1
359a5c5d450adbf2fde77777235700b3,126,67,3,294,70,56,01026,3
4ae46b5ab920fbc8ec347d02858ae877,16,14,2,56,16,0,11040,1
b7b817e25680e41aa72bffad253859a7,33,33,1,231,0,33,01026,1
9c731b4a2ce0c1e201386b39ad1076ac,10,9,2,35,10,0,05030,1
b8f5478d1ff1b1d50a8e11d9c5f68743,19,19,1,133,19,0,01201,1
8148ec189fc643d0274112832c01402c,146,96,4,255.5,146,0,05040,3
4caf8d76157ca8638d094154dde480fe,187,112,2,654.5,187,0,01085,4
6b55cff99687382dee5786becb3f4ed4,66,61,2,231,66,0,01013,2
9da9c80a7478a1857dc1339d0c152b9b,151,121,2,528.5,52,99,11040,3
1986bcec6324ee475bed3e33c036598b,84,58,3,196,84,0,05030,3
a6fcca712d849122af5fd338676aa869,102,63,2,357,102,0,02650,3
bbdb59e169691bda62d5fa714186b9a2,40,31,2,140,40,0,05040,1
028908dac32cd1cbb8df369a6ba89296,73,73,1,511,73,0,09130,2
f104fa7fbae44126e55365291a181a1c,29,28,2,101.5,29,0,01012,1
dfed9759baab8ac8f45ee1db1377428b,14,13,2,49,14,0,05040,1
5280205bcc542fa57d63443f72866eaf,76,65,2,266,36,40,09130,2
c5357b217aa38c6f704e1354f4afca4c,35,35,1,245,35,0,10200,1
e94a271777dbf115083f9e7106d3e58e,61,41,2,213.5,61,0,08452,1
0070dbc628261ef60c8d628f75559ac0,336,208,4,588,200,136,01085,4
a8b2284ae5c5078f552ba9a4251baf56,70,56,3,163.33333333333334,70,0,05040,2
3808ed3d894f84823178006f33676d55,78,61,2,273,78,0,05030,2
048433f7662e9c7d7b8bb3f03a206727,28,28,1,196,28,0,14301,1
e665052fd7222e795248286fea428a8f,30,30,1,210,30,0,03090,1
15a91b670cb645e4f8aad91abb047a54,50,39,2,175,29,21,09190,1
eb58a600d7afa98fbdbd2aeeef809593,67,58,2,234.5,67,0,01013,2
2bc58448045736226128965a9ecf985f,73,41,3,170.33333333333334,73,0,10153,2
76b24c4dec7c7bba0bc0fc555bfec286,55,37,2,192.5,29,26,10200,1
8e84e645d9c3b311ed5b8b5591db27a3,357,162,3,833,357,0,01026,4
53e56751dcfd1a96354e34af72e243be,21,21,1,147,21,0,05030,1
323aaa5e310985cdc3a40b77887fe4d9,36,36,1,252,36,0,09131,1
27713cb802e28a846e9d0c082f03ca10,13,13,1,91,13,0,09170,1
1466875fc34812f050558b459dc53539,76,62,4,133,76,0,11040,3
81f254b73fafe1b0bab038fce1fb30c3,3,3,1,21,0,3,10028,1
8753d686ef21fa61ecb875d41dfb327c,165,98,4,288.75,118,47,11080,3
f92ab96e914cb90e1ca9c3dc01b97f05,20,20,1,140,20,0,03033,1
4a84df74ad37fda1b0fd02d98218ffeb,169,89,3,394.33333333333337,82,87,01012,3
9422808852e4a6626a36a22e78c3ff0a,149,82,3,347.6666666666667,149,0,05040,3
53a0a8efcf136017afcf24f3ec9d6ac0,92,47,3,214.66666666666669,92,0,01026,2
bceb4e78dba6754c05e57af9499fc654,56,56,1,392,56,0,04060,2
0b6b34d3fbe417382dd4f38740520cae,23,23,1,161,23,0,09130,1
0658985d9043fe83746475d3bfbbd720,73,61,2,255.5,73,0,08100,2
c0f20f233ee5da8ed2dc1160af448b76,49,19,3,114.33333333333334,49,0,13877,1
8e6445908dc9047fd904ef06b7e904e7,110,84,2,385,110,0,05040,3
47d4cf75da69ec6b2d51975b0d05c40d,37,34,2,129.5,19,18,05030,1
30ce6b06c091cb9f99008ecd92a29a1f,82,51,3,191.33333333333334,82,0,01085,2
9b8b00c0de54941b6cdc1dc9ad27cf21,33,33,1,231,33,0,03033,1
c932ce7ab8f2b0590a9d37903b3f66dc,17,17,1,119,17,0,05200,1
b7950a0813818c7b411b0600c74fbff7,135,81,4,236.25,135,0,01085,3
ed12fa349586741645e5876fb3524ccf,305,99,2,1067.5,305,0,11060,4
3127934cf18e7b561acfde69705401e1,24,24,1,168,24,0,10200,1
4324c920ec858552e588981d1785fd10,373,128,3,870.3333333333334,334,39,05040,4
8ae72bee8531631453503e7bdc2fdca7,15,15,1,105,15,0,05040,1
9aee695fcd91811851cadad21960119c,80,49,3,186.66666666666669,80,0,01027,2
4d5777ae0f5039eb129932b41cb35426,4,4,1,28,4,0,03033,1
2061bc664eae186e73ee816b2f0bbcbb,252,116,3,588,252,0,05040,4
7a6cf5f069d70247d9cd46c9e1bf64c5,260,135,4,455,168,92,01012,4
81708c4c18a988780fb2deb7a403b881,80,61,2,280,40,40,11040,2
a374e275df8fae8cc2ff5d0ffe2b02c6,64,52,3,149.33333333333334,64,0,01012,2
254e2203ec3dd5922e1dfc5023dd100d,138,75,2,483,42,96,05040,3
9d469ea992aabe59bf17fa768934f93a,131,87,1,917,131,0,05040,3
c8b995b48c30e5844dd8c8291908e6b6,136,50,3,317.33333333333337,136,0,01026,3
b4b0d866958ff3bf4653564933153e74,105,54,3,245,105,0,04060,3
a98ff81fb34f502c0f76a17d0cd3c76e,32,32,1,224,32,0,04080,1
4aec636901e1b77afba16d5a8874e851,5,5,1,35,0,5,11181,1
7ec2d3baf480546db33d264eae4c82e0,66,55,2,231,66,0,01027,2
c10ed65ad0b91388db4bd1a673efdcb2,91,61,3,212.33333333333334,91,0,05041,3
1a10cb9f0743be4e32a1dcf8ae12da88,93,76,1,651,93,0,02756,3
4a34cd9efe276eb829265236b69c742e,75,67,2,262.5,75,0,11100,2
96720a4083328ab103fc052a4961a2d7,182,76,5,254.79999999999998,182,0,05040,3
8060458a16beea9c718cd68e350a936e,33,33,1,231,33,0,05040,1
b2e27dfcd17196414f8c29d1558f7670,5,3,1,35,5,0,05030,1
368c3a297c46844dca013ee7829f8024,382,155,5,534.8,335,47,01012,4
6143b7526987bf30fc687a21078ea275,52,45,2,182,52,0,01012,1
417a662170825d8a8bf37f71e6033459,40,37,3,93.33333333333334,22,18,01026,1
ec4b191a79763c85a9a70799dbdb47bc,271,94,5,379.4,187,84,05040,4
1ec9af7734edb958bc6f25abda4fd424,29,14,3,67.66666666666667,29,0,11040,1
6f6e78bf58d9ea03283fc9a7a61b5fd4,144,70,3,336,88,56,05040,3
f130198d4cfa702e7087e1df09f0e35e,2,2,1,14,2,0,12691,1
8018cf6ecb36019f2a063acbfc9448bc,11,10,3,25.666666666666668,11,0,11080,1
e62b51e6dd31896afb9d657718d9d9b0,135,46,3,315,135,0,04201,3
c60d34f40dcd108a758507fefacb89fc,49,38,2,171.5,49,0,05100,1
fc5f2110e058d031be34152c954be0da,26,25,2,91,26,0,05030,1
27053c70f245c0ca747ffc53cfe5f5ac,30,27,2,105,30,0,05040,1
ec62da8561d6493a81ab09c5745c760a,46,40,1,322,46,0,03033,1
aa281ff76773250a3a467941822271fc,138,89,4,241.5,138,0,05030,3
6a1eeb02f8e6a0c073e6fb8243efac7c,69,69,1,483,69,0,05040,2
7fb7cc956f132fe03daa1cbf760e5087,38,35,1,266,38,0,08150,1
96242d781390ba8aa85a2060243905de,10,10,1,70,10,0,01026,1
0dee158e59de5d52f63f92ded973abee,21,21,1,147,21,0,12501,1
12110a58d934eba0e08071ae7f25159b,99,75,3,231,99,0,01085,3
472f10e18e33f026d009de3f87c1d9c0,112,73,3,261.33333333333337,112,0,10040,3
dd14e32c7b721c00d2bef1146fbc39bc,295,141,5,413,234,61,01012,4
db149da9e92a250b65f7543af49fbff8,18,18,1,126,18,0,10152,1
e30967591f04bd9c39e0b1fe7059410b,24,24,1,168,0,24,01026,1
a7ad0155480c79c93189fabc1c47431a,47,40,1,329,0,47,01012,1
3f252d225e2563dbabe6d06b0c15d915,16,16,1,112,16,0,11140,1
e01f5c9a59a870384ac9e23cc2c405a6,10,10,1,70,10,0,04130,1
d13f7c3f3208aede1455569fd0a3d8ab,254,69,2,889,254,0,05040,4
4092abc675bad1db39d0fbfb49998c66,39,36,2,136.5,39,0,10240,1
29ab990cbd73f3e293303444685d7b5b,101,72,1,707,101,0,09130,3
fc6778ffd03b7d09da097d1797a64a3a,58,41,1,406,58,0,05040,1
b552949c17144bb9fb914a5c3e7de281,47,16,5,65.8,47,0,11140,2
64d14fdc6e7d4f9c048c38af7fa6e488,194,150,2,679,194,0,05030,4
673101103f92cafaa6fd622ba0bfb531,37,26,2,129.5,37,0,11040,1
0c51b330419419fabfe6de8569833c15,102,63,1,714,102,0,09170,3
821560698b38656691b20f281aa41a08,63,43,2,220.5,63,0,11140,1
62a359029d0f56cad80a706fa13d86d4,111,61,3,259,72,39,01013,3
b805bb6474eb830327304bc5bc8705ef,237,113,4,414.75,203,34,01026,4
24a37014e5eb617280ec8d094b4f1e32,146,103,1,1022,0,146,08314,4
6ef143793295bd4bbfcb4d4c5e73f0cb,57,49,2,199.5,57,0,05030,1
d5aa055690616646eedca547285a0402,54,54,1,378,54,0,11100,1
b2a689e11f4f0d5f743556059bf185b1,7,7,1,49,7,0,10200,1
f9ac4cf5333d436cbd884981bf5c7436,65,52,2,227.5,37,28,02751,2
679338c8ef421edd1ae5f5f406810ffa,19,19,1,133,19,0,11080,1
638fe92202173bb713d3aa2f5bf5d1c5,141,68,4,246.75,108,33,05040,3
dc49cb4acaa69fc78ee559b45d39f57c,127,75,5,177.79999999999998,105,22,01012,3
06d11527be31d0bca5595e81c77f6aad,32,15,3,74.66666666666667,27,5,09190,1
997680680a0bb9b936b2ebefea291343,3,3,1,21,3,0,08230,1
c5b26ef9e8cdbb98fe86422708d9400c,100,69,3,233.33333333333334,100,0,01012,3
6395ee9bda85442d26566865977e0b82,32,32,1,224,32,0,01026,1
56d371358d7404b1b9bb49751ef00afd,218,106,4,381.5,218,0,09010,4
7ecde6aeb815e8f8a00ab606d9b0b272,164,95,3,382.6666666666667,137,27,01026,3
605613e1964218da3d57bdcc342e52bd,112,63,2,392,38,74,11080,3
6417ef56e5954ffe965d12c99400cd4a,83,64,2,290.5,83,0,05030,2
2d07414594619126d13ef700a1ada36a,43,28,2,150.5,43,0,05040,1
966dcedd0c6676c3c746d130bca9e529,45,43,1,315,45,0,08150,1
a893661789d3a24e3c6da3065c84e80e,89,54,1,623,89,0,12670,3
59e733dc77c1605c601f60ff266bec69,62,50,2,217,62,0,03090,2
b0d95b4fa8b7f120c1ad2204d025182c,37,25,2,129.5,37,0,11080,1
fd67f72ae05d84b0023cd0c0dee0c4e5,76,67,1,532,76,0,03070,2
9b1a36d9884ede06f6e047c91f9c5cf5,220,120,3,513.3333333333334,220,0,01026,4
374a09f9d4b7e8bb8e7d0e1dd0ef4d41,41,41,1,287,41,0,01026,1
94ffaaeb5f5dd46df02b1ad6adf19aee,131,76,3,305.6666666666667,89,42,01026,3
de05eb3a2d80ff92f1100bc543269344,28,28,1,196,28,0,01012,1
c1e8068ab891e56ab3696f0268072cc6,33,33,1,231,33,0,05040,1
d0893bfa5d52e9e6feae15a983aba408,18,14,3,42,18,0,09190,1
da90e101ac633c619d6502a05fb416d4,82,57,4,143.5,26,56,05040,3
21602ef500a1a074014d61e01fe58585,102,68,3,238,78,24,01012,3
6407a527a2b0d8f6c742f3b3b371e8f2,11,11,1,77,11,0,01012,1
4c421df3bec141115063456b8c0741ea,150,100,3,350,150,0,11060,3
e755c96113bd5984da12e625fd04b7fc,126,78,4,220.5,126,0,05040,3
914cee696bec1f85c6029d6a05f8e146,75,49,4,131.25,53,22,05030,3
0c6799845fd25d7514c445e1d43deb82,322,145,5,450.8,255,67,01013,4
67129159dc825644618bf08fe030ee4b,3,1,3,7,2,1,08315,1
46ac03a18be7d26e1a8a791bcf6c783d,130,106,2,455,130,0,03070,3
092e9b9ac6a77848ae8cc9115ffca2f6,297,155,2,1039.5,297,0,05040,4
f75655766d1927b13fd41f2bab676377,79,66,4,138.25,61,18,10200,3
162a075e896522cb9c61e4e14e66fef0,9,8,2,31.5,9,0,05030,1
69714595af139a6dc1c96737b30dda0b,35,35,1,245,35,0,05040,1
8c5ef976fbafa5908581f5071414cde2,44,32,3,102.66666666666667,44,0,05030,1
57f737ed2cfb04cc43682f3f0836ff85,63,44,2,220.5,63,0,05100,1
f0fa2ef9c6bed3a8dc79a138fdcc6316,27,27,1,189,0,27,05100,1
981f7bef6e287cd75e6fe51b8d525298,270,118,3,630,220,50,11080,4
4a76b533c23f55dfec786ce317956eba,251,114,5,351.4,185,66,11130,4
a7d8525f01e6d3a15d792a78a4cc2801,247,111,3,576.3333333333334,247,0,05100,4
0c79219a7586d5cc8fee2be7490704cd,321,164,2,1123.5,1,320,04020,4
28ed55f04a6533250b50c1d28d46ac12,40,36,1,280,40,0,01012,1
9005b8c09dc92e62d4008793d9c63ec3,29,29,1,203,29,0,01012,1
244c82e1d6818630b2e03bd48668fa10,75,59,3,175,75,0,10200,2
d6b5b36a8ba999de15ee09f73b8eb270,55,55,1,385,55,0,10200,1
dcc63c24e31ff0a1a1b495b2be677858,305,140,4,533.75,183,122,01026,4
6c93992677bfda26082a099ba492acb4,36,31,2,126,36,0,02691,1
1c3fb7b07ed81dcedb23fd242de4ce4a,119,85,3,277.6666666666667,69,50,05030,3
ca2328aa2dd4d6a3105fe7e90d528cbe,10,10,1,70,10,0,09010,1
7fc8c8addef1cd2365874a142e5f9f41,119,88,2,416.5,63,56,05040,3
6f2dcd2ecfa41369797574f404e59f05,28,28,1,196,0,28,01012,1
9964de6d8248c925cb558d255ffc678a,90,54,2,315,90,0,01027,2
c5902cbf13c809e562533a2e32ef1f4f,130,93,2,455,130,0,10240,3
f0a9c212ee1377621a66850ebb160303,75,61,2,262.5,30,45,11100,2
c809d51760786baca593b2cb1a4e4c1d,22,22,1,154,22,0,08150,1
26e698d3d4c2f57e474108fe8b05a190,32,27,1,224,32,0,11080,1
65a6447839a044f63c8ebdb23b57bb3e,178,85,3,415.33333333333337,178,0,03050,3
49c26332497022775bdca488f3c9f06f,18,18,1,126,18,0,11100,1
19e707d6e207a7008c1a051297cfb554,19,19,1,133,0,19,05030,1
1c5e62032de2278d1a3d089aed66e085,57,43,2,199.5,57,0,05040,1
e9fbce1be6b9fff41e000f6f8064804c,38,31,2,133,18,20,05040,1
e63d7367da248061da0bd0dbdcbf7003,248,108,5,347.2,203,45,01013,4
045a442abc02cb9f647bfc5ae16a8ab6,47,47,1,329,47,0,04060,1
1f2749704e94a1400bac18eedb6ae86a,104,62,3,242.66666666666669,51,53,05040,3
f2428f0f21375cf6e474f240169e9b72,23,23,1,161,23,0,05040,1
3d4594ec5f1f5554b814851e78aa6e0b,62,34,3,144.66666666666669,21,41,11100,2
db019af8ef7397f3e025d72443ae7271,73,53,2,255.5,73,0,05030,2
e89b1a21c5ecdc518f22b2f3595a98da,12,7,2,42,12,0,12670,1
1eadf6b9bca0bfe12991f48da473c36f,419,145,6,488.83333333333337,369,50,01026,4
ff71b963e95b5fb9ae3dd2f6ce1582ef,13,13,1,91,13,0,05040,1
516d0b4772c0cec695bf475053810094,53,46,1,371,53,0,05040,1
b8bde20053555913e0128abb302e4fa0,51,51,1,357,51,0,11100,1
d5bde002a4fc122fd5e5afa9b0995b28,25,25,1,175,25,0,10200,1
f09f77bfe1a92e97eb00ad9e2ccf2ba6,268,99,4,469,268,0,02691,4
f19879c886a3faf78c012b5032750fd2,61,48,2,213.5,61,0,02650,1
764ffe8a8b7ec20996d6f3138e748387,261,134,4,456.75,261,0,05040,4
aa6f1431af080e14e51c75beafa6ae06,185,94,3,431.6666666666667,185,0,01026,3
7c56b48a09f8285b076cf750186f7829,19,19,1,133,19,0,05030,1
4cd462431b42476f018e14fad4617483,29,29,1,203,29,0,04020,1
7d8575440622a1d74bdd65521122a8bb,60,53,2,210,60,0,05040,2
12388f94ac9ecf3674a15360364aae83,76,65,3,177.33333333333334,76,0,05100,2
f0c75db94465a169d5ecc9de5a388a5d,82,80,2,287,6,76,13490,3
ec872ca90128232c2bad80aba0d8ed8c,65,44,3,151.66666666666669,43,22,01027,2
e26f9f73efb0260dd8115f7e4816b130,31,31,1,217,31,0,05040,1
eda65598e0e49e6070d68716046cee8b,38,34,2,133,38,0,05040,1
7e9b24b18aa5d3161dfd2fe39ce9e2a9,3,3,1,21,3,0,11040,1
7b48b262117f9db5a387aa5192c7d6ab,475,141,6,554.1666666666667,437,38,01012,4
876ca9e04f9d9ec87cb47f709f9818d2,60,44,4,105,60,0,05030,2
d2cf6f355db2488f68915a0e6cae4b17,113,85,3,263.6666666666667,113,0,01027,3
3d27af8e16ac847822145271803c26f0,70,51,2,245,34,36,02620,2
1ce9967365e2c1110805408da147770f,48,48,1,336,48,0,01027,1
a632477cca18b07c466b75e3e583f164,330,87,2,1155,26,304,10200,4
ce805b434e206a98cf9f801734d7e628,163,102,3,380.33333333333337,163,0,05100,3
cbbe60c3cacbb0364bd3ee514ca7f89e,271,115,3,632.3333333333334,271,0,01026,4
a9764ff0600626e20b44982ddc8417d4,65,59,2,227.5,65,0,11100,2
eff3032391b03aed68904dcf4d3dbf9d,50,50,1,350,50,0,01085,1
aa227e7eb763b4515c9abd25f8db84ea,206,109,2,721,23,183,01026,4
68ae85d97fcc39f99040829a69aefaf4,43,43,1,301,43,0,05100,1
162d855a04f811bd9a659d9d52cb470f,10,9,2,35,10,0,13580,1
ee00025f9f3afc798442d8f8d6d0bdf2,137,89,4,239.75,137,0,12501,3
ee24503a377b789691e1546e01c62c3d,108,61,1,756,108,0,05100,3
cd2cb26328d8eb1a90a5ae6b0e812395,24,24,1,168,24,0,05040,1
f6aa932c681a75809df7f5e7495c7299,15,15,1,105,0,15,08230,1
37a0ee4b0689bdce3bbc6362f6c3cccb,76,43,2,266,76,0,10200,2
509dd2c6f08c7573a86d82e393309193,6,6,1,42,0,6,02690,1
d8e14cf47f15aafc29d37d03c0925256,6,5,2,21,6,0,05030,1
e9bd7af1b7a290cb93d370508e8d8e97,481,237,4,841.75,131,350,05040,4
373bb8fcedc7bc05ff13ec6085758181,100,54,3,233.33333333333334,40,60,10200,3
0f3355a60e352c9a09c5514835baca40,43,43,1,301,43,0,09170,1
0664f4184b43be4273c527fccde44d7e,113,82,2,395.5,113,0,04060,3
26d783c60f155f581b2a49c94b8ce71b,19,19,1,133,0,19,01012,1
9838c823aea0fcc7e09084f3745a8eaf,7,7,2,24.5,3,4,10028,1
69a799debb44c8fe155d3b1ddc556f62,62,50,3,144.66666666666669,62,0,10200,2
88e214554663bc0ab377cd62601fd0c1,52,42,2,182,43,9,10101,1
cea2f3149e3ab929122ddbb240b4a60e,54,54,1,378,54,0,01013,1
eb8366432d223bcd8be4bfff9e951af0,141,86,2,493.5,141,0,05040,3
403f73499b117daf5fa416142758c997,44,31,3,102.66666666666667,44,0,09010,1
78eb6c51b915ff30e4a4b85c6219d170,105,61,4,183.75,86,19,05030,3
0676cab7bea1dc2bc024573dcf0ce50d,249,116,3,581,152,97,05040,4
e3ec046bdf0fb05e7c5f62a69c0a0749,57,47,2,199.5,57,0,04020,1
ee8d5aeeec4bdaec55ac6c0871f91a55,54,47,3,126,54,0,11080,2
2378cd594dc9e9f120864fa4c20dd5f1,13,13,1,91,13,0,01027,1
e2dedb4adc2999696bbae1e6ab671f37,85,58,2,297.5,85,0,10200,2
524579ce94824da0e3356525d08ffc6a,127,82,3,296.33333333333337,127,0,03090,3
5cbc84288c0d84357e94225558d27543,67,50,4,117.25,67,0,11080,2
df401c7dc48e79a848dd2bc7682ecfc4,110,97,2,385,110,0,10028,3
